RANK THIS WEEK,RANK LAST WEEK,PLAYER NAME,EVENTS,TOTAL,DISTANCE RANK,ACCURACY RANK,year,measure
1,1,Keegan Bradley,29,69,44,25,2017,total_driving
2,2,Kyle Stanley,29,79,66,13,2017,total_driving
3,5,Graham DeLaet,25,89,34,55,2017,total_driving
4,4,Lucas Glover,26,90,50,40,2017,total_driving
5,3,Rickie Fowler,21,93,41,52,2017,total_driving
6,T6,Rick Lamb,19,98,54,44,2017,total_driving
7,T6,Martin Laird,25,99,62,37,2017,total_driving
8,8,Shane Lowry,16,100,67,33,2017,total_driving
9,9,Francesco Molinari,21,104,98,6,2017,total_driving
10,T12,Sergio Garcia,17,105,30,75,2017,total_driving
T11,T12,Paul Casey,24,107,58,49,2017,total_driving
T11,10,Jim Herman,25,107,96,11,2017,total_driving
13,14,Brendan Steele,25,109,40,69,2017,total_driving
T14,15,Kevin Streelman,26,114,84,30,2017,total_driving
T14,11,Russell Henley,27,114,54,60,2017,total_driving
16,T16,Hudson Swafford,28,116,22,94,2017,total_driving
17,18,Boo Weekley,27,119,116,3,2017,total_driving
18,T16,Gary Woodland,26,128,13,115,2017,total_driving
19,T21,Patrick Cantlay,13,129,48,81,2017,total_driving
20,20,Emiliano Grillo,25,130,91,39,2017,total_driving
21,T21,Jason Kokrak,28,131,17,114,2017,total_driving
T22,19,Jason Dufner,24,132,78,54,2017,total_driving
T22,T21,Bubba Watson,22,132,20,112,2017,total_driving
24,T21,Sam Saunders,24,133,88,45,2017,total_driving
25,26,Xander Schauffele,28,134,16,118,2017,total_driving
T26,T27,Harold Varner III,31,139,29,110,2017,total_driving
T26,25,Kevin Kisner,28,139,120,19,2017,total_driving
28,T27,Jon Rahm,23,140,20,120,2017,total_driving
T29,T30,Richy Werenski,26,141,109,32,2017,total_driving
T29,T30,Billy Horschel,28,141,43,98,2017,total_driving
T31,T27,Kevin Chappell,27,142,23,119,2017,total_driving
T31,T30,Hunter Mahan,26,142,79,63,2017,total_driving
33,34,Dustin Johnson,20,145,2,143,2017,total_driving
T34,T35,Tony Finau,29,146,10,136,2017,total_driving
T34,T35,Russell Knox,24,146,126,20,2017,total_driving
T36,33,Hideki Matsuyama,22,147,26,121,2017,total_driving
T36,T38,Ryan Moore,24,147,130,17,2017,total_driving
T36,T35,Sean O'Hair,25,147,58,89,2017,total_driving
T39,T38,Robert Garrigus,26,148,37,111,2017,total_driving
T39,T38,Rory Sabbatini,23,148,105,43,2017,total_driving
41,41,J.J. Spaun,29,149,107,42,2017,total_driving
42,T42,Louis Oosthuizen,18,152,69,83,2017,total_driving
T43,T44,Chez Reavie,28,153,149,4,2017,total_driving
T43,T42,James Hahn,28,153,86,67,2017,total_driving
T43,T44,Julián Etulain,22,153,89,64,2017,total_driving
T46,T46,William McGirt,28,156,149,7,2017,total_driving
T46,T46,J.J. Henry,29,156,83,73,2017,total_driving
T48,T48,Tag Ridings,20,159,32,127,2017,total_driving
T48,T48,Ryan Palmer,20,159,27,132,2017,total_driving
T48,T48,Adam Scott,16,159,15,144,2017,total_driving
T48,T53,Ben Martin,27,159,103,56,2017,total_driving
52,T65,Justin Rose,18,160,35,125,2017,total_driving
T53,T53,Jamie Lovemark,28,161,24,137,2017,total_driving
T53,T56,Luke List,31,161,4,157,2017,total_driving
T53,T48,Brooks Koepka,24,161,7,154,2017,total_driving
T56,T58,Daniel Berger,26,162,62,100,2017,total_driving
T56,T58,Rory McIlroy,14,162,1,161,2017,total_driving
T56,T56,Zach Johnson,23,162,140,22,2017,total_driving
T59,60,Anirban Lahiri,22,164,61,103,2017,total_driving
T59,61,Grayson Murray,30,164,12,152,2017,total_driving
61,T48,Jhonattan Vegas,29,166,33,133,2017,total_driving
T62,T63,Matt Jones,20,168,28,140,2017,total_driving
T62,62,Bud Cauley,28,168,72,96,2017,total_driving
T64,T67,David Lingmerth,23,169,113,56,2017,total_driving
T64,T63,Bryson DeChambeau,31,169,45,124,2017,total_driving
T66,T74,Justin Thomas,25,170,8,162,2017,total_driving
T66,T67,Chad Campbell,29,170,147,23,2017,total_driving
T66,T67,Webb Simpson,28,170,142,28,2017,total_driving
T66,T70,Brett Stegmaier,27,170,124,46,2017,total_driving
70,T65,Charley Hoffman,31,171,49,122,2017,total_driving
71,T70,Adam Hadwin,28,173,108,65,2017,total_driving
72,T76,Scott Brown,29,174,121,53,2017,total_driving
T73,T74,Sung Kang,32,175,67,108,2017,total_driving
T73,73,Shawn Stefani,26,175,84,91,2017,total_driving
T73,80,Vaughn Taylor,26,175,161,14,2017,total_driving
T76,T76,Chris Stroud,22,176,141,35,2017,total_driving
T76,T76,Jordan Spieth,23,176,75,101,2017,total_driving
T76,T76,Trey Mullinax,28,176,9,167,2017,total_driving
79,T82,Ryan Armour,20,177,176,1,2017,total_driving
T80,T82,Scott Piercy,22,179,72,107,2017,total_driving
T80,72,Marc Leishman,25,179,50,129,2017,total_driving
T80,T86,Matt Kuchar,26,179,148,31,2017,total_driving
T80,81,Morgan Hoffmann,29,179,86,93,2017,total_driving
T80,85,Jonathan Randolph,22,179,132,47,2017,total_driving
85,84,Byeong Hun An,22,180,41,139,2017,total_driving
86,T86,Graeme McDowell,17,181,173,8,2017,total_driving
T87,T89,C.T. Pan,29,182,134,48,2017,total_driving
T87,T86,Danny Lee,32,182,111,71,2017,total_driving
89,T89,Brandon Hagy,26,183,3,180,2017,total_driving
T90,93,Nick Taylor,29,184,105,79,2017,total_driving
T90,T94,Steve Wheatcroft,17,184,169,15,2017,total_driving
92,92,Rafa Cabrera Bello,19,185,103,82,2017,total_driving
T93,T94,Brian Harman,30,186,116,70,2017,total_driving
T93,T97,John Huh,28,186,136,50,2017,total_driving
95,T94,Kyle Reifers,32,187,146,41,2017,total_driving
T96,T99,Ryan Brehm,25,188,4,184,2017,total_driving
T96,T99,Alex Cejka,28,188,164,24,2017,total_driving
T96,T89,Pat Perez,26,188,112,76,2017,total_driving
T99,T103,Miguel Angel Carballo,22,189,128,61,2017,total_driving
T99,107,Kevin Tway,27,189,10,179,2017,total_driving
T99,T97,Smylie Kaufman,26,189,25,164,2017,total_driving
T99,T103,Blayne Barber,25,189,109,80,2017,total_driving
T103,T99,Mackenzie Hughes,31,190,81,109,2017,total_driving
T103,T99,J.T. Poston,28,190,77,113,2017,total_driving
T103,T109,Chris Kirk,28,190,139,51,2017,total_driving
T106,T103,Jason Day,20,191,19,172,2017,total_driving
T106,108,Nick Watney,23,191,35,156,2017,total_driving
T106,T103,Cameron Percy,23,191,96,95,2017,total_driving
T109,T109,K.J. Choi,25,192,163,29,2017,total_driving
T109,T111,Jim Furyk,18,192,190,2,2017,total_driving
T109,T111,Daniel Summerhays,29,192,136,56,2017,total_driving
T112,T114,David Hearn,29,193,167,26,2017,total_driving
T112,T117,Spencer Levin,31,193,175,18,2017,total_driving
T114,T117,Brian Stuard,31,194,189,5,2017,total_driving
T114,T111,Johnson Wagner,26,194,128,66,2017,total_driving
T114,120,Ben Crane,26,194,178,16,2017,total_driving
T114,T114,Patrick Rodgers,27,194,18,176,2017,total_driving
118,T117,Andrew Loupe,21,195,6,189,2017,total_driving
T119,T114,Brian Campbell,20,196,70,126,2017,total_driving
T119,T121,Roberto Castro,25,196,169,27,2017,total_driving
T121,T123,Søren Kjeldsen,17,197,187,10,2017,total_driving
T121,T123,Zac Blair,32,197,188,9,2017,total_driving
T123,T127,Ken Duke,26,198,186,12,2017,total_driving
T123,T121,Scott Stallings,27,198,57,141,2017,total_driving
125,T123,Troy Merritt,28,199,114,85,2017,total_driving
126,126,Kelly Kraft,27,200,101,99,2017,total_driving
T127,T127,J.B. Holmes,23,201,14,187,2017,total_driving
T127,129,Andres Gonzales,24,201,46,155,2017,total_driving
129,130,Steven Alker,23,204,183,21,2017,total_driving
T130,132,Tim Wilkinson,22,209,173,36,2017,total_driving
T130,131,Bill Haas,25,209,92,117,2017,total_driving
132,133,Patrick Reed,29,213,75,138,2017,total_driving
T133,T135,D.A. Points,22,214,180,34,2017,total_driving
T133,T135,Geoff Ogilvy,25,214,142,72,2017,total_driving
135,T137,Brian Gay,25,215,177,38,2017,total_driving
T136,T137,Martin Flores,27,216,39,177,2017,total_driving
T136,134,Robert Streb,30,216,81,135,2017,total_driving
T136,139,Harris English,27,216,30,186,2017,total_driving
T139,T140,Jonas Blixt,25,218,122,96,2017,total_driving
T139,T140,Rod Pampling,22,218,131,87,2017,total_driving
T139,143,Charl Schwartzel,18,218,47,171,2017,total_driving
142,T140,Jimmy Walker,21,219,74,145,2017,total_driving
143,146,Ollie Schniederjans,28,222,37,185,2017,total_driving
144,145,Branden Grace,20,223,100,123,2017,total_driving
T145,T147,Stewart Cink,26,225,65,160,2017,total_driving
T145,T147,Cody Gribble,28,225,60,165,2017,total_driving
T145,T150,Michael Kim,28,225,119,106,2017,total_driving
T148,T147,Dominic Bozzelli,24,226,80,146,2017,total_driving
T148,T152,Seamus Power,25,226,53,173,2017,total_driving
T150,T150,Seung-Yul Noh,31,227,52,175,2017,total_driving
T150,155,Brandt Snedeker,15,227,165,62,2017,total_driving
T152,T152,Fabián Gómez,21,228,151,77,2017,total_driving
T152,T152,Charles Howell III,23,228,62,166,2017,total_driving
154,156,Peter Malnati,29,230,162,68,2017,total_driving
155,T157,Michael Thompson,21,232,154,78,2017,total_driving
T156,T157,Retief Goosen,19,233,102,131,2017,total_driving
T156,T159,Ian Poulter,20,233,159,74,2017,total_driving
T156,T159,Brett Drewitt,19,233,145,88,2017,total_driving
159,161,Sebastián Muñoz,17,238,70,168,2017,total_driving
160,162,Tyrone Van Aswegen,32,239,134,105,2017,total_driving
161,T167,Jason Bohn,28,241,185,56,2017,total_driving
T162,T163,Kevin Na,26,242,158,84,2017,total_driving
T162,T163,Ryan Blaum,29,242,156,86,2017,total_driving
164,T163,Cameron Smith,26,243,94,149,2017,total_driving
165,T167,Matt Every,30,244,56,188,2017,total_driving
166,169,Phil Mickelson,22,251,89,162,2017,total_driving
167,170,Mark Hubbard,27,252,160,92,2017,total_driving
168,172,Mark Anderson,20,259,157,102,2017,total_driving
169,173,Si Woo Kim,30,260,118,142,2017,total_driving
170,174,Patton Kizzire,28,270,92,178,2017,total_driving
T171,T176,Billy Hurley III,25,273,183,90,2017,total_driving
T171,175,Gonzalo Fernandez-Castaño,22,273,99,174,2017,total_driving
173,T176,Whee Kim,27,274,115,159,2017,total_driving
T174,T176,Aaron Baddeley,20,275,94,181,2017,total_driving
T174,179,Brad Fritsch,18,275,127,148,2017,total_driving
176,180,Chad Collins,26,281,166,115,2017,total_driving
177,T181,Greg Chalmers,28,285,181,104,2017,total_driving
178,T181,Nicholas Lindheim,21,287,136,151,2017,total_driving
179,183,Camilo Villegas,25,293,124,169,2017,total_driving
180,184,Cameron Tringale,28,296,168,128,2017,total_driving
181,185,Derek Fathauer,27,300,142,158,2017,total_driving
182,T186,Wesley Bryan,28,302,172,130,2017,total_driving
183,T186,Tom Hoge,17,304,151,153,2017,total_driving
T184,189,Ryo Ishikawa,20,305,122,183,2017,total_driving
T184,188,Ernie Els,20,305,155,150,2017,total_driving
186,190,Bryce Molder,26,316,182,134,2017,total_driving
T187,192,Ricky Barnes,31,323,153,170,2017,total_driving
T187,191,Steven Bowditch,27,323,133,190,2017,total_driving
189,193,Luke Donald,18,325,178,147,2017,total_driving
190,194,Carl Pettersson,27,353,171,182,2017,total_driving
