RANK THIS WEEK,RANK LAST WEEK,PLAYER NAME,EVENTS,TOTAL,DISTANCE RANK,ACCURACY RANK,year,measure
1,1,David Hearn,24,72,45,27,2005,total_driving
2,2,Kenny Perry,23,98,9,89,2005,total_driving
3,3,Harrison Frazar,31,104,17,87,2005,total_driving
4,4,Joe Durant,25,105,92,13,2005,total_driving
5,5,Charles Warren,31,106,27,79,2005,total_driving
6,6,Mathias Grönberg,19,108,15,93,2005,total_driving
7,7,Bradley Hughes,20,113,75,38,2005,total_driving
8,8,Joey Snyder III,31,118,68,50,2005,total_driving
9,9,Billy Mayfair,31,125,103,22,2005,total_driving
10,10,John Senden,29,131,77,54,2005,total_driving
11,11,Will MacKenzie,25,132,20,112,2005,total_driving
T12,T12,Zach Johnson,30,133,86,47,2005,total_driving
T12,T12,Michael Long,26,133,29,104,2005,total_driving
T12,T12,John Rollins,30,133,49,84,2005,total_driving
15,15,Jeff Brehaut,23,134,114,20,2005,total_driving
T16,T16,D.J. Brigman,26,136,42,94,2005,total_driving
T16,T16,Ted Purdy,34,136,45,91,2005,total_driving
T16,T16,Justin Rose,28,136,51,85,2005,total_driving
19,19,Roland Thatcher,26,137,67,70,2005,total_driving
20,20,Mark Calcavecchia,27,140,91,49,2005,total_driving
21,21,Robert Allenby,31,142,33,109,2005,total_driving
22,22,Briny Baird,33,143,100,43,2005,total_driving
23,23,Joey Sindelar,29,144,113,31,2005,total_driving
T24,T24,Richard Johnson,16,145,117,28,2005,total_driving
T24,T24,Jonathan Kaye,24,145,80,65,2005,total_driving
26,26,Sean O'Hair,29,150,23,127,2005,total_driving
T27,T27,Lucas Glover,28,151,12,139,2005,total_driving
T27,T27,J.L. Lewis,30,151,71,80,2005,total_driving
T27,T27,Jeff Maggert,25,151,135,16,2005,total_driving
T30,T30,Bart Bryant,26,153,147,6,2005,total_driving
T30,T30,Alex Cejka,31,153,114,39,2005,total_driving
32,32,Bo Van Pelt,33,157,59,98,2005,total_driving
T33,T33,Craig Barlow,26,159,88,71,2005,total_driving
T33,T33,D.J. Trahan,28,159,41,118,2005,total_driving
35,35,John Huston,31,161,56,105,2005,total_driving
T36,T36,Vaughn Taylor,32,162,84,78,2005,total_driving
T36,T36,David Toms,25,162,107,55,2005,total_driving
T38,T38,Brian Davis,23,163,155,8,2005,total_driving
T38,T38,Marco Dawson,23,163,63,100,2005,total_driving
T38,T38,Sergio Garcia,20,163,10,153,2005,total_driving
T38,T38,Kent Jones,32,163,102,61,2005,total_driving
T42,T42,Vijay Singh,30,164,16,148,2005,total_driving
T42,T42,Lee Westwood,15,164,38,126,2005,total_driving
T44,T44,Tommy Armour III,29,165,112,53,2005,total_driving
T44,T44,K.J. Choi,24,165,98,67,2005,total_driving
T44,T44,Paul Claxton,29,165,153,12,2005,total_driving
T44,T44,J.J. Henry,32,165,34,131,2005,total_driving
T44,T44,Chris Smith,32,165,18,147,2005,total_driving
T44,T44,Darron Stiles,26,165,142,23,2005,total_driving
T50,T50,Rocco Mediate,24,168,108,60,2005,total_driving
T50,T50,D.A. Points,33,168,82,86,2005,total_driving
T50,T50,Kevin Stadler,33,168,23,145,2005,total_driving
T50,T50,Scott Verplank,25,168,159,9,2005,total_driving
T54,T54,Scott Gutschewski,27,169,4,165,2005,total_driving
T54,T54,Jay Williamson,16,169,155,14,2005,total_driving
T56,T56,Geoff Ogilvy,26,170,31,139,2005,total_driving
T56,T56,Heath Slocum,29,170,159,11,2005,total_driving
58,58,Duffy Waldorf,28,172,149,23,2005,total_driving
T59,T59,Stuart Appleby,25,174,19,155,2005,total_driving
T59,T59,Davis Love III,24,174,8,166,2005,total_driving
61,61,Jason Bohn,28,175,62,113,2005,total_driving
T62,T62,Chad Campbell,27,176,52,124,2005,total_driving
T62,T62,Kevin Sutherland,26,176,108,68,2005,total_driving
64,64,Olin Browne,29,177,173,4,2005,total_driving
T65,T65,Tom Pernice Jr.,32,179,80,99,2005,total_driving
T65,T65,Hidemichi Tanaka,34,179,150,29,2005,total_driving
67,67,Arjun Atwal,17,180,50,130,2005,total_driving
68,68,Nick Watney,31,182,28,154,2005,total_driving
T69,T69,Cameron Beckman,31,183,120,63,2005,total_driving
T69,T69,Steve Lowery,32,183,77,106,2005,total_driving
T69,T69,Hunter Mahan,34,183,55,128,2005,total_driving
T72,T72,Mark Hensby,21,185,83,102,2005,total_driving
T72,T72,Brett Wetterich,28,185,3,182,2005,total_driving
T74,T74,Rod Pampling,26,186,40,146,2005,total_driving
T74,T74,Mario Tiziani,23,186,122,64,2005,total_driving
T76,T76,Brian Bateman,32,187,76,111,2005,total_driving
T76,T76,Tim Herron,28,187,65,122,2005,total_driving
T76,T76,Phil Mickelson,21,187,26,161,2005,total_driving
T76,T76,Greg Owen,24,187,71,116,2005,total_driving
T80,T80,Jonathan Byrd,31,188,37,151,2005,total_driving
T80,T80,Jerry Kelly,31,188,155,33,2005,total_driving
82,82,Brandt Jobe,27,189,11,178,2005,total_driving
83,83,Tjaart van der Walt,19,190,140,50,2005,total_driving
T84,T84,José Coceres,22,191,184,7,2005,total_driving
T84,T84,Robert Damron,28,191,181,10,2005,total_driving
T86,T86,Arron Oberholser,21,193,145,48,2005,total_driving
T86,T86,Tiger Woods,21,193,2,191,2005,total_driving
T88,T88,Steve Allan,32,194,32,162,2005,total_driving
T88,T88,Omar Uresti,27,194,191,3,2005,total_driving
90,90,Matt Kuchar,21,195,170,25,2005,total_driving
T91,T91,Ryan Palmer,32,196,47,149,2005,total_driving
T91,T91,Bob Tway,26,196,114,82,2005,total_driving
93,93,Tom Lehman,20,197,121,76,2005,total_driving
T94,T94,Tim Clark,26,199,140,59,2005,total_driving
T94,T94,Fred Funk,30,199,197,2,2005,total_driving
T94,T94,Brendan Jones,28,199,14,185,2005,total_driving
T94,T94,Adam Scott,19,199,23,176,2005,total_driving
98,98,Phillip Price,25,200,142,58,2005,total_driving
T99,T99,Doug Barron,24,201,175,26,2005,total_driving
T99,T99,Steve Elkington,20,201,145,56,2005,total_driving
T99,T99,Retief Goosen,18,201,44,157,2005,total_driving
T102,T102,Jim Furyk,26,202,170,32,2005,total_driving
T102,T102,Jeff Hart,23,202,201,1,2005,total_driving
T102,T102,Skip Kendall,32,202,187,15,2005,total_driving
T102,T102,Justin Leonard,24,202,128,74,2005,total_driving
106,106,Scott Hend,28,203,1,202,2005,total_driving
T107,T107,Frank Lickliter II,33,204,103,101,2005,total_driving
T107,T107,Brenden Pappas,15,204,6,198,2005,total_driving
T107,T107,Kirk Triplett,18,204,187,17,2005,total_driving
T110,T110,Gavin Coles,22,205,200,5,2005,total_driving
T110,T110,John Daly,25,205,5,200,2005,total_driving
T110,T110,Tom Gillis,28,205,133,72,2005,total_driving
T110,T110,Pat Perez,28,205,68,137,2005,total_driving
T110,T110,Carl Pettersson,34,205,70,135,2005,total_driving
115,115,Hank Kuehne,30,206,7,199,2005,total_driving
116,116,Robert Gamez,28,208,162,46,2005,total_driving
T117,T117,John Elliott,25,209,13,196,2005,total_driving
T117,T117,Tag Ridings,31,209,20,189,2005,total_driving
119,119,Luke Donald,18,210,135,75,2005,total_driving
120,120,Larry Mize,18,211,192,19,2005,total_driving
T121,T121,Tom Byrum,27,213,195,18,2005,total_driving
T121,T121,Fred Couples,22,213,39,174,2005,total_driving
T121,T121,Peter Lonard,27,213,93,120,2005,total_driving
T124,T124,Jim Carter,25,215,185,30,2005,total_driving
T124,T124,Dan Forsman,17,215,52,163,2005,total_driving
T124,T124,Shaun Micheel,29,215,101,114,2005,total_driving
T124,T124,Mark Wilson,25,215,174,41,2005,total_driving
T128,T128,John Cook,26,217,196,21,2005,total_driving
T128,T128,Neal Lancaster,31,217,58,159,2005,total_driving
T128,T128,Stephen Leaney,29,217,182,35,2005,total_driving
T131,T131,Scott McCarron,24,218,77,141,2005,total_driving
T131,T131,Dennis Paulson,24,218,30,188,2005,total_driving
T131,T131,Jeff Sluman,28,218,176,42,2005,total_driving
T131,T131,Dean Wilson,27,218,152,66,2005,total_driving
T135,T135,Bob Estes,25,219,142,77,2005,total_driving
T135,T135,Shigeki Maruyama,29,219,98,121,2005,total_driving
137,137,Jason Allred,29,221,20,201,2005,total_driving
T138,T138,Danny Briggs,29,222,185,37,2005,total_driving
T138,T138,Daniel Chopra,34,222,35,187,2005,total_driving
T138,T138,Chris Riley,25,222,178,44,2005,total_driving
T138,T138,Rory Sabbatini,26,222,36,186,2005,total_driving
142,142,Carlos Franco,25,223,48,175,2005,total_driving
143,143,Steve Jones,20,224,167,57,2005,total_driving
144,144,Glen Day,27,225,118,107,2005,total_driving
145,145,Todd Hamilton,31,227,110,117,2005,total_driving
146,146,Charles Howell III,29,228,56,172,2005,total_driving
T147,T147,Paul Gow,27,230,178,52,2005,total_driving
T147,T147,Brett Quigley,31,230,59,171,2005,total_driving
T147,T147,Patrick Sheehan,35,230,96,134,2005,total_driving
150,150,Loren Roberts,18,231,197,34,2005,total_driving
151,151,Jesper Parnevik,24,232,64,168,2005,total_driving
152,152,Brian Gay,33,233,193,40,2005,total_driving
T153,T153,Matt Davidson,20,234,165,69,2005,total_driving
T153,T153,Bill Glasson,21,234,139,95,2005,total_driving
T153,T153,Joe Ogilvie,30,234,131,103,2005,total_driving
T156,T156,Woody Austin,30,235,93,142,2005,total_driving
T156,T156,Mark Brooks,28,235,199,36,2005,total_driving
T156,T156,Steve Flesch,30,235,138,97,2005,total_driving
159,159,James Driscoll,26,237,42,195,2005,total_driving
160,160,Ian Poulter,20,239,132,107,2005,total_driving
161,161,Mike Weir,23,240,158,82,2005,total_driving
T162,T162,Billy Andrade,26,241,151,90,2005,total_driving
T162,T162,Bob Heintz,24,241,71,170,2005,total_driving
164,164,Padraig Harrington,15,243,54,189,2005,total_driving
T165,T165,Ben Crane,21,244,61,183,2005,total_driving
T165,T165,Charlie Wi,23,244,129,115,2005,total_driving
T167,T167,Hunter Haas,28,247,88,159,2005,total_driving
T167,T167,Corey Pavin,23,247,202,45,2005,total_driving
169,169,Jay Haas,16,249,187,62,2005,total_driving
170,170,Dudley Hart,29,250,127,123,2005,total_driving
T171,T171,Justin Bolli,24,252,96,156,2005,total_driving
T171,T171,Ryuji Imada,25,252,85,167,2005,total_driving
173,173,Stephen Ames,24,254,122,132,2005,total_driving
174,174,Michael Allen,30,257,65,192,2005,total_driving
T175,T175,Chris Anderson,25,258,177,81,2005,total_driving
T175,T175,Ben Curtis,24,258,170,88,2005,total_driving
T175,T175,Brent Geiberger,21,258,162,96,2005,total_driving
T175,T175,Glen Hnatiuk,21,258,148,110,2005,total_driving
179,179,Todd Fischer,35,260,187,73,2005,total_driving
T180,T180,Matt Gogel,28,261,169,92,2005,total_driving
T180,T180,José María Olazábal,16,261,103,158,2005,total_driving
182,182,Bernhard Langer,19,262,93,169,2005,total_driving
183,183,Hideto Tanihara,20,264,135,129,2005,total_driving
184,184,Freddie Jacobson,23,266,90,176,2005,total_driving
T185,T185,Aaron Baddeley,27,268,74,194,2005,total_driving
T185,T185,Andrew Magee,29,268,87,181,2005,total_driving
T187,T187,Paul Azinger,22,269,133,136,2005,total_driving
T187,T187,Stewart Cink,26,269,126,143,2005,total_driving
189,189,Rich Beem,26,270,106,164,2005,total_driving
190,190,Kevin Na,32,285,167,118,2005,total_driving
191,191,Chris DiMarco,24,289,164,125,2005,total_driving
192,192,Thomas Levet,20,290,110,180,2005,total_driving
T193,T193,J.P. Hayes,22,297,153,144,2005,total_driving
T193,T193,Tim Petrovic,32,297,118,179,2005,total_driving
195,195,Lee Janzen,26,309,125,184,2005,total_driving
196,196,Craig Perks,27,315,122,193,2005,total_driving
197,197,Mark O'Meara,21,316,183,133,2005,total_driving
198,198,Rob Rashell,25,318,166,152,2005,total_driving
199,199,Steve Stricker,21,326,129,197,2005,total_driving
200,200,Len Mattiace,34,328,178,150,2005,total_driving
T201,T201,Brad Faxon,23,332,194,138,2005,total_driving
T201,T201,Franklin Langham,31,332,159,173,2005,total_driving
