RANK THIS WEEK,RANK LAST WEEK,PLAYER NAME,EVENTS,TOTAL,DISTANCE RANK,ACCURACY RANK,year,measure,RANK THIS WEEK
1,1,Jeff Brehaut,34,79,62,17,2004,total_driving,NA
2,2,John Senden,28,94,23,71,2004,total_driving,NA
T3,T3,Ted Purdy,35,99,76,23,2004,total_driving,NA
T3,T3,Lucas Glover,30,99,6,93,2004,total_driving,NA
T5,6,J.J. Henry,30,101,10,91,2004,total_driving,NA
T5,5,Joe Durant,26,101,97,4,2004,total_driving,NA
7,8,Jason Bohn,29,110,41,69,2004,total_driving,NA
8,9,Craig Barlow,25,111,61,50,2004,total_driving,NA
9,10,Brian Bateman,24,113,48,65,2004,total_driving,NA
10,T11,Bo Van Pelt,30,114,36,78,2004,total_driving,NA
11,T11,Robert Allenby,26,116,34,82,2004,total_driving,NA
12,13,Harrison Frazar,25,117,18,99,2004,total_driving,NA
13,14,Jay Williamson,33,118,85,33,2004,total_driving,NA
T14,15,Cameron Beckman,30,121,59,62,2004,total_driving,NA
T14,16,Geoff Ogilvy,26,121,7,114,2004,total_driving,NA
T16,T17,Scott McCarron,27,123,39,84,2004,total_driving,NA
T16,T17,Joey Sindelar,31,123,53,70,2004,total_driving,NA
18,T20,Vaughn Taylor,27,125,46,79,2004,total_driving,NA
19,T20,Tom Lehman,19,126,97,29,2004,total_driving,NA
20,T22,Mike Heinen,17,127,4,123,2004,total_driving,NA
21,19,Zach Johnson,30,128,113,15,2004,total_driving,NA
22,T22,Roland Thatcher,23,129,43,86,2004,total_driving,NA
23,24,Kent Jones,32,130,103,27,2004,total_driving,NA
24,25,Pat Perez,32,134,54,80,2004,total_driving,NA
25,26,John Rollins,29,137,101,36,2004,total_driving,NA
26,27,Billy Mayfair,32,140,118,22,2004,total_driving,NA
27,28,Notah Begay III,23,141,110,31,2004,total_driving,NA
28,T30,Ryan Palmer,33,142,29,113,2004,total_driving,NA
29,29,Brent Geiberger,31,143,56,87,2004,total_driving,NA
T30,32,Bart Bryant,23,145,138,7,2004,total_driving,NA
T30,T30,Steve Elkington,20,145,100,45,2004,total_driving,NA
32,33,Mark Calcavecchia,24,148,56,92,2004,total_driving,NA
33,35,Olin Browne,30,150,142,8,2004,total_driving,NA
34,36,Phil Mickelson,22,151,30,121,2004,total_driving,NA
T35,T37,Jonathan Kaye,25,152,62,90,2004,total_driving,NA
T35,T40,Mark Wilson,19,152,138,14,2004,total_driving,NA
T37,39,Frank Lickliter II,27,154,94,60,2004,total_driving,NA
T37,T40,Kenny Perry,23,154,26,128,2004,total_driving,NA
39,T42,Matt Gogel,25,155,113,42,2004,total_driving,NA
T40,T42,Briny Baird,30,156,73,83,2004,total_driving,NA
T40,T44,Tom Pernice Jr.,31,156,109,47,2004,total_driving,NA
T40,T44,Rocco Mediate,19,156,131,25,2004,total_driving,NA
T40,47,Duffy Waldorf,26,156,116,40,2004,total_driving,NA
T40,T44,J.L. Lewis,32,156,83,73,2004,total_driving,NA
45,T48,Arron Oberholser,23,159,122,37,2004,total_driving,NA
46,T48,Rich Beem,28,160,22,138,2004,total_driving,NA
T47,51,Chris Smith,33,161,5,156,2004,total_driving,NA
T47,T52,Hidemichi Tanaka,27,161,150,11,2004,total_driving,NA
T47,T52,Kevin Sutherland,27,161,105,56,2004,total_driving,NA
T50,T56,Robert Gamez,31,162,85,77,2004,total_driving,NA
T50,55,Jonathan Byrd,27,162,28,134,2004,total_driving,NA
T52,T56,Dennis Paulson,21,163,14,149,2004,total_driving,NA
T52,T48,Vijay Singh,29,163,13,150,2004,total_driving,NA
T54,34,Retief Goosen,16,164,38,126,2004,total_driving,NA
T54,T59,Brian Kortan,24,164,47,117,2004,total_driving,NA
T56,T59,Richard Johnson,32,165,131,34,2004,total_driving,NA
T56,58,Davis Love III,24,165,14,151,2004,total_driving,NA
58,T37,Stuart Appleby,25,167,42,125,2004,total_driving,NA
59,61,Woody Austin,29,168,56,112,2004,total_driving,NA
60,T62,D.J. Brigman,27,169,65,104,2004,total_driving,NA
T61,T62,Steve Allan,33,170,11,159,2004,total_driving,NA
T61,T64,David Branshaw,30,170,110,60,2004,total_driving,NA
T61,T66,John Huston,20,170,103,67,2004,total_driving,NA
T61,T52,Stephen Ames,27,170,89,81,2004,total_driving,NA
65,T66,José Coceres,20,172,166,6,2004,total_driving,NA
66,T64,Mark Hensby,29,173,122,51,2004,total_driving,NA
T67,T66,Scott Verplank,24,175,173,2,2004,total_driving,NA
T67,71,Heath Slocum,31,175,157,18,2004,total_driving,NA
69,69,Hunter Mahan,30,176,45,131,2004,total_driving,NA
70,70,Charles Howell III,30,177,82,95,2004,total_driving,NA
71,T72,Kris Cox,26,178,16,162,2004,total_driving,NA
T72,T72,Glen Day,33,179,107,72,2004,total_driving,NA
T72,T72,Kirk Triplett,24,179,167,12,2004,total_driving,NA
T74,76,Tim Clark,26,181,168,13,2004,total_driving,NA
T74,75,Roger Tambellini,28,181,21,160,2004,total_driving,NA
T76,T77,Jeff Maggert,20,183,148,35,2004,total_driving,NA
T76,T77,Hirofumi Miyase,27,183,163,20,2004,total_driving,NA
78,T77,Deane Pappas,22,184,32,152,2004,total_driving,NA
79,T81,Andre Stolz,20,185,20,165,2004,total_driving,NA
80,T81,Justin Leonard,25,187,134,53,2004,total_driving,NA
81,T83,Scott Simpson,18,188,169,19,2004,total_driving,NA
T82,T85,Chris Couch,24,189,8,181,2004,total_driving,NA
T82,T85,Chad Campbell,28,189,87,102,2004,total_driving,NA
T82,T83,Matt Kuchar,28,189,94,95,2004,total_driving,NA
T85,T85,Scott Hend,29,191,2,189,2004,total_driving,NA
T85,T90,Patrick Sheehan,33,191,72,119,2004,total_driving,NA
T85,80,Tiger Woods,19,191,9,182,2004,total_driving,NA
T85,T88,Skip Kendall,29,191,146,45,2004,total_driving,NA
T89,T93,Scott Hoch,17,192,154,38,2004,total_driving,NA
T89,T93,Tag Ridings,18,192,12,180,2004,total_driving,NA
T89,T90,Luke Donald,21,192,162,30,2004,total_driving,NA
T89,T93,Jason Dufner,28,192,65,127,2004,total_driving,NA
T93,T88,Fred Funk,29,193,192,1,2004,total_driving,NA
T93,T90,Jerry Kelly,29,193,172,21,2004,total_driving,NA
T95,T93,John Daly,22,195,3,192,2004,total_driving,NA
T95,T98,Tom Byrum,25,195,190,5,2004,total_driving,NA
T95,T103,Daniel Chopra,33,195,26,169,2004,total_driving,NA
T98,T101,Peter Lonard,23,196,54,142,2004,total_driving,NA
T98,T103,Kevin Na,32,196,157,39,2004,total_driving,NA
T98,100,Craig Bowden,30,196,193,3,2004,total_driving,NA
T101,T103,Dicky Pride,23,197,153,44,2004,total_driving,NA
T101,T101,Hank Kuehne,30,197,1,196,2004,total_driving,NA
T103,T107,Danny Briggs,28,199,125,74,2004,total_driving,NA
T103,106,Tommy Armour III,28,199,70,129,2004,total_driving,NA
T105,T113,Fred Couples,16,201,35,166,2004,total_driving,NA
T105,T109,Omar Uresti,28,201,191,10,2004,total_driving,NA
T107,T109,Spike McRoy,33,202,145,57,2004,total_driving,NA
T107,T109,Robert Damron,28,202,178,24,2004,total_driving,NA
T109,117,J.P. Hayes,27,203,152,51,2004,total_driving,NA
T109,T113,John Cook,19,203,194,9,2004,total_driving,NA
T111,T107,Ernie Els,16,204,19,185,2004,total_driving,NA
T111,T109,Rod Pampling,26,204,50,154,2004,total_driving,NA
T111,T98,Adam Scott,16,204,30,174,2004,total_driving,NA
T111,T93,Sergio Garcia,18,204,33,171,2004,total_driving,NA
115,T113,Tim Petrovic,32,205,97,108,2004,total_driving,NA
116,T118,Rich Barcelo,26,206,43,163,2004,total_driving,NA
117,T118,Pat Bates,32,207,181,26,2004,total_driving,NA
T118,T113,Darren Clarke,16,208,78,130,2004,total_driving,NA
T118,T120,Justin Rose,22,208,65,143,2004,total_driving,NA
T120,T123,Rory Sabbatini,26,209,48,161,2004,total_driving,NA
T120,122,Shaun Micheel,27,209,93,116,2004,total_driving,NA
T122,T120,Tom Carter,35,210,24,186,2004,total_driving,NA
T122,T123,Alex Cejka,24,210,110,100,2004,total_driving,NA
124,T123,Carl Pettersson,28,211,64,147,2004,total_driving,NA
T125,T123,Brenden Pappas,34,212,17,195,2004,total_driving,NA
T125,T128,Corey Pavin,23,212,196,16,2004,total_driving,NA
T125,T128,Guy Boros,24,212,149,63,2004,total_driving,NA
T125,T123,Jay Delsing,26,212,79,133,2004,total_driving,NA
T129,131,Jeff Sluman,28,213,165,48,2004,total_driving,NA
T129,130,Tim Herron,26,213,40,173,2004,total_driving,NA
131,132,Brett Quigley,31,214,37,177,2004,total_driving,NA
132,T134,Steve Pate,24,216,128,88,2004,total_driving,NA
T133,136,Chris DiMarco,27,217,176,41,2004,total_driving,NA
T133,133,Niclas Fasth,22,217,77,140,2004,total_driving,NA
T135,T137,Dan Olsen,31,219,25,194,2004,total_driving,NA
T135,T137,Ben Crane,27,219,125,94,2004,total_driving,NA
T137,T137,Mathias Grönberg,32,220,50,170,2004,total_driving,NA
T137,T137,David Morland IV,27,220,188,32,2004,total_driving,NA
T137,142,Gene Sauers,30,220,156,64,2004,total_driving,NA
T140,T146,Danny Ellis,26,221,101,120,2004,total_driving,NA
T140,141,Arjun Atwal,30,221,73,148,2004,total_driving,NA
T142,T146,Stephen Leaney,24,223,135,88,2004,total_driving,NA
T142,T143,Loren Roberts,22,223,195,28,2004,total_driving,NA
144,T146,Joe Ogilvie,32,224,79,145,2004,total_driving,NA
T145,149,Neal Lancaster,33,227,52,175,2004,total_driving,NA
T145,150,Len Mattiace,25,227,173,54,2004,total_driving,NA
T145,T134,Carlos Franco,27,227,69,158,2004,total_driving,NA
T148,T152,Dudley Hart,23,228,113,115,2004,total_driving,NA
T148,T143,David Toms,24,228,117,111,2004,total_driving,NA
150,T143,Steve Flesch,31,229,161,68,2004,total_driving,NA
151,T154,Russ Cochran,25,230,155,75,2004,total_driving,NA
T152,T154,Esteban Toledo,36,231,182,49,2004,total_driving,NA
T152,T152,Nick Price,15,231,188,43,2004,total_driving,NA
154,T154,Greg Chalmers,22,233,94,139,2004,total_driving,NA
T155,T157,Bob Burns,30,235,180,55,2004,total_driving,NA
T155,159,Ben Curtis,20,235,138,97,2004,total_driving,NA
157,151,Stewart Cink,28,238,70,168,2004,total_driving,NA
T158,T157,Mike Weir,22,239,138,101,2004,total_driving,NA
T158,T160,Michael Allen,28,239,60,179,2004,total_driving,NA
T158,T160,Lee Janzen,25,239,107,132,2004,total_driving,NA
T161,162,Dan Forsman,28,240,142,98,2004,total_driving,NA
T161,163,Grant Waite,29,240,83,157,2004,total_driving,NA
T163,T164,Tripp Isenhour,22,242,106,136,2004,total_driving,NA
T163,T164,Jesper Parnevik,24,242,89,153,2004,total_driving,NA
165,166,Mark Brooks,31,243,184,59,2004,total_driving,NA
166,167,Mark O'Meara,17,245,187,58,2004,total_driving,NA
T167,168,Brian Gay,32,248,163,85,2004,total_driving,NA
T167,169,Kevin Muncrief,21,248,65,183,2004,total_driving,NA
T169,T170,David Peoples,26,251,146,105,2004,total_driving,NA
T169,T170,Steve Lowery,28,251,79,172,2004,total_driving,NA
171,172,David Frost,26,252,186,66,2004,total_driving,NA
T172,T173,Cliff Kresge,33,253,131,122,2004,total_driving,NA
T172,175,Dean Wilson,33,253,136,117,2004,total_driving,NA
174,T176,Jay Haas,23,259,183,76,2004,total_driving,NA
175,180,Bernhard Langer,15,260,136,124,2004,total_driving,NA
T176,T178,Blaine McCallister,27,261,151,110,2004,total_driving,NA
T176,T176,Craig Perks,27,261,73,188,2004,total_driving,NA
T178,T173,Shigeki Maruyama,26,264,157,107,2004,total_driving,NA
T178,181,John Riegger,17,264,120,144,2004,total_driving,NA
180,T178,K.J. Choi,24,266,120,146,2004,total_driving,NA
181,183,Bob Estes,23,272,170,102,2004,total_driving,NA
182,182,Freddie Jacobson,24,273,89,184,2004,total_driving,NA
183,184,Bob Tway,26,275,170,105,2004,total_driving,NA
184,185,Aaron Baddeley,27,278,87,191,2004,total_driving,NA
185,186,Tommy Tolles,25,282,92,190,2004,total_driving,NA
186,187,Billy Andrade,31,283,128,155,2004,total_driving,NA
187,T189,Ken Duke,30,287,124,163,2004,total_driving,NA
188,T189,Craig Parry,16,288,179,109,2004,total_driving,NA
189,192,Todd Fischer,33,294,157,137,2004,total_driving,NA
T190,188,Todd Hamilton,27,295,128,167,2004,total_driving,NA
T190,191,Paul Azinger,23,295,119,176,2004,total_driving,NA
192,193,Chris Riley,23,311,176,135,2004,total_driving,NA
193,194,David Gossett,25,312,125,187,2004,total_driving,NA
194,195,Brad Faxon,28,326,185,141,2004,total_driving,NA
195,196,Steve Stricker,27,337,144,193,2004,total_driving,NA
196,197,José María Olazábal,17,353,175,178,2004,total_driving,NA
1,1,David Hearn,24,72,45,27,2005,total_driving,NA
2,2,Kenny Perry,23,98,9,89,2005,total_driving,NA
3,4,Harrison Frazar,31,104,17,87,2005,total_driving,NA
4,3,Joe Durant,25,105,92,13,2005,total_driving,NA
5,5,Charles Warren,31,106,27,79,2005,total_driving,NA
6,6,Mathias Grönberg,19,108,15,93,2005,total_driving,NA
7,7,Bradley Hughes,20,113,75,38,2005,total_driving,NA
8,8,Joey Snyder III,31,118,68,50,2005,total_driving,NA
9,9,Billy Mayfair,31,125,103,22,2005,total_driving,NA
10,T10,John Senden,29,131,77,54,2005,total_driving,NA
11,T16,Will MacKenzie,25,132,20,112,2005,total_driving,NA
T12,T10,Zach Johnson,30,133,86,47,2005,total_driving,NA
T12,T12,Michael Long,26,133,29,104,2005,total_driving,NA
T12,T14,John Rollins,30,133,49,84,2005,total_driving,NA
15,T14,Jeff Brehaut,23,134,114,20,2005,total_driving,NA
T16,T18,Justin Rose,28,136,51,85,2005,total_driving,NA
T16,T12,Ted Purdy,34,136,45,91,2005,total_driving,NA
T16,T18,D.J. Brigman,26,136,42,94,2005,total_driving,NA
19,T16,Roland Thatcher,26,137,67,70,2005,total_driving,NA
20,T25,Mark Calcavecchia,27,140,91,49,2005,total_driving,NA
21,T23,Robert Allenby,31,142,33,109,2005,total_driving,NA
22,22,Briny Baird,33,143,100,43,2005,total_driving,NA
23,T23,Joey Sindelar,29,144,113,31,2005,total_driving,NA
T24,T25,Richard Johnson,16,145,117,28,2005,total_driving,NA
T24,T25,Jonathan Kaye,24,145,80,65,2005,total_driving,NA
26,21,Sean O'Hair,29,150,23,127,2005,total_driving,NA
T27,20,Lucas Glover,28,151,12,139,2005,total_driving,NA
T27,T28,Jeff Maggert,25,151,135,16,2005,total_driving,NA
T27,T28,J.L. Lewis,30,151,71,80,2005,total_driving,NA
T30,T31,Bart Bryant,26,153,147,6,2005,total_driving,NA
T30,30,Alex Cejka,31,153,114,39,2005,total_driving,NA
32,33,Bo Van Pelt,33,157,59,98,2005,total_driving,NA
T33,T41,D.J. Trahan,28,159,41,118,2005,total_driving,NA
T33,35,Craig Barlow,26,159,88,71,2005,total_driving,NA
35,36,John Huston,31,161,56,105,2005,total_driving,NA
T36,34,David Toms,25,162,107,55,2005,total_driving,NA
T36,T37,Vaughn Taylor,32,162,84,78,2005,total_driving,NA
T38,45,Sergio Garcia,20,163,10,153,2005,total_driving,NA
T38,T37,Kent Jones,32,163,102,61,2005,total_driving,NA
T38,T37,Marco Dawson,23,163,63,100,2005,total_driving,NA
T38,T37,Brian Davis,23,163,155,8,2005,total_driving,NA
T42,T46,Lee Westwood,15,164,38,126,2005,total_driving,NA
T42,T31,Vijay Singh,30,164,16,148,2005,total_driving,NA
T44,50,Chris Smith,32,165,18,147,2005,total_driving,NA
T44,T46,Tommy Armour III,29,165,112,53,2005,total_driving,NA
T44,T43,Paul Claxton,29,165,153,12,2005,total_driving,NA
T44,T43,Darron Stiles,26,165,142,23,2005,total_driving,NA
T44,T46,J.J. Henry,32,165,34,131,2005,total_driving,NA
T44,T41,K.J. Choi,24,165,98,67,2005,total_driving,NA
T50,T56,Kevin Stadler,33,168,23,145,2005,total_driving,NA
T50,T51,D.A. Points,33,168,82,86,2005,total_driving,NA
T50,T46,Rocco Mediate,24,168,108,60,2005,total_driving,NA
T50,T59,Scott Verplank,25,168,159,9,2005,total_driving,NA
T54,T51,Jay Williamson,16,169,155,14,2005,total_driving,NA
T54,T54,Scott Gutschewski,27,169,4,165,2005,total_driving,NA
T56,T56,Geoff Ogilvy,26,170,31,139,2005,total_driving,NA
T56,53,Heath Slocum,29,170,159,11,2005,total_driving,NA
58,T54,Duffy Waldorf,28,172,149,23,2005,total_driving,NA
T59,T59,Stuart Appleby,25,174,19,155,2005,total_driving,NA
T59,T56,Davis Love III,24,174,8,166,2005,total_driving,NA
61,63,Jason Bohn,28,175,62,113,2005,total_driving,NA
T62,62,Kevin Sutherland,26,176,108,68,2005,total_driving,NA
T62,T59,Chad Campbell,27,176,52,124,2005,total_driving,NA
64,T64,Olin Browne,29,177,173,4,2005,total_driving,NA
T65,T66,Tom Pernice Jr.,32,179,80,99,2005,total_driving,NA
T65,T66,Hidemichi Tanaka,34,179,150,29,2005,total_driving,NA
67,69,Arjun Atwal,17,180,50,130,2005,total_driving,NA
68,T73,Nick Watney,31,182,28,154,2005,total_driving,NA
T69,T71,Hunter Mahan,34,183,55,128,2005,total_driving,NA
T69,70,Cameron Beckman,31,183,120,63,2005,total_driving,NA
T69,T71,Steve Lowery,32,183,77,106,2005,total_driving,NA
T72,T73,Mark Hensby,21,185,83,102,2005,total_driving,NA
T72,T75,Brett Wetterich,28,185,3,182,2005,total_driving,NA
T74,T80,Rod Pampling,26,186,40,146,2005,total_driving,NA
T74,T75,Mario Tiziani,23,186,122,64,2005,total_driving,NA
T76,T64,Tim Herron,28,187,65,122,2005,total_driving,NA
T76,T80,Greg Owen,24,187,71,116,2005,total_driving,NA
T76,79,Phil Mickelson,21,187,26,161,2005,total_driving,NA
T76,T80,Brian Bateman,32,187,76,111,2005,total_driving,NA
T80,T83,Jonathan Byrd,31,188,37,151,2005,total_driving,NA
T80,78,Jerry Kelly,31,188,155,33,2005,total_driving,NA
82,T66,Brandt Jobe,27,189,11,178,2005,total_driving,NA
83,T87,Tjaart van der Walt,19,190,140,50,2005,total_driving,NA
T84,T85,José Coceres,22,191,184,7,2005,total_driving,NA
T84,T85,Robert Damron,28,191,181,10,2005,total_driving,NA
T86,T90,Arron Oberholser,21,193,145,48,2005,total_driving,NA
T86,T83,Tiger Woods,21,193,2,191,2005,total_driving,NA
T88,89,Omar Uresti,27,194,191,3,2005,total_driving,NA
T88,T90,Steve Allan,32,194,32,162,2005,total_driving,NA
90,92,Matt Kuchar,21,195,170,25,2005,total_driving,NA
T91,93,Bob Tway,26,196,114,82,2005,total_driving,NA
T91,T94,Ryan Palmer,32,196,47,149,2005,total_driving,NA
93,T94,Tom Lehman,20,197,121,76,2005,total_driving,NA
T94,T96,Fred Funk,30,199,197,2,2005,total_driving,NA
T94,T87,Tim Clark,26,199,140,59,2005,total_driving,NA
T94,T96,Brendan Jones,28,199,14,185,2005,total_driving,NA
T94,T96,Adam Scott,19,199,23,176,2005,total_driving,NA
98,T99,Phillip Price,25,200,142,58,2005,total_driving,NA
T99,T99,Doug Barron,24,201,175,26,2005,total_driving,NA
T99,T75,Retief Goosen,18,201,44,157,2005,total_driving,NA
T99,T101,Steve Elkington,20,201,145,56,2005,total_driving,NA
T102,T101,Jeff Hart,23,202,201,1,2005,total_driving,NA
T102,T101,Skip Kendall,32,202,187,15,2005,total_driving,NA
T102,T114,Jim Furyk,26,202,170,32,2005,total_driving,NA
T102,T101,Justin Leonard,24,202,128,74,2005,total_driving,NA
106,106,Scott Hend,28,203,1,202,2005,total_driving,NA
T107,T107,Brenden Pappas,15,204,6,198,2005,total_driving,NA
T107,T109,Frank Lickliter II,33,204,103,101,2005,total_driving,NA
T107,T107,Kirk Triplett,18,204,187,17,2005,total_driving,NA
T110,117,Tom Gillis,28,205,133,72,2005,total_driving,NA
T110,T109,John Daly,25,205,5,200,2005,total_driving,NA
T110,T109,Gavin Coles,22,205,200,5,2005,total_driving,NA
T110,T114,Pat Perez,28,205,68,137,2005,total_driving,NA
T110,T112,Carl Pettersson,34,205,70,135,2005,total_driving,NA
115,T112,Hank Kuehne,30,206,7,199,2005,total_driving,NA
116,T114,Robert Gamez,28,208,162,46,2005,total_driving,NA
T117,118,John Elliott,25,209,13,196,2005,total_driving,NA
T117,T120,Tag Ridings,31,209,20,189,2005,total_driving,NA
119,T101,Luke Donald,18,210,135,75,2005,total_driving,NA
120,119,Larry Mize,18,211,192,19,2005,total_driving,NA
T121,122,Fred Couples,22,213,39,174,2005,total_driving,NA
T121,T120,Tom Byrum,27,213,195,18,2005,total_driving,NA
T121,T125,Peter Lonard,27,213,93,120,2005,total_driving,NA
T124,T123,Mark Wilson,25,215,174,41,2005,total_driving,NA
T124,T123,Jim Carter,25,215,185,30,2005,total_driving,NA
T124,T125,Dan Forsman,17,215,52,163,2005,total_driving,NA
T124,T128,Shaun Micheel,29,215,101,114,2005,total_driving,NA
T128,T130,John Cook,26,217,196,21,2005,total_driving,NA
T128,T128,Neal Lancaster,31,217,58,159,2005,total_driving,NA
T128,T125,Stephen Leaney,29,217,182,35,2005,total_driving,NA
T131,133,Scott McCarron,24,218,77,141,2005,total_driving,NA
T131,T130,Dean Wilson,27,218,152,66,2005,total_driving,NA
T131,T130,Jeff Sluman,28,218,176,42,2005,total_driving,NA
T131,T134,Dennis Paulson,24,218,30,188,2005,total_driving,NA
T135,T134,Bob Estes,25,219,142,77,2005,total_driving,NA
T135,T137,Shigeki Maruyama,29,219,98,121,2005,total_driving,NA
137,T139,Jason Allred,29,221,20,201,2005,total_driving,NA
T138,T139,Rory Sabbatini,26,222,36,186,2005,total_driving,NA
T138,T137,Chris Riley,25,222,178,44,2005,total_driving,NA
T138,T141,Daniel Chopra,34,222,35,187,2005,total_driving,NA
T138,136,Danny Briggs,29,222,185,37,2005,total_driving,NA
142,T141,Carlos Franco,25,223,48,175,2005,total_driving,NA
143,143,Steve Jones,20,224,167,57,2005,total_driving,NA
144,144,Glen Day,27,225,118,107,2005,total_driving,NA
145,145,Todd Hamilton,31,227,110,117,2005,total_driving,NA
146,T150,Charles Howell III,29,228,56,172,2005,total_driving,NA
T147,T146,Patrick Sheehan,35,230,96,134,2005,total_driving,NA
T147,149,Paul Gow,27,230,178,52,2005,total_driving,NA
T147,148,Brett Quigley,31,230,59,171,2005,total_driving,NA
150,T146,Loren Roberts,18,231,197,34,2005,total_driving,NA
151,T150,Jesper Parnevik,24,232,64,168,2005,total_driving,NA
152,T150,Brian Gay,33,233,193,40,2005,total_driving,NA
T153,T150,Matt Davidson,20,234,165,69,2005,total_driving,NA
T153,T154,Joe Ogilvie,30,234,131,103,2005,total_driving,NA
T153,T154,Bill Glasson,21,234,139,95,2005,total_driving,NA
T156,T154,Mark Brooks,28,235,199,36,2005,total_driving,NA
T156,T157,Woody Austin,30,235,93,142,2005,total_driving,NA
T156,T157,Steve Flesch,30,235,138,97,2005,total_driving,NA
159,159,James Driscoll,26,237,42,195,2005,total_driving,NA
160,160,Ian Poulter,20,239,132,107,2005,total_driving,NA
161,161,Mike Weir,23,240,158,82,2005,total_driving,NA
T162,T162,Billy Andrade,26,241,151,90,2005,total_driving,NA
T162,T162,Bob Heintz,24,241,71,170,2005,total_driving,NA
164,NA,Padraig Harrington,15,243,54,189,2005,total_driving,NA
T165,165,Charlie Wi,23,244,129,115,2005,total_driving,NA
T165,164,Ben Crane,21,244,61,183,2005,total_driving,NA
T167,T166,Hunter Haas,28,247,88,159,2005,total_driving,NA
T167,T166,Corey Pavin,23,247,202,45,2005,total_driving,NA
169,168,Jay Haas,16,249,187,62,2005,total_driving,NA
170,171,Dudley Hart,29,250,127,123,2005,total_driving,NA
T171,170,Ryuji Imada,25,252,85,167,2005,total_driving,NA
T171,169,Justin Bolli,24,252,96,156,2005,total_driving,NA
173,172,Stephen Ames,24,254,122,132,2005,total_driving,NA
174,173,Michael Allen,30,257,65,192,2005,total_driving,NA
T175,T175,Glen Hnatiuk,21,258,148,110,2005,total_driving,NA
T175,T177,Ben Curtis,24,258,170,88,2005,total_driving,NA
T175,T175,Chris Anderson,25,258,177,81,2005,total_driving,NA
T175,174,Brent Geiberger,21,258,162,96,2005,total_driving,NA
179,181,Todd Fischer,35,260,187,73,2005,total_driving,NA
T180,T177,Matt Gogel,28,261,169,92,2005,total_driving,NA
T180,T179,José María Olazábal,16,261,103,158,2005,total_driving,NA
182,T179,Bernhard Langer,19,262,93,169,2005,total_driving,NA
183,T182,Hideto Tanihara,20,264,135,129,2005,total_driving,NA
184,T182,Freddie Jacobson,23,266,90,176,2005,total_driving,NA
T185,184,Aaron Baddeley,27,268,74,194,2005,total_driving,NA
T185,185,Andrew Magee,29,268,87,181,2005,total_driving,NA
T187,187,Stewart Cink,26,269,126,143,2005,total_driving,NA
T187,T188,Paul Azinger,22,269,133,136,2005,total_driving,NA
189,T188,Rich Beem,26,270,106,164,2005,total_driving,NA
190,190,Kevin Na,32,285,167,118,2005,total_driving,NA
191,186,Chris DiMarco,24,289,164,125,2005,total_driving,NA
192,191,Thomas Levet,20,290,110,180,2005,total_driving,NA
T193,192,Tim Petrovic,32,297,118,179,2005,total_driving,NA
T193,193,J.P. Hayes,22,297,153,144,2005,total_driving,NA
195,194,Lee Janzen,26,309,125,184,2005,total_driving,NA
196,195,Craig Perks,27,315,122,193,2005,total_driving,NA
197,196,Mark O'Meara,21,316,183,133,2005,total_driving,NA
198,197,Rob Rashell,25,318,166,152,2005,total_driving,NA
199,198,Steve Stricker,21,326,129,197,2005,total_driving,NA
200,199,Len Mattiace,34,328,178,150,2005,total_driving,NA
T201,200,Franklin Langham,31,332,159,173,2005,total_driving,NA
T201,201,Brad Faxon,23,332,194,138,2005,total_driving,NA
1,2,Scott Gutschewski,19,83,11,72,2006,total_driving,NA
2,1,Chris Smith,21,84,24,60,2006,total_driving,NA
3,3,Nicholas Thompson,32,89,48,41,2006,total_driving,NA
4,4,Hunter Mahan,29,91,57,34,2006,total_driving,NA
5,T5,Robert Allenby,22,93,64,29,2006,total_driving,NA
6,T5,Joe Durant,28,94,93,1,2006,total_driving,NA
7,T7,Greg Owen,24,101,54,47,2006,total_driving,NA
8,T7,Kenny Perry,22,102,69,33,2006,total_driving,NA
9,9,Charles Warren,27,104,20,84,2006,total_driving,NA
10,T11,Lucas Glover,31,114,23,91,2006,total_driving,NA
11,13,Jonathan Byrd,20,115,33,82,2006,total_driving,NA
12,14,John Senden,28,117,44,73,2006,total_driving,NA
13,15,Padraig Harrington,15,119,60,59,2006,total_driving,NA
14,16,Ian Poulter,15,120,100,20,2006,total_driving,NA
15,17,Ryan Moore,22,124,74,50,2006,total_driving,NA
16,10,Brett Wetterich,25,126,4,122,2006,total_driving,NA
17,T18,Jonathan Kaye,32,128,61,67,2006,total_driving,NA
18,T18,John Rollins,28,129,50,79,2006,total_driving,NA
19,20,Bubba Dickerson,32,132,27,105,2006,total_driving,NA
20,T22,Adam Scott,19,133,16,117,2006,total_driving,NA
21,21,Steve Elkington,17,134,127,7,2006,total_driving,NA
T22,T24,Brian Davis,28,137,115,22,2006,total_driving,NA
T22,T22,David Branshaw,29,137,102,35,2006,total_driving,NA
24,T24,Nick Watney,29,139,18,121,2006,total_driving,NA
25,26,Mathew Goggin,26,140,45,95,2006,total_driving,NA
T26,T27,Kevin Sutherland,29,143,67,76,2006,total_driving,NA
T26,T27,Will MacKenzie,29,143,40,103,2006,total_driving,NA
T28,T30,Tiger Woods,15,145,6,139,2006,total_driving,NA
T28,29,Harrison Frazar,29,145,9,136,2006,total_driving,NA
T30,T33,Henrik Bjornstad,31,146,39,107,2006,total_driving,NA
T30,T30,Rich Beem,27,146,48,98,2006,total_driving,NA
32,32,Kent Jones,32,147,110,37,2006,total_driving,NA
33,T33,Jason Bohn,29,148,95,53,2006,total_driving,NA
34,T36,Briny Baird,25,151,135,16,2006,total_driving,NA
35,35,Jeff Gove,29,152,88,64,2006,total_driving,NA
T36,T36,Alex Cejka,30,153,96,57,2006,total_driving,NA
T36,T36,Eric Axley,29,153,61,92,2006,total_driving,NA
T36,41,Duffy Waldorf,28,153,115,38,2006,total_driving,NA
39,42,Daisuke Maruyama,25,154,139,15,2006,total_driving,NA
40,40,Chris Couch,27,155,21,134,2006,total_driving,NA
41,43,Chris Riley,27,157,139,18,2006,total_driving,NA
42,T36,Davis Love III,23,158,14,144,2006,total_driving,NA
43,T45,J.P. Hayes,19,159,108,51,2006,total_driving,NA
T44,49,Brent Geiberger,30,161,113,48,2006,total_driving,NA
T44,T45,Sean O'Hair,30,161,71,90,2006,total_driving,NA
46,T45,Ted Purdy,33,162,101,61,2006,total_driving,NA
T47,44,David Toms,22,163,133,30,2006,total_driving,NA
T47,T51,Ryan Palmer,30,163,47,116,2006,total_driving,NA
T49,T53,Mathias Grönberg,30,164,54,110,2006,total_driving,NA
T49,T53,Matt Hansen,25,164,19,145,2006,total_driving,NA
T51,T51,Brandt Jobe,28,165,37,128,2006,total_driving,NA
T51,57,Jason Gore,29,165,22,143,2006,total_driving,NA
T53,50,Jim Furyk,24,167,159,8,2006,total_driving,NA
T53,56,Bart Bryant,26,167,156,11,2006,total_driving,NA
T53,T53,D.J. Trahan,33,167,81,86,2006,total_driving,NA
56,58,Heath Slocum,30,169,165,4,2006,total_driving,NA
T57,61,Justin Rose,28,171,82,89,2006,total_driving,NA
T57,T59,Zach Johnson,27,171,145,26,2006,total_driving,NA
59,T45,Geoff Ogilvy,20,172,53,119,2006,total_driving,NA
T60,T59,Trevor Immelman,24,173,58,115,2006,total_driving,NA
T60,62,Bo Van Pelt,28,173,35,138,2006,total_driving,NA
62,T63,Tjaart van der Walt,21,174,150,24,2006,total_driving,NA
63,T65,Billy Mayfair,29,175,154,21,2006,total_driving,NA
T64,T63,Paul Stankowski,22,176,51,125,2006,total_driving,NA
T64,T65,Patrick Sheehan,34,176,105,71,2006,total_driving,NA
T66,T68,Omar Uresti,22,177,171,6,2006,total_driving,NA
T66,T65,Phil Mickelson,19,177,17,160,2006,total_driving,NA
T66,T68,Charley Hoffman,29,177,10,167,2006,total_driving,NA
T69,T74,Camilo Villegas,29,178,13,165,2006,total_driving,NA
T69,T70,Jeff Maggert,26,178,164,14,2006,total_driving,NA
T69,T70,Skip Kendall,22,178,165,13,2006,total_driving,NA
T72,T74,Kirk Triplett,18,179,168,11,2006,total_driving,NA
T72,T70,Troy Matteson,32,179,28,151,2006,total_driving,NA
T74,T74,Robert Garrigus,28,180,3,177,2006,total_driving,NA
T74,77,Frank Lickliter II,29,180,125,55,2006,total_driving,NA
76,T70,K.J. Choi,26,182,112,70,2006,total_driving,NA
T77,T80,Jeff Brehaut,33,183,125,58,2006,total_driving,NA
T77,T84,Steve Stricker,17,183,134,49,2006,total_driving,NA
T77,T80,Larry Mize,18,183,178,5,2006,total_driving,NA
T80,T84,David McKenzie,28,184,142,42,2006,total_driving,NA
T80,T78,Pat Perez,19,184,30,154,2006,total_driving,NA
T80,T78,Kris Cox,28,184,30,154,2006,total_driving,NA
T80,T82,Richard Johnson,29,184,148,36,2006,total_driving,NA
84,T86,Brian Bateman,26,186,40,146,2006,total_driving,NA
85,T82,Jeff Overton,28,187,26,161,2006,total_driving,NA
86,T86,J.J. Henry,28,188,46,142,2006,total_driving,NA
T87,T86,J.B. Holmes,26,189,2,187,2006,total_driving,NA
T87,T89,Steve Flesch,33,189,124,65,2006,total_driving,NA
T87,T89,Scott Verplank,25,189,186,3,2006,total_driving,NA
T87,T89,Stephen Ames,21,189,88,101,2006,total_driving,NA
T87,T89,Bob May,21,189,71,118,2006,total_driving,NA
T92,T93,Joe Ogilvie,29,192,107,85,2006,total_driving,NA
T92,T93,Bubba Watson,27,192,1,191,2006,total_driving,NA
T94,96,Ron Whittaker,28,193,161,32,2006,total_driving,NA
T94,95,Olin Browne,30,193,184,9,2006,total_driving,NA
T96,T97,John Daly,21,195,5,190,2006,total_driving,NA
T96,102,Freddie Jacobson,18,195,84,111,2006,total_driving,NA
T98,99,Fred Funk,29,196,194,2,2006,total_driving,NA
T98,T97,Tag Ridings,33,196,8,188,2006,total_driving,NA
100,T100,Luke Donald,18,197,145,52,2006,total_driving,NA
T101,T100,Roger Tambellini,25,198,24,174,2006,total_driving,NA
T101,T103,Jerry Kelly,31,198,179,19,2006,total_driving,NA
T103,T103,John Cook,22,199,182,17,2006,total_driving,NA
T103,T106,Justin Leonard,26,199,154,45,2006,total_driving,NA
T105,T110,Thomas Levet,18,200,113,87,2006,total_driving,NA
T105,T106,Arjun Atwal,33,200,102,98,2006,total_driving,NA
T105,T103,Sergio Garcia,17,200,71,129,2006,total_driving,NA
T108,T110,Mike Sposa,25,201,138,63,2006,total_driving,NA
T108,T108,Fred Couples,17,201,15,186,2006,total_driving,NA
T108,T110,Robert Gamez,30,201,174,27,2006,total_driving,NA
T108,T108,Ryan Hietala,23,201,7,194,2006,total_driving,NA
112,T110,Paul Goydos,24,202,192,10,2006,total_driving,NA
T113,T115,Marco Dawson,27,203,77,126,2006,total_driving,NA
T113,118,Mark Wilson,24,203,157,46,2006,total_driving,NA
115,117,Alex Aragon,26,204,12,192,2006,total_driving,NA
116,119,Jerry Smith,29,205,180,25,2006,total_driving,NA
T117,T122,Tommy Armour III,25,206,152,54,2006,total_driving,NA
T117,T126,David Howell,14,206,93,113,2006,total_driving,NA
T117,T120,Danny Ellis,23,206,66,140,2006,total_driving,NA
T117,T124,D.A. Points,28,206,92,114,2006,total_driving,NA
121,T124,Bob Estes,25,207,120,87,2006,total_driving,NA
T122,T122,Ian Leggatt,29,208,77,131,2006,total_driving,NA
T122,T120,Daniel Chopra,33,208,29,179,2006,total_driving,NA
T124,T126,Jesper Parnevik,24,209,86,123,2006,total_driving,NA
T124,T131,Joey Sindelar,29,209,143,66,2006,total_driving,NA
T126,130,Greg Kraft,26,210,187,23,2006,total_driving,NA
T126,T115,Retief Goosen,18,210,34,176,2006,total_driving,NA
T126,T126,Bill Haas,30,210,40,170,2006,total_driving,NA
T126,T126,Jon Mills,27,210,32,178,2006,total_driving,NA
130,134,Vaughn Taylor,26,212,115,97,2006,total_driving,NA
131,T131,Tom Pernice Jr.,33,213,144,69,2006,total_driving,NA
132,T138,Shaun Micheel,29,217,97,120,2006,total_driving,NA
133,T136,Vijay Singh,27,218,65,153,2006,total_driving,NA
T134,T145,Steve Lowery,31,219,110,109,2006,total_driving,NA
T134,T142,Shane Bertsch,34,219,176,43,2006,total_driving,NA
T136,T142,Brian Gay,31,220,189,31,2006,total_driving,NA
T136,T142,Mark Brooks,36,220,192,28,2006,total_driving,NA
T136,T145,Mark Calcavecchia,27,220,152,68,2006,total_driving,NA
T136,T138,Tim Herron,27,220,59,161,2006,total_driving,NA
T140,148,Ben Crane,26,221,127,94,2006,total_driving,NA
T140,141,Jason Schultz,28,221,69,152,2006,total_driving,NA
142,135,Stewart Cink,26,223,75,148,2006,total_driving,NA
143,T138,Ernie Els,18,225,54,171,2006,total_driving,NA
144,T149,Tim Clark,22,227,183,44,2006,total_driving,NA
T145,T151,Doug Barron,28,228,188,40,2006,total_driving,NA
T145,T149,David Duval,24,228,35,193,2006,total_driving,NA
147,T151,Craig Barlow,22,229,63,166,2006,total_driving,NA
148,T136,Chad Campbell,25,230,83,147,2006,total_driving,NA
149,T153,Woody Austin,31,231,102,129,2006,total_driving,NA
T150,T159,Paul Azinger,30,233,127,106,2006,total_driving,NA
T150,155,John Huston,27,233,75,158,2006,total_driving,NA
T150,T145,Ben Curtis,26,233,177,56,2006,total_driving,NA
T150,T153,Charles Howell III,30,233,51,182,2006,total_driving,NA
154,T156,Jimmy Walker,21,234,38,196,2006,total_driving,NA
T155,T159,Aaron Baddeley,25,235,98,137,2006,total_driving,NA
T155,158,Corey Pavin,23,235,196,39,2006,total_driving,NA
157,T164,Billy Andrade,24,236,132,104,2006,total_driving,NA
158,162,James Driscoll,29,238,43,195,2006,total_driving,NA
159,166,Bernhard Langer,24,239,127,112,2006,total_driving,NA
T160,163,Rod Pampling,24,240,99,141,2006,total_driving,NA
T160,T156,Stuart Appleby,23,240,90,150,2006,total_driving,NA
162,T159,Arron Oberholser,23,244,136,108,2006,total_driving,NA
T163,T164,Dean Wilson,34,245,149,96,2006,total_driving,NA
T163,T167,Shigeki Maruyama,30,245,122,123,2006,total_driving,NA
165,T167,Michael Allen,25,246,79,167,2006,total_driving,NA
T166,T176,Carl Pettersson,28,247,115,132,2006,total_driving,NA
T166,170,Stephen Leaney,27,247,185,62,2006,total_driving,NA
T166,171,Jeff Sluman,29,247,172,75,2006,total_driving,NA
T169,T172,Mike Weir,24,248,165,83,2006,total_driving,NA
T169,T167,Brett Quigley,33,248,91,157,2006,total_driving,NA
171,T172,"Wes Short, Jr.",33,249,80,169,2006,total_driving,NA
172,T174,Tom Lehman,20,250,115,135,2006,total_driving,NA
173,T176,Peter Lonard,22,251,170,81,2006,total_driving,NA
T174,T174,Carlos Franco,29,253,68,185,2006,total_driving,NA
T174,178,J.L. Lewis,17,253,173,80,2006,total_driving,NA
T174,179,Chris DiMarco,26,253,175,78,2006,total_driving,NA
T177,T180,José María Olazábal,18,257,108,149,2006,total_driving,NA
T177,T180,Nathan Green,30,257,157,100,2006,total_driving,NA
179,T180,Steve Jones,27,258,181,77,2006,total_driving,NA
180,183,Tim Petrovic,30,261,168,93,2006,total_driving,NA
T181,T185,Todd Fischer,35,264,190,74,2006,total_driving,NA
T181,T185,Robert Damron,31,264,162,102,2006,total_driving,NA
183,T185,Len Mattiace,22,265,85,180,2006,total_driving,NA
184,188,Bob Tway,25,266,139,127,2006,total_driving,NA
185,184,Rory Sabbatini,24,268,87,181,2006,total_driving,NA
186,189,"John Engler, Jr.",27,270,106,164,2006,total_driving,NA
187,191,Dudley Hart,29,285,122,163,2006,total_driving,NA
188,192,Michael Connell,22,292,159,133,2006,total_driving,NA
189,193,Ryuji Imada,31,296,137,159,2006,total_driving,NA
190,194,Vance Veazey,20,299,127,172,2006,total_driving,NA
191,195,Greg Chalmers,28,309,120,189,2006,total_driving,NA
192,196,Hidemichi Tanaka,31,318,162,156,2006,total_driving,NA
193,197,Todd Hamilton,27,331,147,184,2006,total_driving,NA
194,198,Lee Janzen,28,332,150,182,2006,total_driving,NA
195,199,Mark O'Meara,18,366,191,175,2006,total_driving,NA
196,200,Brad Faxon,26,368,195,173,2006,total_driving,NA
1,1,Charles Warren,29,59,9,50,2007,total_driving,NA
2,2,Mathew Goggin,30,70,26,44,2007,total_driving,NA
3,3,Hunter Mahan,27,73,36,37,2007,total_driving,NA
4,4,Jay Williamson,14,84,72,12,2007,total_driving,NA
5,5,Kenny Perry,24,104,22,82,2007,total_driving,NA
6,6,Cameron Beckman,29,109,69,40,2007,total_driving,NA
7,7,Jason Gore,27,110,8,102,2007,total_driving,NA
8,T14,Sean O'Hair,28,113,34,79,2007,total_driving,NA
9,9,John Senden,27,115,55,60,2007,total_driving,NA
10,10,D.J. Trahan,30,116,48,68,2007,total_driving,NA
11,T12,Boo Weekley,29,118,37,81,2007,total_driving,NA
12,11,Bill Haas,30,120,11,109,2007,total_driving,NA
13,T12,Briny Baird,31,121,66,55,2007,total_driving,NA
14,8,Jeff Overton,19,122,24,98,2007,total_driving,NA
15,T14,Matt Hendrix,24,129,15,114,2007,total_driving,NA
T16,T17,Greg Owen,29,130,40,90,2007,total_driving,NA
T16,T21,Alex Cejka,25,130,94,36,2007,total_driving,NA
18,T17,Peter Lonard,27,131,80,51,2007,total_driving,NA
19,T17,Jeff Brehaut,21,133,76,57,2007,total_driving,NA
T20,T21,Billy Mayfair,30,135,117,18,2007,total_driving,NA
T20,20,Lucas Glover,29,135,46,89,2007,total_driving,NA
T22,16,Chris Stroud,24,140,87,53,2007,total_driving,NA
T22,T29,Daisuke Maruyama,28,140,98,42,2007,total_driving,NA
24,25,Ted Purdy,33,142,57,85,2007,total_driving,NA
25,26,Kent Jones,30,143,111,32,2007,total_driving,NA
T26,T29,Joe Durant,28,144,139,5,2007,total_driving,NA
T26,24,Jim Rutledge,23,144,99,45,2007,total_driving,NA
T26,T21,Ken Duke,31,144,103,41,2007,total_driving,NA
T29,T32,Michael Allen,22,146,61,85,2007,total_driving,NA
T29,28,Anthony Kim,26,146,12,134,2007,total_driving,NA
31,34,Nick Watney,26,147,17,130,2007,total_driving,NA
T32,35,Jeff Gove,30,148,84,64,2007,total_driving,NA
T32,T29,J.J. Henry,26,148,54,94,2007,total_driving,NA
34,T32,Bubba Dickerson,19,149,25,124,2007,total_driving,NA
T35,T40,Rich Beem,29,150,79,71,2007,total_driving,NA
T35,37,Tommy Armour III,24,150,126,24,2007,total_driving,NA
37,38,Robert Allenby,28,154,22,132,2007,total_driving,NA
38,27,David Branshaw,30,155,93,62,2007,total_driving,NA
39,T40,Steve Allan,18,156,12,144,2007,total_driving,NA
40,39,Ryan Armour,32,157,135,22,2007,total_driving,NA
41,T42,John Merrick,29,158,33,125,2007,total_driving,NA
42,T42,Mark Calcavecchia,28,159,86,73,2007,total_driving,NA
T43,T45,John Rollins,29,162,85,77,2007,total_driving,NA
T43,36,Jaco Van Zyl,21,162,131,31,2007,total_driving,NA
45,T45,Tiger Woods,16,164,12,152,2007,total_driving,NA
46,T45,Steve Marino,31,165,29,136,2007,total_driving,NA
47,50,Pat Perez,27,166,37,129,2007,total_driving,NA
48,T48,Darron Stiles,24,167,134,33,2007,total_driving,NA
49,T51,Bo Van Pelt,30,168,50,118,2007,total_driving,NA
T50,T62,Steve Lowery,22,169,67,102,2007,total_driving,NA
T50,T51,Camilo Villegas,24,169,27,142,2007,total_driving,NA
52,T42,Mathias Grönberg,31,170,16,154,2007,total_driving,NA
T53,T62,Tom Byrum,20,171,156,15,2007,total_driving,NA
T53,57,J.B. Holmes,24,171,3,168,2007,total_driving,NA
55,T55,Justin Leonard,29,173,148,25,2007,total_driving,NA
T56,T62,Jim Furyk,23,174,171,3,2007,total_driving,NA
T56,58,Ryan Moore,28,174,82,92,2007,total_driving,NA
T58,54,Steve Wheatcroft,25,176,122,54,2007,total_driving,NA
T58,T55,Charlie Wi,27,176,124,52,2007,total_driving,NA
T58,T59,Craig Barlow,16,176,45,131,2007,total_driving,NA
T61,T72,Brett Wetterich,28,177,7,170,2007,total_driving,NA
T61,T67,Mark Wilson,25,177,131,46,2007,total_driving,NA
T61,T78,Shaun Micheel,29,177,138,39,2007,total_driving,NA
T61,T67,Zach Johnson,23,177,169,8,2007,total_driving,NA
T61,T59,George McNeill,30,177,28,149,2007,total_driving,NA
T66,T59,Adam Scott,19,178,18,160,2007,total_driving,NA
T66,T67,Steve Elkington,25,178,164,14,2007,total_driving,NA
T66,T70,Heath Slocum,28,178,172,6,2007,total_driving,NA
69,T62,Bart Bryant,25,179,160,19,2007,total_driving,NA
T70,77,Joey Sindelar,25,180,111,69,2007,total_driving,NA
T70,T62,Michael Boyd,21,180,176,4,2007,total_driving,NA
T72,53,Duffy Waldorf,23,181,107,74,2007,total_driving,NA
T72,T80,Tag Ridings,18,181,6,175,2007,total_driving,NA
T72,T70,Jason Schultz,22,181,43,138,2007,total_driving,NA
75,T48,Chris Tidland,21,182,62,120,2007,total_driving,NA
76,T80,Jason Bohn,17,183,111,72,2007,total_driving,NA
T77,T75,Chris Riley,17,184,167,17,2007,total_driving,NA
T77,T72,Glen Day,27,184,164,20,2007,total_driving,NA
T79,74,Brian Davis,28,185,172,13,2007,total_driving,NA
T79,T88,Troy Matteson,26,185,37,148,2007,total_driving,NA
T81,T80,Tom Johnson,27,186,103,83,2007,total_driving,NA
T81,T78,Robert Gamez,30,186,159,27,2007,total_driving,NA
T83,T80,Scott Verplank,23,188,172,16,2007,total_driving,NA
T83,85,Mike Weir,23,188,92,96,2007,total_driving,NA
T83,T86,Paul Stankowski,18,188,43,145,2007,total_driving,NA
T86,T80,John Mallinger,29,189,163,26,2007,total_driving,NA
T86,T86,Bubba Watson,26,189,1,188,2007,total_driving,NA
88,T88,Scott Gutschewski,22,190,5,185,2007,total_driving,NA
T89,T93,Will MacKenzie,30,191,74,117,2007,total_driving,NA
T89,92,Justin Rose,16,191,96,95,2007,total_driving,NA
91,T90,José Coceres,17,192,191,1,2007,total_driving,NA
92,T97,Trevor Immelman,21,193,118,75,2007,total_driving,NA
T93,T97,Charley Hoffman,30,195,19,176,2007,total_driving,NA
T93,110,J.P. Hayes,28,195,69,126,2007,total_driving,NA
T93,T75,Tripp Isenhour,32,195,111,84,2007,total_driving,NA
T93,T93,Fred Funk,22,195,193,2,2007,total_driving,NA
97,T105,Jerry Kelly,28,196,162,34,2007,total_driving,NA
T98,T93,Craig Bowden,25,197,190,7,2007,total_driving,NA
T98,T97,Robert Garrigus,28,197,4,193,2007,total_driving,NA
T98,T90,Michael Sim,17,197,78,119,2007,total_driving,NA
T101,T105,Jarrod Lyle,24,198,65,133,2007,total_driving,NA
T101,T100,John Daly,24,198,2,196,2007,total_driving,NA
T101,96,Doug LaBelle II,33,198,187,11,2007,total_driving,NA
T104,T100,Harrison Frazar,32,199,9,190,2007,total_driving,NA
T104,T100,Mark Brooks,18,199,189,10,2007,total_driving,NA
106,113,Michael Putnam,29,200,53,147,2007,total_driving,NA
107,104,Stephen Ames,23,201,154,47,2007,total_driving,NA
T108,T100,Kirk Triplett,25,202,181,21,2007,total_driving,NA
T108,T105,Chris Couch,30,202,20,182,2007,total_driving,NA
T108,T105,Kyle Reifers,27,202,41,161,2007,total_driving,NA
T111,T114,Kevin Stadler,31,203,62,141,2007,total_driving,NA
T111,T114,Davis Love III,21,203,34,169,2007,total_driving,NA
T111,T114,Brian Gay,32,203,194,9,2007,total_driving,NA
T114,T118,Tom Pernice Jr.,31,205,156,49,2007,total_driving,NA
T114,109,Jeff Maggert,26,205,142,63,2007,total_driving,NA
116,112,Tim Clark,19,206,178,28,2007,total_driving,NA
T117,111,Frank Lickliter II,30,207,142,65,2007,total_driving,NA
T117,T120,Steve Flesch,31,207,107,100,2007,total_driving,NA
T119,T120,Ernie Els,16,210,31,179,2007,total_driving,NA
T119,T120,Phil Mickelson,22,210,29,181,2007,total_driving,NA
T119,117,D.J. Brigman,22,210,94,116,2007,total_driving,NA
122,T124,Bob Heintz,27,211,133,78,2007,total_driving,NA
T123,T128,Kevin Sutherland,25,212,75,137,2007,total_driving,NA
T123,123,Geoff Ogilvy,22,212,47,165,2007,total_driving,NA
T123,T124,Anders Hansen,17,212,164,48,2007,total_driving,NA
T123,T126,Luke Donald,20,212,177,35,2007,total_driving,NA
T127,T128,Jeff Quinney,29,213,155,58,2007,total_driving,NA
T127,132,Vijay Singh,27,213,58,155,2007,total_driving,NA
129,T126,Jesper Parnevik,27,214,99,115,2007,total_driving,NA
T130,T133,Charles Howell III,26,215,20,195,2007,total_driving,NA
T130,T140,Aaron Baddeley,23,215,69,146,2007,total_driving,NA
T132,T138,Mark Hensby,25,216,115,101,2007,total_driving,NA
T132,T130,Rocco Mediate,22,216,178,38,2007,total_driving,NA
T132,T148,Jonathan Byrd,23,216,67,149,2007,total_driving,NA
T135,T118,Johnson Wagner,33,217,129,88,2007,total_driving,NA
T135,T140,Brendon de Jonge,26,217,58,159,2007,total_driving,NA
T137,T133,Joe Ogilvie,31,218,91,127,2007,total_driving,NA
T137,T133,Gavin Coles,28,218,195,23,2007,total_driving,NA
139,T138,Bob Estes,28,219,149,70,2007,total_driving,NA
140,T133,Stuart Appleby,24,220,80,140,2007,total_driving,NA
T141,157,Rod Pampling,25,221,119,102,2007,total_driving,NA
T141,T142,Daniel Chopra,34,221,32,189,2007,total_driving,NA
T141,T145,Henrik Stenson,15,221,41,180,2007,total_driving,NA
T141,T142,Paul Goydos,19,221,192,29,2007,total_driving,NA
T141,T145,Andrew Buckle,26,221,50,171,2007,total_driving,NA
T146,147,Kevin Na,27,222,109,113,2007,total_driving,NA
T146,T133,Ryan Palmer,30,222,49,173,2007,total_driving,NA
148,T148,K.J. Choi,25,223,144,79,2007,total_driving,NA
T149,T152,Jason Dufner,32,225,90,135,2007,total_driving,NA
T149,T152,Chad Campbell,28,225,115,110,2007,total_driving,NA
T151,T152,Corey Pavin,25,226,196,30,2007,total_driving,NA
T151,T152,David Toms,22,226,151,75,2007,total_driving,NA
T151,151,Richard Johnson,32,226,160,66,2007,total_driving,NA
154,T148,Woody Austin,27,227,122,105,2007,total_driving,NA
T155,T152,Tom Lehman,19,228,137,91,2007,total_driving,NA
T155,T158,Ben Curtis,25,228,185,43,2007,total_driving,NA
157,160,Tim Herron,27,232,110,122,2007,total_driving,NA
158,T158,Stewart Cink,25,233,50,183,2007,total_driving,NA
T159,161,Freddie Jacobson,20,234,135,99,2007,total_driving,NA
T159,162,Padraig Harrington,18,234,60,174,2007,total_driving,NA
T159,164,Vaughn Taylor,28,234,147,87,2007,total_driving,NA
162,T142,Paul Gow,26,237,170,67,2007,total_driving,NA
163,T130,Marco Dawson,23,238,89,149,2007,total_driving,NA
T164,163,Brian Bateman,18,239,72,167,2007,total_driving,NA
T164,165,Sergio Garcia,19,239,55,184,2007,total_driving,NA
166,T167,Matt Kuchar,26,241,185,56,2007,total_driving,NA
167,169,Craig Kanada,34,242,183,59,2007,total_driving,NA
T168,166,Steve Stricker,23,243,146,97,2007,total_driving,NA
T168,T167,Stephen Leaney,26,243,182,61,2007,total_driving,NA
170,171,Rory Sabbatini,23,250,88,162,2007,total_driving,NA
171,170,Craig Lile,24,251,145,106,2007,total_driving,NA
172,T172,Arron Oberholser,21,252,129,123,2007,total_driving,NA
173,175,Retief Goosen,14,254,62,192,2007,total_driving,NA
174,174,Cliff Kresge,30,255,127,128,2007,total_driving,NA
175,T176,Carl Pettersson,31,256,99,157,2007,total_driving,NA
176,T172,Ian Poulter,18,258,151,107,2007,total_driving,NA
177,179,Nathan Green,29,259,139,120,2007,total_driving,NA
178,T181,Tim Petrovic,32,262,119,143,2007,total_driving,NA
179,T176,Bryce Molder,21,267,76,191,2007,total_driving,NA
T180,178,Lee Janzen,24,268,105,163,2007,total_driving,NA
T180,180,Dicky Pride,25,268,156,112,2007,total_driving,NA
T180,T183,Brett Quigley,25,268,82,186,2007,total_driving,NA
183,186,Todd Hamilton,28,273,96,177,2007,total_driving,NA
184,T183,Dean Wilson,28,275,183,92,2007,total_driving,NA
T185,T181,Billy Andrade,27,277,121,156,2007,total_driving,NA
T185,187,Parker McLachlin,28,277,99,178,2007,total_driving,NA
187,185,Bob Tway,32,278,139,139,2007,total_driving,NA
188,188,Brandt Snedeker,29,280,127,153,2007,total_driving,NA
189,189,Nick O'Hern,22,286,175,111,2007,total_driving,NA
190,190,Shigeki Maruyama,31,288,180,108,2007,total_driving,NA
191,191,Eric Axley,36,293,106,187,2007,total_driving,NA
192,192,Rich Barcelo,26,296,124,172,2007,total_driving,NA
193,194,Ryuji Imada,32,315,149,166,2007,total_driving,NA
194,193,Chris DiMarco,24,317,153,164,2007,total_driving,NA
195,195,Jeff Sluman,21,325,168,157,2007,total_driving,NA
196,196,José María Olazábal,16,382,188,194,2007,total_driving,NA
1,1,Jason Gore,33,56,15,41,2008,total_driving,NA
2,2,Charles Warren,29,85,10,75,2008,total_driving,NA
3,3,Nicholas Thompson,36,88,36,52,2008,total_driving,NA
4,4,John Merrick,28,100,20,80,2008,total_driving,NA
5,5,John Riegger,24,105,74,31,2008,total_driving,NA
6,T6,Charley Hoffman,29,107,12,95,2008,total_driving,NA
7,8,Joe Durant,28,110,102,8,2008,total_driving,NA
8,9,Jeff Gove,18,114,103,11,2008,total_driving,NA
9,T10,John Senden,28,116,81,35,2008,total_driving,NA
T10,T10,Mathew Goggin,27,118,34,84,2008,total_driving,NA
T10,T10,John Rollins,28,118,80,38,2008,total_driving,NA
12,13,Ryan Moore,24,122,56,66,2008,total_driving,NA
T13,18,Ryan Armour,32,126,103,23,2008,total_driving,NA
T13,19,Michael Allen,28,126,101,25,2008,total_driving,NA
15,15,Paul Casey,16,127,18,109,2008,total_driving,NA
16,T16,Ben Crane,25,128,86,42,2008,total_driving,NA
T17,14,John Huston,18,130,65,65,2008,total_driving,NA
T17,T16,Todd Demsey,25,130,53,77,2008,total_driving,NA
19,T33,Robert Allenby,28,131,61,70,2008,total_driving,NA
20,T20,J.J. Henry,34,132,61,71,2008,total_driving,NA
21,T20,Nick Watney,27,135,7,128,2008,total_driving,NA
22,22,Rich Beem,29,136,88,48,2008,total_driving,NA
23,T23,Hunter Mahan,27,137,75,62,2008,total_driving,NA
T24,T37,Steve Marino,32,140,49,91,2008,total_driving,NA
T24,25,Charlie Wi,27,140,95,45,2008,total_driving,NA
T24,T33,Mathias Grönberg,30,140,38,102,2008,total_driving,NA
27,T23,Pat Perez,27,141,44,97,2008,total_driving,NA
T28,T28,Mark Wilson,29,142,122,20,2008,total_driving,NA
T28,32,Billy Mayfair,29,142,129,13,2008,total_driving,NA
30,T30,Chad Campbell,28,143,75,68,2008,total_driving,NA
T31,T30,D.J. Trahan,27,144,66,78,2008,total_driving,NA
T31,T26,Ryan Palmer,22,144,44,100,2008,total_driving,NA
33,39,Martin Laird,29,145,31,114,2008,total_driving,NA
34,T26,Boo Weekley,24,146,61,85,2008,total_driving,NA
35,T28,Jay Williamson,33,147,123,24,2008,total_driving,NA
36,T33,Lucas Glover,26,148,23,125,2008,total_driving,NA
37,44,Rod Pampling,28,151,82,69,2008,total_driving,NA
T38,T37,Kenny Perry,26,153,33,120,2008,total_driving,NA
T38,T42,Chris Stroud,29,153,95,58,2008,total_driving,NA
40,41,Harrison Frazar,23,154,14,140,2008,total_driving,NA
41,T42,Kenneth Ferrie,25,155,119,36,2008,total_driving,NA
T42,47,Kent Jones,23,157,141,16,2008,total_driving,NA
T42,T45,Michael Letzig,29,157,69,88,2008,total_driving,NA
T44,T48,Jonathan Byrd,27,160,114,46,2008,total_driving,NA
T44,T33,Jeff Maggert,28,160,110,50,2008,total_driving,NA
T44,40,Robert Gamez,26,160,153,7,2008,total_driving,NA
47,T48,Chez Reavie,30,161,152,9,2008,total_driving,NA
48,T45,Nick Flanagan,29,164,60,104,2008,total_driving,NA
49,T54,Troy Matteson,30,165,38,127,2008,total_driving,NA
T50,T50,Jason Day,28,166,27,139,2008,total_driving,NA
T50,T50,Steve Allan,21,166,5,161,2008,total_driving,NA
52,T54,Heath Slocum,29,167,164,3,2008,total_driving,NA
53,T56,Ben Curtis,22,168,121,47,2008,total_driving,NA
T54,T60,Joe Ogilvie,29,169,88,81,2008,total_driving,NA
T54,53,Scott McCarron,22,169,139,30,2008,total_driving,NA
T54,T50,Kevin Streelman,32,169,54,115,2008,total_driving,NA
T57,T56,Anthony Kim,22,170,11,159,2008,total_driving,NA
T57,58,Bart Bryant,23,170,166,4,2008,total_driving,NA
T57,T65,Steve Elkington,25,170,148,22,2008,total_driving,NA
T60,T62,Davis Love III,23,171,9,162,2008,total_driving,NA
T60,T62,Bill Haas,31,171,29,142,2008,total_driving,NA
62,T77,Tommy Gainey,24,172,24,148,2008,total_driving,NA
63,T60,Trevor Immelman,22,173,66,107,2008,total_driving,NA
T64,T65,Tag Ridings,29,174,6,168,2008,total_driving,NA
T64,70,Bo Van Pelt,32,174,58,116,2008,total_driving,NA
T64,59,Woody Austin,30,174,114,60,2008,total_driving,NA
67,T65,Vijay Singh,23,175,25,150,2008,total_driving,NA
T68,T65,Scott Verplank,24,176,170,6,2008,total_driving,NA
T68,64,Rory Sabbatini,23,176,58,118,2008,total_driving,NA
70,69,Briny Baird,30,177,116,61,2008,total_driving,NA
71,T73,Todd Hamilton,28,180,129,51,2008,total_driving,NA
T72,T73,Robert Garrigus,29,181,2,179,2008,total_driving,NA
T72,T84,Patrick Sheehan,35,181,125,56,2008,total_driving,NA
74,T109,Tom Scherrer,20,182,88,94,2008,total_driving,NA
T75,T73,Tim Herron,28,183,52,131,2008,total_driving,NA
T75,T71,Tommy Armour III,25,183,88,95,2008,total_driving,NA
T75,T82,Tim Petrovic,32,183,129,54,2008,total_driving,NA
T75,T77,Brian Davis,34,183,173,10,2008,total_driving,NA
T79,76,Ted Purdy,25,184,54,130,2008,total_driving,NA
T79,T77,Bubba Watson,29,184,1,183,2008,total_driving,NA
T81,T89,Kevin Stadler,30,185,68,117,2008,total_driving,NA
T81,T77,Fred Couples,18,185,16,169,2008,total_driving,NA
T81,T71,Omar Uresti,24,185,183,2,2008,total_driving,NA
T84,T77,Padraig Harrington,15,186,32,154,2008,total_driving,NA
T84,T82,Zach Johnson,25,186,181,5,2008,total_driving,NA
86,T87,Scott Sterling,28,188,125,63,2008,total_driving,NA
T87,86,Jim Furyk,26,190,162,28,2008,total_driving,NA
T87,T89,Doug LaBelle II,22,190,153,37,2008,total_driving,NA
T89,T111,Justin Bolli,28,191,125,66,2008,total_driving,NA
T89,T89,Ron Whittaker,22,191,177,14,2008,total_driving,NA
T91,93,Vaughn Taylor,32,192,82,110,2008,total_driving,NA
T91,T96,Cameron Beckman,29,192,150,42,2008,total_driving,NA
T91,T87,Kevin Sutherland,26,192,71,121,2008,total_driving,NA
T91,T84,George McNeill,29,192,40,152,2008,total_driving,NA
T95,95,Adam Scott,15,193,8,185,2008,total_driving,NA
T95,T104,Y.E. Yang,29,193,100,93,2008,total_driving,NA
T97,T104,Marc Turnesa,29,195,117,78,2008,total_driving,NA
T97,T98,John Mallinger,29,195,169,26,2008,total_driving,NA
T97,94,Dustin Johnson,30,195,4,191,2008,total_driving,NA
T97,T96,Olin Browne,27,195,194,1,2008,total_driving,NA
T97,T98,Nick O'Hern,26,195,183,12,2008,total_driving,NA
T102,T98,Sergio Garcia,19,196,43,153,2008,total_driving,NA
T102,T98,Justin Leonard,25,196,156,40,2008,total_driving,NA
104,T104,Kevin Na,29,197,158,39,2008,total_driving,NA
T105,T104,J.B. Holmes,26,198,3,195,2008,total_driving,NA
T105,T104,Paul Claxton,23,198,180,18,2008,total_driving,NA
T105,T109,Brandt Jobe,19,198,21,177,2008,total_driving,NA
108,T111,Bob Estes,28,201,145,56,2008,total_driving,NA
109,T98,Brad Elder,23,202,78,124,2008,total_driving,NA
T110,113,Jason Allred,23,206,22,184,2008,total_driving,NA
T110,121,Travis Perkins,23,206,16,190,2008,total_driving,NA
T112,T116,Sean O'Hair,25,207,69,138,2008,total_driving,NA
T112,T114,Frank Lickliter II,32,207,125,82,2008,total_driving,NA
T114,T114,Shane Bertsch,29,208,187,21,2008,total_driving,NA
T114,103,Alejandro Cañizares,16,208,97,111,2008,total_driving,NA
T116,T126,Jon Mills,32,209,51,158,2008,total_driving,NA
T116,T118,Paul Goydos,25,209,190,19,2008,total_driving,NA
T116,T122,Ángel Cabrera,17,209,13,196,2008,total_driving,NA
T116,T118,Stewart Cink,23,209,28,181,2008,total_driving,NA
120,T122,Gavin Coles,16,210,195,15,2008,total_driving,NA
T121,T116,Brenden Pappas,24,211,42,169,2008,total_driving,NA
T121,T129,Bob Tway,20,211,167,44,2008,total_driving,NA
T121,T124,Andres Romero,20,211,19,192,2008,total_driving,NA
T124,T126,Will MacKenzie,21,213,108,105,2008,total_driving,NA
T124,T129,Jeff Overton,32,213,26,187,2008,total_driving,NA
T124,T136,Mark Calcavecchia,25,213,139,74,2008,total_driving,NA
T124,T126,Brian Gay,31,213,196,17,2008,total_driving,NA
128,T134,Glen Day,19,215,183,32,2008,total_driving,NA
T129,T142,Brett Quigley,25,216,94,122,2008,total_driving,NA
T129,T134,Phil Mickelson,21,216,35,181,2008,total_driving,NA
T129,147,David Lutterus,23,216,84,132,2008,total_driving,NA
T129,T129,Camilo Villegas,22,216,50,166,2008,total_driving,NA
T133,T124,Peter Lonard,30,217,153,64,2008,total_driving,NA
T133,T129,Richard Johnson,29,217,29,188,2008,total_driving,NA
T135,T118,Alex Cejka,25,218,142,76,2008,total_driving,NA
T135,T138,David Toms,20,218,146,72,2008,total_driving,NA
T135,T138,Tim Wilkinson,29,218,165,53,2008,total_driving,NA
T138,133,Craig Kanada,23,219,192,27,2008,total_driving,NA
T138,T149,Bob Sowards,22,219,84,135,2008,total_driving,NA
T138,T145,Jin Park,30,219,186,33,2008,total_driving,NA
T138,T136,Kyle Thompson,26,219,111,108,2008,total_driving,NA
T142,T145,Geoff Ogilvy,20,222,57,165,2008,total_driving,NA
T142,T138,J.P. Hayes,26,222,124,98,2008,total_driving,NA
T144,T142,Greg Kraft,21,223,189,34,2008,total_driving,NA
T144,T151,Aaron Baddeley,22,223,73,150,2008,total_driving,NA
T144,148,Chris Riley,17,223,168,55,2008,total_driving,NA
T144,T138,Charles Howell III,31,223,48,175,2008,total_driving,NA
148,T149,Mike Weir,26,225,119,106,2008,total_driving,NA
149,154,Corey Pavin,20,226,197,29,2008,total_driving,NA
T150,153,Jesper Parnevik,29,229,93,136,2008,total_driving,NA
T150,T155,James Driscoll,28,229,40,189,2008,total_driving,NA
T150,T151,Jimmy Walker,24,229,36,193,2008,total_driving,NA
153,159,Ken Duke,33,230,118,112,2008,total_driving,NA
154,T160,K.J. Choi,21,232,106,126,2008,total_driving,NA
T155,T142,Lee Janzen,28,233,132,101,2008,total_driving,NA
T155,T155,Matt Jones,31,233,47,186,2008,total_driving,NA
T157,T160,Richard Johnson,21,235,146,89,2008,total_driving,NA
T157,T163,Tom Lehman,17,235,148,87,2008,total_driving,NA
T157,170,Jerry Kelly,31,235,176,59,2008,total_driving,NA
T160,T157,Stephen Ames,24,236,133,103,2008,total_driving,NA
T160,T157,Stuart Appleby,23,236,72,164,2008,total_driving,NA
162,162,Ernie Els,16,237,64,173,2008,total_driving,NA
163,T163,Daniel Chopra,27,238,44,194,2008,total_driving,NA
164,169,Mark Hensby,26,239,79,160,2008,total_driving,NA
T165,T167,Stephen Leaney,17,240,191,49,2008,total_driving,NA
T165,T167,Tim Clark,27,240,157,83,2008,total_driving,NA
167,T165,Brad Adamonis,29,242,75,167,2008,total_driving,NA
168,T165,Steve Lowery,25,243,99,144,2008,total_driving,NA
169,171,Marco Dawson,21,247,106,141,2008,total_driving,NA
170,172,Tom Pernice Jr.,30,251,161,90,2008,total_driving,NA
171,T175,Carl Pettersson,29,253,108,145,2008,total_driving,NA
T172,T173,Jim McGovern,26,255,163,92,2008,total_driving,NA
T172,T173,Matt Kuchar,27,255,182,73,2008,total_driving,NA
174,T175,Rocco Mediate,27,256,170,86,2008,total_driving,NA
175,177,Cody Freeman,26,257,86,171,2008,total_driving,NA
176,178,Parker McLachlin,27,262,105,157,2008,total_driving,NA
177,179,Eric Axley,35,264,88,176,2008,total_driving,NA
T178,184,Retief Goosen,18,271,97,174,2008,total_driving,NA
T178,182,Cliff Kresge,28,271,158,113,2008,total_driving,NA
T178,T180,Johnson Wagner,26,271,138,133,2008,total_driving,NA
181,183,Chris DiMarco,29,274,175,99,2008,total_driving,NA
182,T180,Carlos Franco,25,275,112,163,2008,total_driving,NA
183,185,Ian Poulter,15,281,135,146,2008,total_driving,NA
184,187,Nathan Green,30,283,134,149,2008,total_driving,NA
T185,188,Freddie Jacobson,24,284,142,142,2008,total_driving,NA
T185,186,Steve Flesch,29,284,150,134,2008,total_driving,NA
187,189,Billy Andrade,24,292,137,155,2008,total_driving,NA
188,190,Brandt Snedeker,26,297,160,137,2008,total_driving,NA
189,191,Dean Wilson,32,301,178,123,2008,total_driving,NA
190,195,Dudley Hart,22,308,179,129,2008,total_driving,NA
191,193,David Duval,20,310,113,197,2008,total_driving,NA
192,192,Jeff Quinney,28,312,193,119,2008,total_driving,NA
193,194,Steve Stricker,22,313,135,178,2008,total_driving,NA
194,T196,Ryuji Imada,25,317,170,147,2008,total_driving,NA
195,T196,Brett Rumford,26,322,142,180,2008,total_driving,NA
196,198,Chad Collins,24,330,174,156,2008,total_driving,NA
197,199,Shigeki Maruyama,18,360,188,172,2008,total_driving,NA
1,3,Jonathan Byrd,25,92,33,59,2009,total_driving,NA
2,T1,Lucas Glover,26,95,25,70,2009,total_driving,NA
T3,5,John Rollins,27,97,30,67,2009,total_driving,NA
T3,T1,Kenny Perry,24,97,48,49,2009,total_driving,NA
T5,4,Robert Allenby,21,98,48,50,2009,total_driving,NA
T5,6,Boo Weekley,22,98,62,36,2009,total_driving,NA
7,7,Hunter Mahan,25,102,28,74,2009,total_driving,NA
T8,9,Greg Owen,30,104,59,45,2009,total_driving,NA
T8,T10,Heath Slocum,30,104,97,7,2009,total_driving,NA
T8,T10,Ryan Moore,27,104,33,71,2009,total_driving,NA
11,13,Kirk Triplett,20,105,100,5,2009,total_driving,NA
12,8,Tiger Woods,17,107,21,86,2009,total_driving,NA
13,12,Charles Warren,20,111,18,93,2009,total_driving,NA
14,T18,Scott McCarron,27,117,114,3,2009,total_driving,NA
15,T15,John Senden,29,118,40,78,2009,total_driving,NA
16,17,Michael Allen,22,119,80,39,2009,total_driving,NA
T17,14,Jeff Maggert,28,121,83,38,2009,total_driving,NA
T17,T15,Martin Laird,24,121,14,107,2009,total_driving,NA
19,T18,Kris Blanks,20,122,65,57,2009,total_driving,NA
20,22,David Toms,27,123,119,4,2009,total_driving,NA
21,T20,Bo Van Pelt,30,124,56,68,2009,total_driving,NA
T22,30,D.J. Trahan,30,126,79,47,2009,total_driving,NA
T22,23,Jason Bohn,25,126,108,18,2009,total_driving,NA
T24,25,Tommy Armour III,19,129,95,34,2009,total_driving,NA
T24,26,Nicholas Thompson,31,129,38,91,2009,total_driving,NA
26,27,Mathew Goggin,26,131,69,62,2009,total_driving,NA
T27,24,Bill Haas,29,132,22,110,2009,total_driving,NA
T27,T20,Jason Gore,24,132,72,60,2009,total_driving,NA
29,29,Ted Purdy,30,134,45,89,2009,total_driving,NA
T30,33,Billy Mayfair,28,139,119,20,2009,total_driving,NA
T30,31,Steve Marino,29,139,35,104,2009,total_driving,NA
32,T38,Will MacKenzie,24,140,78,62,2009,total_driving,NA
33,32,Steve Elkington,23,142,107,35,2009,total_driving,NA
34,34,Steve Lowery,27,143,74,69,2009,total_driving,NA
35,28,Peter Tomasulo,25,144,50,94,2009,total_driving,NA
36,T36,Ernie Els,19,145,68,77,2009,total_driving,NA
T37,T41,Mark Wilson,28,146,118,28,2009,total_driving,NA
T37,35,Troy Matteson,30,146,9,137,2009,total_driving,NA
39,T38,Jason Dufner,26,148,102,46,2009,total_driving,NA
T40,T36,Bill Lunde,27,149,57,92,2009,total_driving,NA
T40,T43,Jay Williamson,22,149,123,26,2009,total_driving,NA
42,T43,Ben Crane,27,150,109,41,2009,total_driving,NA
43,T46,Tim Clark,23,152,150,2,2009,total_driving,NA
44,T48,Zach Johnson,26,153,143,10,2009,total_driving,NA
T45,T41,Ryan Palmer,26,154,26,128,2009,total_driving,NA
T45,40,John Merrick,28,154,29,125,2009,total_driving,NA
47,T48,Justin Leonard,26,155,123,32,2009,total_driving,NA
T48,T51,Scott Verplank,24,156,145,11,2009,total_driving,NA
T48,T48,Sergio Garcia,17,156,18,138,2009,total_driving,NA
T50,T51,Steve Stricker,22,157,104,53,2009,total_driving,NA
T50,T46,Davis Love III,27,157,14,143,2009,total_driving,NA
T52,T59,Joe Durant,20,158,157,1,2009,total_driving,NA
T52,T51,Marc Leishman,28,158,17,141,2009,total_driving,NA
54,T55,Kevin Streelman,29,159,30,129,2009,total_driving,NA
T55,T51,Matt Weibring,22,160,84,76,2009,total_driving,NA
T55,T55,Jeff Klauk,29,160,147,13,2009,total_driving,NA
57,58,Nick Watney,24,161,6,155,2009,total_driving,NA
T58,T55,Robert Garrigus,25,162,1,161,2009,total_driving,NA
T58,45,Patrick Sheehan,15,162,146,16,2009,total_driving,NA
60,T59,Charlie Wi,28,164,112,52,2009,total_driving,NA
61,T66,Darron Stiles,20,165,153,12,2009,total_driving,NA
T62,61,Alex Cejka,25,167,143,24,2009,total_driving,NA
T62,T62,Charley Hoffman,27,167,11,156,2009,total_driving,NA
T62,T72,Stephen Ames,23,167,94,73,2009,total_driving,NA
65,T66,Kent Jones,24,168,141,27,2009,total_driving,NA
T66,70,Justin Rose,22,169,90,79,2009,total_driving,NA
T66,T64,Tag Ridings,16,169,4,165,2009,total_driving,NA
T66,T62,Sean O'Hair,23,169,46,123,2009,total_driving,NA
69,T64,J.J. Henry,28,171,44,127,2009,total_driving,NA
T70,T68,Vijay Singh,21,172,41,131,2009,total_driving,NA
T70,T76,Chris Stroud,28,172,72,100,2009,total_driving,NA
T70,T68,Jason Day,18,172,36,136,2009,total_driving,NA
T70,T74,Johnson Wagner,26,172,88,84,2009,total_driving,NA
T70,71,Dustin Johnson,25,172,3,169,2009,total_driving,NA
T75,T79,Chez Reavie,27,173,154,19,2009,total_driving,NA
T75,T74,Chad Campbell,26,173,70,103,2009,total_driving,NA
77,T76,James Nitties,27,174,63,111,2009,total_driving,NA
T78,T76,Camilo Villegas,21,176,50,126,2009,total_driving,NA
T78,T79,Chris Riley,22,176,167,9,2009,total_driving,NA
T80,T82,Jim Furyk,23,177,152,25,2009,total_driving,NA
T80,T82,Bob Estes,23,177,137,40,2009,total_driving,NA
T80,T72,Michael Letzig,28,177,43,134,2009,total_driving,NA
T80,T87,Colt Knost,24,177,154,23,2009,total_driving,NA
T84,93,Brian Davis,32,178,127,51,2009,total_driving,NA
T84,T91,D.A. Points,29,178,141,37,2009,total_driving,NA
86,T82,Scott Piercy,28,179,12,167,2009,total_driving,NA
87,86,Bubba Watson,24,180,2,178,2009,total_driving,NA
T88,T87,Harrison Frazar,28,182,10,172,2009,total_driving,NA
T88,T87,Gary Woodland,18,182,5,177,2009,total_driving,NA
90,T87,Bart Bryant,17,183,175,8,2009,total_driving,NA
T91,T94,Daniel Chopra,28,185,26,159,2009,total_driving,NA
T91,97,Vaughn Taylor,28,185,129,56,2009,total_driving,NA
T91,T94,Adam Scott,19,185,37,148,2009,total_driving,NA
94,T91,Briny Baird,28,186,138,48,2009,total_driving,NA
T95,T98,Rod Pampling,23,187,90,97,2009,total_driving,NA
T95,102,Bob Heintz,20,187,123,64,2009,total_driving,NA
T97,T98,Stewart Cink,22,188,39,149,2009,total_driving,NA
T97,T94,Tim Petrovic,31,188,133,55,2009,total_driving,NA
T99,T103,Brian Gay,27,189,183,6,2009,total_driving,NA
T99,T98,Ángel Cabrera,17,189,8,181,2009,total_driving,NA
T101,T98,Fred Couples,16,190,24,166,2009,total_driving,NA
T101,T109,Brandt Snedeker,26,190,169,21,2009,total_driving,NA
T103,T103,J.B. Holmes,25,191,7,184,2009,total_driving,NA
T103,T82,Casey Wittenberg,25,191,109,82,2009,total_driving,NA
T103,81,Brian Vranesh,20,191,89,102,2009,total_driving,NA
T103,T103,Anthony Kim,22,191,16,175,2009,total_driving,NA
T107,T112,Matt Jones,17,192,23,169,2009,total_driving,NA
T107,T103,Kevin Stadler,20,192,75,117,2009,total_driving,NA
T107,T107,Phil Mickelson,18,192,13,179,2009,total_driving,NA
T107,T112,Kevin Sutherland,27,192,80,112,2009,total_driving,NA
T111,T123,Jerry Kelly,26,193,114,79,2009,total_driving,NA
T111,T117,K.J. Choi,22,193,150,43,2009,total_driving,NA
T113,T112,Bryce Molder,21,194,129,65,2009,total_driving,NA
T113,T112,Matt Kuchar,24,194,128,66,2009,total_driving,NA
T115,T109,Glen Day,26,195,174,21,2009,total_driving,NA
T115,T117,John Mallinger,27,195,164,31,2009,total_driving,NA
T117,T123,Tom Lehman,16,196,179,17,2009,total_driving,NA
T117,T119,Todd Hamilton,29,196,113,83,2009,total_driving,NA
T117,T107,Brendon de Jonge,29,196,75,121,2009,total_driving,NA
T117,T123,Pat Perez,22,196,87,109,2009,total_driving,NA
T117,T112,George McNeill,26,196,61,135,2009,total_driving,NA
T122,T119,Mark Brooks,17,197,182,15,2009,total_driving,NA
T122,T126,Woody Austin,24,197,99,98,2009,total_driving,NA
T122,T119,Retief Goosen,20,197,58,139,2009,total_driving,NA
T125,T126,Corey Pavin,23,198,184,14,2009,total_driving,NA
T125,T126,Andres Romero,20,198,18,180,2009,total_driving,NA
T125,T109,Leif Olson,21,198,30,168,2009,total_driving,NA
T128,T129,Charles Howell III,29,199,53,146,2009,total_driving,NA
T128,T134,Nick O'Hern,27,199,170,29,2009,total_driving,NA
130,T129,Y.E. Yang,23,200,67,133,2009,total_driving,NA
T131,T129,Rory Sabbatini,25,201,47,154,2009,total_driving,NA
T131,T119,Matt Bettencourt,31,201,52,149,2009,total_driving,NA
133,T129,Paul Goydos,25,202,172,30,2009,total_driving,NA
T134,137,Scott Sterling,16,203,109,94,2009,total_driving,NA
T134,142,Rich Beem,26,203,114,89,2009,total_driving,NA
136,T140,Ricky Barnes,23,207,55,152,2009,total_driving,NA
137,T143,Ian Poulter,17,208,133,75,2009,total_driving,NA
138,T143,Richard Johnson,26,209,176,33,2009,total_driving,NA
139,157,Rick Price,21,210,166,44,2009,total_driving,NA
140,T138,Chris DiMarco,29,211,157,54,2009,total_driving,NA
141,T146,Tim Herron,27,212,59,153,2009,total_driving,NA
142,T146,Geoff Ogilvy,20,214,63,151,2009,total_driving,NA
T143,T134,Peter Lonard,30,215,157,58,2009,total_driving,NA
T143,T149,Cameron Beckman,26,215,97,118,2009,total_driving,NA
T143,T149,Jeff Overton,28,215,41,174,2009,total_driving,NA
146,148,Rocco Mediate,22,217,129,88,2009,total_driving,NA
T147,T154,Greg Chalmers,26,218,119,99,2009,total_driving,NA
T147,151,Marc Turnesa,30,218,157,61,2009,total_driving,NA
T149,145,Jarrod Lyle,21,219,95,124,2009,total_driving,NA
T149,T154,Stuart Appleby,25,219,77,142,2009,total_driving,NA
T149,158,Jeff Quinney,26,219,177,42,2009,total_driving,NA
152,T152,Cliff Kresge,28,221,149,72,2009,total_driving,NA
153,T152,Joe Ogilvie,29,223,65,158,2009,total_driving,NA
154,156,Steve Flesch,27,225,117,108,2009,total_driving,NA
155,159,Tom Pernice Jr.,26,226,140,86,2009,total_driving,NA
156,160,Mark Calcavecchia,23,234,104,130,2009,total_driving,NA
157,161,David Duval,22,236,53,183,2009,total_driving,NA
158,165,Brett Quigley,28,237,93,144,2009,total_driving,NA
159,166,Ben Curtis,18,238,157,81,2009,total_driving,NA
160,T162,Kevin Na,26,240,136,104,2009,total_driving,NA
T161,171,Brad Adamonis,25,242,82,160,2009,total_driving,NA
T161,167,Ken Duke,29,242,129,113,2009,total_driving,NA
T161,T162,Webb Simpson,30,242,102,140,2009,total_driving,NA
164,168,Carl Pettersson,29,243,86,157,2009,total_driving,NA
165,172,Jimmy Walker,24,246,70,176,2009,total_driving,NA
166,T169,Brian Bateman,25,248,84,164,2009,total_driving,NA
167,T162,Aron Price,27,250,154,96,2009,total_driving,NA
168,T169,Lee Janzen,23,254,139,115,2009,total_driving,NA
T169,174,Nathan Green,30,255,123,132,2009,total_driving,NA
T169,173,Aaron Baddeley,23,255,92,163,2009,total_driving,NA
171,T178,Derek Fathauer,25,262,100,162,2009,total_driving,NA
172,175,David Mathis,27,264,148,116,2009,total_driving,NA
173,177,Dean Wilson,29,266,181,85,2009,total_driving,NA
T174,T178,Mike Weir,24,269,163,106,2009,total_driving,NA
T174,176,Freddie Jacobson,25,269,122,147,2009,total_driving,NA
176,181,Padraig Harrington,20,277,106,171,2009,total_driving,NA
177,180,Greg Kraft,21,279,178,101,2009,total_driving,NA
178,184,Spencer Levin,25,284,165,119,2009,total_driving,NA
179,183,Luke Donald,21,287,173,114,2009,total_driving,NA
180,185,Ryuji Imada,25,290,168,122,2009,total_driving,NA
181,182,Brendon Todd,21,291,171,120,2009,total_driving,NA
182,186,Eric Axley,30,315,133,182,2009,total_driving,NA
183,187,Brad Faxon,23,324,180,144,2009,total_driving,NA
184,188,Parker McLachlin,25,330,157,173,2009,total_driving,NA
1,1,Charles Warren,21,70,9,61,2010,total_driving,NA
2,2,Graham DeLaet,28,84,6,78,2010,total_driving,NA
3,3,Hunter Mahan,25,95,57,38,2010,total_driving,NA
T4,8,Davis Love III,24,102,17,85,2010,total_driving,NA
T4,4,Boo Weekley,27,102,55,47,2010,total_driving,NA
6,5,Kenny Perry,20,104,68,36,2010,total_driving,NA
7,7,John Rollins,26,110,30,80,2010,total_driving,NA
T8,6,Chris Couch,23,111,49,62,2010,total_driving,NA
T8,T9,Ryan Moore,24,111,75,36,2010,total_driving,NA
10,11,John Merrick,31,113,60,53,2010,total_driving,NA
T11,12,Blake Adams,26,115,63,52,2010,total_driving,NA
T11,T9,Tom Gillis,27,115,86,29,2010,total_driving,NA
T11,13,Steve Elkington,22,115,80,35,2010,total_driving,NA
T14,T14,Joe Durant,19,118,116,2,2010,total_driving,NA
T14,T19,John Senden,30,118,72,46,2010,total_driving,NA
16,T16,J.J. Henry,27,120,46,74,2010,total_driving,NA
17,T19,Jarrod Lyle,18,122,23,99,2010,total_driving,NA
T18,T16,Will MacKenzie,23,123,66,57,2010,total_driving,NA
T18,18,Bo Van Pelt,28,123,53,70,2010,total_driving,NA
T18,T14,Mathias Grönberg,22,123,40,83,2010,total_driving,NA
21,22,Rory McIlroy,16,127,12,115,2010,total_driving,NA
22,23,Bill Haas,25,130,42,88,2010,total_driving,NA
23,T24,Scott McCarron,29,131,88,43,2010,total_driving,NA
24,T24,Rickie Fowler,28,133,47,86,2010,total_driving,NA
25,T26,Kevin Streelman,28,134,70,64,2010,total_driving,NA
T26,T26,Nick Watney,24,136,20,116,2010,total_driving,NA
T26,29,Retief Goosen,19,136,60,76,2010,total_driving,NA
T28,T19,Paul Stankowski,18,138,70,68,2010,total_driving,NA
T28,28,Lucas Glover,23,138,27,111,2010,total_driving,NA
30,T30,Jay Williamson,24,139,119,20,2010,total_driving,NA
T31,37,Stewart Cink,23,141,49,92,2010,total_driving,NA
T31,33,Billy Mayfair,26,141,124,17,2010,total_driving,NA
T31,T30,Josh Teater,31,141,44,97,2010,total_driving,NA
34,36,Sergio Garcia,15,142,47,95,2010,total_driving,NA
T35,T34,Adam Scott,20,143,33,110,2010,total_driving,NA
T35,T30,D.J. Trahan,27,143,10,133,2010,total_driving,NA
T35,T34,Charley Hoffman,24,143,15,128,2010,total_driving,NA
T38,T40,Chad Campbell,28,144,119,25,2010,total_driving,NA
T38,T38,Matt Kuchar,26,144,105,39,2010,total_driving,NA
T40,T38,Ben Crane,24,145,136,9,2010,total_driving,NA
T40,T40,Kevin Sutherland,25,145,96,49,2010,total_driving,NA
42,42,Mathew Goggin,28,147,78,69,2010,total_driving,NA
43,43,David Toms,25,151,144,7,2010,total_driving,NA
44,T48,Vijay Singh,24,153,51,102,2010,total_driving,NA
45,44,Vaughn Taylor,26,155,122,33,2010,total_driving,NA
46,NA,Cliff Kresge,17,156,128,28,2010,total_driving,NA
47,T45,Robert Allenby,22,159,82,77,2010,total_driving,NA
48,T48,Kris Blanks,30,161,110,51,2010,total_driving,NA
T49,T54,Troy Matteson,28,164,22,142,2010,total_driving,NA
T49,T48,Martin Laird,26,164,20,144,2010,total_driving,NA
T49,47,Steve Stricker,19,164,134,30,2010,total_driving,NA
T49,T52,Zach Johnson,25,164,156,8,2010,total_driving,NA
T49,T54,Jason Dufner,25,164,140,24,2010,total_driving,NA
T54,T52,Brett Wetterich,16,166,4,162,2010,total_driving,NA
T54,60,Aron Price,22,166,121,45,2010,total_driving,NA
T56,51,Garth Mulroy,19,167,29,138,2010,total_driving,NA
T56,T58,Garrett Willis,24,167,153,14,2010,total_driving,NA
T58,T54,Heath Slocum,25,169,163,6,2010,total_driving,NA
T58,T54,Justin Rose,22,169,97,72,2010,total_driving,NA
T58,T61,Paul Casey,17,169,35,134,2010,total_driving,NA
T61,T58,Sean O'Hair,25,170,78,92,2010,total_driving,NA
T61,T63,Brendon de Jonge,32,170,105,65,2010,total_driving,NA
T61,65,Y.E. Yang,21,170,88,82,2010,total_driving,NA
T64,T45,Nicholas Thompson,29,171,80,91,2010,total_driving,NA
T64,T63,Henrik Bjornstad,26,171,93,78,2010,total_driving,NA
T64,T67,Roger Tambellini,26,171,53,118,2010,total_driving,NA
67,66,Pat Perez,27,172,102,70,2010,total_driving,NA
T68,T76,Jerry Kelly,29,173,160,13,2010,total_driving,NA
T68,78,Michael Letzig,27,173,75,98,2010,total_driving,NA
T70,T61,John Mallinger,29,175,152,23,2010,total_driving,NA
T70,T67,James Nitties,30,175,112,63,2010,total_driving,NA
T70,T67,Dustin Johnson,23,175,3,172,2010,total_driving,NA
T73,T76,Robert Garrigus,22,176,1,175,2010,total_driving,NA
T73,T74,Mark Wilson,28,176,150,26,2010,total_driving,NA
T75,T71,Bubba Watson,22,178,2,176,2010,total_driving,NA
T75,T71,Chris DiMarco,25,178,160,18,2010,total_driving,NA
T75,70,Skip Kendall,18,178,157,21,2010,total_driving,NA
T75,T74,Jason Day,24,178,15,163,2010,total_driving,NA
79,T71,Kevin Stadler,28,180,72,108,2010,total_driving,NA
80,T81,Dean Wilson,18,183,142,41,2010,total_driving,NA
81,T79,Aaron Baddeley,26,184,14,170,2010,total_driving,NA
82,T81,Alex Prugh,28,185,27,158,2010,total_driving,NA
83,T81,Richard Johnson,27,186,175,11,2010,total_driving,NA
84,T79,Matt Every,18,187,64,123,2010,total_driving,NA
85,T89,J.B. Holmes,26,188,5,183,2010,total_driving,NA
T86,T104,Cameron Tringale,22,189,32,157,2010,total_driving,NA
T86,T93,Jim Furyk,21,189,179,10,2010,total_driving,NA
T86,84,Alex Cejka,28,189,173,16,2010,total_driving,NA
T89,T93,Omar Uresti,27,190,189,1,2010,total_driving,NA
T89,T108,Ryan Palmer,27,190,26,164,2010,total_driving,NA
T89,88,Ángel Cabrera,19,190,8,182,2010,total_driving,NA
T89,T95,Greg Owen,27,190,60,130,2010,total_driving,NA
T89,T89,Marc Leishman,26,190,31,159,2010,total_driving,NA
T94,T85,Steve Wheatcroft,27,191,102,89,2010,total_driving,NA
T94,T89,K.J. Choi,22,191,131,60,2010,total_driving,NA
T96,T98,Scott Piercy,28,192,19,173,2010,total_driving,NA
T96,T85,Cameron Percy,25,192,36,156,2010,total_driving,NA
T96,T98,Tim Clark,24,192,188,4,2010,total_driving,NA
T96,T95,Rod Pampling,26,192,126,66,2010,total_driving,NA
T96,T113,Steve Marino,24,192,68,124,2010,total_driving,NA
T101,T101,Stephen Ames,23,193,138,55,2010,total_driving,NA
T101,T104,Jonathan Byrd,26,193,64,129,2010,total_driving,NA
T103,T101,Brian Davis,32,194,163,31,2010,total_driving,NA
T103,T137,Jeff Gove,22,194,86,108,2010,total_driving,NA
T103,T89,Justin Leonard,27,194,172,22,2010,total_driving,NA
T106,T104,Brian Gay,30,195,192,3,2010,total_driving,NA
T106,T104,John Daly,20,195,6,189,2010,total_driving,NA
T106,T101,Jeff Overton,26,195,18,177,2010,total_driving,NA
T109,T108,Craig Bowden,20,196,191,5,2010,total_driving,NA
T109,T110,Chris Riley,24,196,169,27,2010,total_driving,NA
111,T110,Paul Goydos,25,197,185,12,2010,total_driving,NA
T112,T127,Jeff Maggert,28,199,159,40,2010,total_driving,NA
T112,T95,Chris Tidland,24,199,93,106,2010,total_driving,NA
T112,T85,Justin Bolli,23,199,141,58,2010,total_driving,NA
115,T119,Trevor Immelman,19,200,110,90,2010,total_driving,NA
T116,125,Ben Curtis,24,201,182,19,2010,total_driving,NA
T116,126,Jeff Quinney,29,201,186,15,2010,total_driving,NA
T116,T113,Matt Bettencourt,32,201,36,165,2010,total_driving,NA
T116,T119,Phil Mickelson,20,201,13,188,2010,total_driving,NA
T116,T119,Woody Austin,29,201,147,54,2010,total_driving,NA
T116,116,Scott Verplank,22,201,167,34,2010,total_driving,NA
T122,T98,Tom Pernice Jr.,22,202,154,48,2010,total_driving,NA
T122,T117,Rocco Mediate,25,202,170,32,2010,total_driving,NA
T122,T117,Andres Romero,21,202,24,178,2010,total_driving,NA
T125,T122,Martin Flores,26,203,11,192,2010,total_driving,NA
T125,T122,Camilo Villegas,20,203,77,126,2010,total_driving,NA
T127,T110,Jason Bohn,25,204,155,49,2010,total_driving,NA
T127,T129,Briny Baird,28,204,138,66,2010,total_driving,NA
T129,T129,Andrew McLardy,21,205,74,131,2010,total_driving,NA
T129,T131,Ted Purdy,30,205,66,139,2010,total_driving,NA
131,T113,Tim Petrovic,32,206,165,41,2010,total_driving,NA
T132,T122,James Driscoll,26,207,39,168,2010,total_driving,NA
T132,T127,Chris Wilson,26,207,58,149,2010,total_driving,NA
134,134,Chris Stroud,27,208,101,107,2010,total_driving,NA
135,T131,Matt Jones,27,209,42,167,2010,total_driving,NA
136,T131,Brian Stuard,28,210,105,105,2010,total_driving,NA
137,T135,Cameron Beckman,25,211,115,96,2010,total_driving,NA
138,T135,D.A. Points,29,214,133,81,2010,total_driving,NA
139,T137,Charles Howell III,28,215,34,181,2010,total_driving,NA
T140,T139,Daniel Chopra,28,216,25,191,2010,total_driving,NA
T140,T144,Derek Lamely,28,216,36,180,2010,total_driving,NA
142,143,Padraig Harrington,18,221,52,169,2010,total_driving,NA
T143,146,Bill Lunde,28,222,85,137,2010,total_driving,NA
T143,T141,Ian Poulter,15,222,109,113,2010,total_driving,NA
T145,T144,Kevin Na,26,223,167,56,2010,total_driving,NA
T145,T139,J.P. Hayes,25,223,148,75,2010,total_driving,NA
T145,T147,Spencer Levin,31,223,150,73,2010,total_driving,NA
T148,T141,Brent Delahoussaye,21,225,181,44,2010,total_driving,NA
T148,T147,George McNeill,28,225,41,184,2010,total_driving,NA
T148,151,Rory Sabbatini,26,225,82,143,2010,total_driving,NA
151,149,David Lutterus,25,226,55,171,2010,total_driving,NA
152,150,Michael Sim,20,228,127,101,2010,total_driving,NA
T153,T158,Charlie Wi,27,232,146,86,2010,total_driving,NA
T153,T156,Steve Flesch,25,232,173,59,2010,total_driving,NA
155,T153,Jimmy Walker,27,235,45,190,2010,total_driving,NA
T156,T156,Jeev Milkha Singh,19,236,100,136,2010,total_driving,NA
T156,T153,Stuart Appleby,31,236,84,152,2010,total_driving,NA
T158,155,Ernie Els,20,237,90,147,2010,total_driving,NA
T158,152,Steve Lowery,25,237,112,125,2010,total_driving,NA
160,T163,Shaun Micheel,21,242,128,114,2010,total_driving,NA
T161,T158,Michael Connell,25,243,144,99,2010,total_driving,NA
T161,T161,Roland Thatcher,26,243,95,148,2010,total_driving,NA
163,T161,Tim Herron,24,244,58,186,2010,total_driving,NA
164,T158,Troy Merritt,29,246,92,154,2010,total_driving,NA
165,T166,Lee Janzen,26,248,98,150,2010,total_driving,NA
166,T163,Carl Pettersson,29,249,137,112,2010,total_driving,NA
167,T166,Johnson Wagner,28,252,135,117,2010,total_driving,NA
168,165,Freddie Jacobson,24,253,131,122,2010,total_driving,NA
169,T168,Bob Estes,26,257,125,132,2010,total_driving,NA
170,170,Webb Simpson,31,258,118,140,2010,total_driving,NA
171,T168,Brandt Snedeker,26,260,176,84,2010,total_driving,NA
172,172,Geoff Ogilvy,19,265,104,161,2010,total_driving,NA
T173,T173,Joe Ogilvie,32,269,114,155,2010,total_driving,NA
T173,T176,Brenden Pappas,24,269,90,179,2010,total_driving,NA
T173,T173,Ryuji Imada,28,269,165,104,2010,total_driving,NA
T173,T173,Mark Calcavecchia,16,269,148,121,2010,total_driving,NA
177,T176,David Duval,24,271,105,166,2010,total_driving,NA
178,171,Kevin Johnson,26,272,178,94,2010,total_driving,NA
T179,T179,Brett Quigley,29,274,128,146,2010,total_driving,NA
T179,178,Bryce Molder,26,274,171,103,2010,total_driving,NA
181,T179,Ricky Barnes,28,276,117,159,2010,total_driving,NA
182,T181,Michael Bradley,24,284,143,141,2010,total_driving,NA
T183,T181,Rich Barcelo,25,286,99,187,2010,total_driving,NA
T183,183,Jerod Turner,21,286,160,126,2010,total_driving,NA
185,184,Nathan Green,27,292,157,135,2010,total_driving,NA
T186,185,Luke Donald,20,297,177,120,2010,total_driving,NA
T186,186,Vance Veazey,23,297,123,174,2010,total_driving,NA
188,187,Greg Kraft,22,306,187,119,2010,total_driving,NA
189,188,Chad Collins,26,324,180,144,2010,total_driving,NA
190,189,Greg Chalmers,27,333,182,151,2010,total_driving,NA
191,190,Brad Faxon,23,343,190,153,2010,total_driving,NA
192,191,Mike Weir,19,369,184,185,2010,total_driving,NA
1,1,John Merrick,21,66,41,25,2011,total_driving,NA
2,T3,John Rollins,27,74,46,28,2011,total_driving,NA
3,T3,Brandt Jobe,28,76,33,43,2011,total_driving,NA
4,2,Boo Weekley,23,79,48,31,2011,total_driving,NA
5,5,Adam Scott,18,86,24,62,2011,total_driving,NA
6,6,Chris Couch,21,93,44,49,2011,total_driving,NA
7,7,Chez Reavie,27,95,71,24,2011,total_driving,NA
8,T12,John Senden,26,101,72,29,2011,total_driving,NA
9,T8,Bo Van Pelt,27,105,38,67,2011,total_driving,NA
10,T8,Josh Teater,31,113,15,98,2011,total_driving,NA
11,14,Bill Haas,26,115,48,67,2011,total_driving,NA
T12,T8,Rod Pampling,21,116,84,32,2011,total_driving,NA
T12,T12,Keegan Bradley,28,116,20,96,2011,total_driving,NA
14,T15,Blake Adams,34,125,80,45,2011,total_driving,NA
15,18,Brendan Steele,27,127,77,50,2011,total_driving,NA
16,T15,J.J. Henry,28,128,92,36,2011,total_driving,NA
17,19,Briny Baird,19,129,112,17,2011,total_driving,NA
T18,17,Billy Horschel,25,133,94,39,2011,total_driving,NA
T18,20,Kyle Stanley,28,133,9,124,2011,total_driving,NA
20,21,Charley Hoffman,27,136,22,114,2011,total_driving,NA
T21,22,Scott McCarron,22,138,84,54,2011,total_driving,NA
T21,23,Charl Schwartzel,15,138,43,95,2011,total_driving,NA
23,26,Gary Woodland,25,142,5,137,2011,total_driving,NA
24,24,Webb Simpson,26,143,51,92,2011,total_driving,NA
25,25,Justin Hicks,23,145,132,13,2011,total_driving,NA
T26,28,Graeme McDowell,16,147,109,38,2011,total_driving,NA
T26,27,Martin Laird,23,147,13,134,2011,total_driving,NA
T28,T40,Kevin Stadler,27,149,74,75,2011,total_driving,NA
T28,T30,Steve Elkington,17,149,135,14,2011,total_driving,NA
30,T30,Dustin Johnson,21,150,3,147,2011,total_driving,NA
T31,35,Joe Durant,25,152,151,1,2011,total_driving,NA
T31,T33,Nick Watney,22,152,16,136,2011,total_driving,NA
T31,32,D.J. Trahan,30,152,31,121,2011,total_driving,NA
34,29,Troy Matteson,28,153,21,132,2011,total_driving,NA
T35,T33,Bubba Watson,22,154,2,152,2011,total_driving,NA
T35,NA,Will Strickler,19,154,10,144,2011,total_driving,NA
37,36,Bobby Gates,29,155,38,117,2011,total_driving,NA
38,T43,Pat Perez,24,156,90,66,2011,total_driving,NA
39,T37,D.A. Points,26,157,122,35,2011,total_driving,NA
40,T37,Davis Love III,22,158,33,125,2011,total_driving,NA
T41,42,Woody Austin,18,160,120,40,2011,total_driving,NA
T41,T37,Jason Bohn,22,160,139,21,2011,total_driving,NA
T43,T46,Scott Piercy,23,161,7,154,2011,total_driving,NA
T43,T50,Sung Kang,21,161,68,93,2011,total_driving,NA
T45,T40,Tag Ridings,28,162,12,150,2011,total_driving,NA
T45,T50,Billy Mayfair,29,162,153,9,2011,total_driving,NA
T45,T46,Tom Gillis,19,162,103,59,2011,total_driving,NA
T48,T46,Brian Davis,30,163,153,10,2011,total_driving,NA
T48,T50,Mark Wilson,26,163,143,20,2011,total_driving,NA
50,T58,Scott Stallings,28,164,11,153,2011,total_driving,NA
T51,T43,Heath Slocum,29,165,163,2,2011,total_driving,NA
T51,T62,Chad Campbell,29,165,92,73,2011,total_driving,NA
T51,T62,Ben Crane,23,165,139,26,2011,total_driving,NA
54,T43,Steve Marino,23,166,59,107,2011,total_driving,NA
T55,64,Hunter Mahan,25,167,84,83,2011,total_driving,NA
T55,T50,Lucas Glover,23,167,63,104,2011,total_driving,NA
T55,T46,Sergio Garcia,16,167,28,139,2011,total_driving,NA
T58,69,Carl Pettersson,27,168,81,87,2011,total_driving,NA
T58,T55,David Hearn,26,168,96,72,2011,total_driving,NA
T60,T58,Jason Dufner,23,169,125,44,2011,total_driving,NA
T60,T58,Aron Price,18,169,158,11,2011,total_driving,NA
T60,T50,Jim Herman,22,169,18,151,2011,total_driving,NA
63,T72,Jeff Overton,26,170,58,112,2011,total_driving,NA
64,T55,Jim Renner,22,171,44,127,2011,total_driving,NA
T65,T65,Cameron Tringale,32,172,66,106,2011,total_driving,NA
T65,T74,Andres Gonzales,21,172,75,97,2011,total_driving,NA
T65,T58,Stephen Ames,22,172,150,22,2011,total_driving,NA
T68,T65,Justin Rose,23,173,99,74,2011,total_driving,NA
T68,T55,Zack Miller,30,173,25,148,2011,total_driving,NA
70,T70,Scott Gutschewski,23,174,36,138,2011,total_driving,NA
71,T67,Steven Bowditch,28,175,6,169,2011,total_driving,NA
T72,T70,Alex Prugh,29,176,31,145,2011,total_driving,NA
T72,T78,Kevin Streelman,26,176,111,65,2011,total_driving,NA
T72,T67,Tommy Gainey,34,176,46,130,2011,total_driving,NA
75,T109,Roland Thatcher,22,177,75,102,2011,total_driving,NA
T76,T90,Hunter Haas,30,178,114,64,2011,total_driving,NA
T76,89,Kent Jones,25,178,137,41,2011,total_driving,NA
78,T74,Brendon de Jonge,30,179,119,60,2011,total_driving,NA
T79,T102,Matt Kuchar,24,180,128,52,2011,total_driving,NA
T79,T72,George McNeill,21,180,60,120,2011,total_driving,NA
T79,T84,Ryan Moore,22,180,103,77,2011,total_driving,NA
T79,T78,Ben Martin,25,180,109,71,2011,total_driving,NA
T79,T74,Joseph Bramlett,25,180,57,123,2011,total_driving,NA
T84,T78,Jhonattan Vegas,25,181,8,173,2011,total_driving,NA
T84,T84,Robert Allenby,25,181,100,81,2011,total_driving,NA
T84,T78,David Toms,23,181,175,6,2011,total_driving,NA
T87,T86,Jim Furyk,26,182,164,18,2011,total_driving,NA
T87,T86,Lee Janzen,19,182,103,79,2011,total_driving,NA
T87,T74,Rickie Fowler,24,182,25,157,2011,total_driving,NA
T90,T98,Charles Howell III,30,183,40,143,2011,total_driving,NA
T90,T78,Robert Karlsson,18,183,28,155,2011,total_driving,NA
T90,T96,Johnson Wagner,25,183,160,23,2011,total_driving,NA
T90,T86,J.B. Holmes,16,183,1,182,2011,total_driving,NA
T94,116,Alexandre Rocha,22,184,96,88,2011,total_driving,NA
T94,T90,Robert Garrigus,26,184,4,180,2011,total_driving,NA
T94,T102,Kevin Chappell,26,184,55,129,2011,total_driving,NA
T97,T98,Zach Johnson,23,185,177,8,2011,total_driving,NA
T97,T96,Brandt Snedeker,26,185,124,61,2011,total_driving,NA
T97,T102,Ben Curtis,23,185,180,5,2011,total_driving,NA
T100,T90,Chris Riley,25,186,174,12,2011,total_driving,NA
T100,T98,Jerry Kelly,26,186,183,3,2011,total_driving,NA
T100,T90,Jason Day,21,186,14,172,2011,total_driving,NA
T103,T107,Vijay Singh,25,188,66,122,2011,total_driving,NA
T103,106,Geoff Ogilvy,21,188,106,82,2011,total_driving,NA
T103,T109,Y.E. Yang,18,188,100,88,2011,total_driving,NA
T106,T98,Nick O'Hern,29,189,182,7,2011,total_driving,NA
T106,T102,Ángel Cabrera,17,189,19,170,2011,total_driving,NA
T108,T107,Brian Gay,26,190,186,4,2011,total_driving,NA
T108,T109,Garrett Willis,24,190,171,19,2011,total_driving,NA
T108,T121,David Mathis,25,190,161,29,2011,total_driving,NA
T108,T112,Matt McQuillan,21,190,135,55,2011,total_driving,NA
T112,T90,Bill Lunde,28,192,89,103,2011,total_driving,NA
T112,T78,Rich Beem,21,192,129,63,2011,total_driving,NA
114,T117,Fabián Gómez,26,194,116,78,2011,total_driving,NA
T115,115,Bryce Molder,27,195,161,34,2011,total_driving,NA
T115,T117,Shane Bertsch,20,195,168,27,2011,total_driving,NA
T117,T112,James Driscoll,24,196,33,163,2011,total_driving,NA
T117,T112,Spencer Levin,31,196,127,69,2011,total_driving,NA
119,120,Steve Stricker,19,198,113,85,2011,total_driving,NA
T120,T123,Phil Mickelson,21,199,22,177,2011,total_driving,NA
T120,T127,Jonathan Byrd,26,199,84,115,2011,total_driving,NA
T122,T121,Rocco Mediate,23,200,184,16,2011,total_driving,NA
T122,T125,Paul Goydos,25,200,185,15,2011,total_driving,NA
T124,T125,Harrison Frazar,19,201,17,184,2011,total_driving,NA
T124,T117,Ryan Palmer,24,201,25,176,2011,total_driving,NA
126,129,Andres Romero,22,202,61,141,2011,total_driving,NA
T127,T132,Luke Donald,19,204,147,57,2011,total_driving,NA
T127,T123,Alex Cejka,21,204,167,37,2011,total_driving,NA
T129,T139,Vaughn Taylor,27,205,147,58,2011,total_driving,NA
T129,131,Ricky Barnes,23,205,72,133,2011,total_driving,NA
T129,130,Camilo Villegas,25,205,65,140,2011,total_driving,NA
T132,T132,Ian Poulter,16,206,155,51,2011,total_driving,NA
T132,NA,Retief Goosen,16,206,107,99,2011,total_driving,NA
T134,T136,Trevor Immelman,25,208,114,94,2011,total_driving,NA
T134,T136,Jimmy Walker,24,208,30,178,2011,total_driving,NA
T136,T134,Chris Stroud,28,210,91,119,2011,total_driving,NA
T136,T136,Michael Thompson,25,210,94,116,2011,total_driving,NA
138,T141,Chris DiMarco,31,211,178,33,2011,total_driving,NA
139,143,Michael Putnam,21,212,41,171,2011,total_driving,NA
140,T127,J.P. Hayes,19,213,157,56,2011,total_driving,NA
T141,T145,Justin Leonard,26,215,168,47,2011,total_driving,NA
T141,151,Kris Blanks,29,215,139,76,2011,total_driving,NA
T141,T141,Troy Merritt,23,215,125,90,2011,total_driving,NA
T144,T145,Chris Kirk,28,217,56,161,2011,total_driving,NA
T144,148,Aaron Baddeley,22,217,51,166,2011,total_driving,NA
T146,T145,Michael Connell,26,218,173,45,2011,total_driving,NA
T146,T134,Colt Knost,27,218,176,42,2011,total_driving,NA
T146,T139,William McGirt,32,218,107,111,2011,total_driving,NA
149,T149,Tim Petrovic,29,219,166,53,2011,total_driving,NA
150,T149,Derek Lamely,26,222,37,185,2011,total_driving,NA
151,152,Daniel Summerhays,29,223,139,84,2011,total_driving,NA
152,T154,K.J. Choi,22,225,134,91,2011,total_driving,NA
T153,153,Sean O'Hair,24,227,63,164,2011,total_driving,NA
T153,158,Tim Herron,28,227,81,146,2011,total_driving,NA
T153,156,Dean Wilson,22,227,179,48,2011,total_driving,NA
156,157,Marc Leishman,27,228,54,174,2011,total_driving,NA
157,T154,Freddie Jacobson,25,232,122,110,2011,total_driving,NA
158,T159,David Duval,24,233,50,183,2011,total_driving,NA
T159,163,Charlie Wi,25,234,133,101,2011,total_driving,NA
T159,T159,Rory Sabbatini,24,234,78,156,2011,total_driving,NA
T159,165,Bio Kim,25,234,53,181,2011,total_driving,NA
T162,166,Marc Turnesa,20,235,155,80,2011,total_driving,NA
T162,T159,Ernie Els,21,235,118,117,2011,total_driving,NA
164,164,Matt Jones,25,237,70,167,2011,total_driving,NA
T165,167,Stewart Cink,22,240,81,159,2011,total_driving,NA
T165,168,Padraig Harrington,18,240,61,179,2011,total_driving,NA
167,T159,Joe Ogilvie,24,242,84,158,2011,total_driving,NA
168,174,Michael Bradley,24,247,98,149,2011,total_driving,NA
169,T170,Cameron Beckman,25,249,145,104,2011,total_driving,NA
170,169,Richard Johnson,23,251,181,70,2011,total_driving,NA
T171,172,Martin Piller,23,254,79,175,2011,total_driving,NA
T171,T170,Kevin Kisner,24,254,145,109,2011,total_driving,NA
T171,176,Anthony Kim,26,254,68,186,2011,total_driving,NA
174,175,Stuart Appleby,24,256,121,135,2011,total_driving,NA
175,177,Greg Chalmers,28,258,172,86,2011,total_driving,NA
176,173,Steve Flesch,27,259,159,100,2011,total_driving,NA
177,179,Jarrod Lyle,29,260,129,131,2011,total_driving,NA
178,T181,Nathan Green,26,263,137,126,2011,total_driving,NA
179,178,Ryuji Imada,29,265,152,113,2011,total_driving,NA
180,T181,D.J. Brigman,23,268,100,168,2011,total_driving,NA
181,180,Nate Smith,24,272,165,107,2011,total_driving,NA
T182,184,Paul Stankowski,24,277,149,128,2011,total_driving,NA
T182,183,Matt Bettencourt,30,277,117,160,2011,total_driving,NA
184,185,Shaun Micheel,27,294,129,165,2011,total_driving,NA
185,186,Arjun Atwal,29,305,143,162,2011,total_driving,NA
186,187,Kevin Na,26,312,170,142,2011,total_driving,NA
1,1,Boo Weekley,25,74,36,38,2012,total_driving,NA
2,2,Hunter Mahan,23,78,61,17,2012,total_driving,NA
3,T5,Bo Van Pelt,24,84,40,44,2012,total_driving,NA
T4,3,Jason Dufner,22,85,64,21,2012,total_driving,NA
T4,4,Chris Couch,21,85,54,31,2012,total_driving,NA
6,T5,Tiger Woods,19,87,32,55,2012,total_driving,NA
7,7,Louis Oosthuizen,19,90,23,67,2012,total_driving,NA
8,9,Brandt Jobe,18,91,25,66,2012,total_driving,NA
9,8,John Rollins,26,98,47,51,2012,total_driving,NA
10,T11,Kevin Stadler,25,102,62,40,2012,total_driving,NA
T11,T13,John Senden,22,103,79,24,2012,total_driving,NA
T11,T11,Keegan Bradley,25,103,16,87,2012,total_driving,NA
T13,T13,John Merrick,26,105,58,47,2012,total_driving,NA
T13,10,Lee Westwood,15,105,29,76,2012,total_driving,NA
T15,17,Justin Rose,19,108,80,28,2012,total_driving,NA
T15,15,Rickie Fowler,23,108,60,48,2012,total_driving,NA
17,16,Billy Horschel,17,111,89,22,2012,total_driving,NA
18,18,Roberto Castro,27,117,83,34,2012,total_driving,NA
T19,T23,Will Claxton,28,119,85,34,2012,total_driving,NA
T19,20,Charley Hoffman,27,119,46,73,2012,total_driving,NA
21,22,Brian Harman,30,120,87,33,2012,total_driving,NA
22,T23,Bill Haas,23,122,66,56,2012,total_driving,NA
T23,19,Josh Teater,30,123,27,96,2012,total_driving,NA
T23,21,Graham DeLaet,23,123,13,110,2012,total_driving,NA
25,T23,John Huh,28,124,113,11,2012,total_driving,NA
26,33,Tom Gillis,23,126,103,23,2012,total_driving,NA
27,26,Kyle Stanley,27,132,8,124,2012,total_driving,NA
28,T27,Adam Scott,16,133,10,123,2012,total_driving,NA
29,T34,Cameron Tringale,26,134,85,49,2012,total_driving,NA
30,T31,Charl Schwartzel,16,135,42,93,2012,total_driving,NA
31,29,Bubba Watson,19,136,1,135,2012,total_driving,NA
32,30,Vijay Singh,27,137,47,90,2012,total_driving,NA
33,T27,Blake Adams,32,139,112,27,2012,total_driving,NA
T34,T34,Charlie Beljan,22,141,2,139,2012,total_driving,NA
T34,40,Graeme McDowell,16,141,136,5,2012,total_driving,NA
T36,T37,Pat Perez,23,144,75,69,2012,total_driving,NA
T36,36,Richard Lee,24,144,134,10,2012,total_driving,NA
38,T31,Harris English,27,145,20,125,2012,total_driving,NA
T39,T37,Seung-Yul Noh,28,146,19,127,2012,total_driving,NA
T39,T37,Ryan Moore,24,146,117,29,2012,total_driving,NA
T41,T43,Sean O'Hair,24,149,31,118,2012,total_driving,NA
T41,NA,Henrik Stenson,15,149,96,53,2012,total_driving,NA
43,T41,Jeff Overton,29,150,68,82,2012,total_driving,NA
T44,45,Russell Knox,23,152,132,20,2012,total_driving,NA
T44,T41,Kevin Streelman,26,152,63,89,2012,total_driving,NA
46,46,Greg Owen,27,156,41,115,2012,total_driving,NA
T47,T48,Martin Laird,22,157,28,129,2012,total_driving,NA
T47,T48,Scott Stallings,27,157,17,140,2012,total_driving,NA
T49,47,Bobby Gates,29,158,21,137,2012,total_driving,NA
T49,51,Billy Mayfair,28,158,122,36,2012,total_driving,NA
51,52,Ryan Palmer,24,159,15,144,2012,total_driving,NA
T52,57,Robert Garrigus,26,160,3,157,2012,total_driving,NA
T52,50,Jeff Maggert,27,160,141,19,2012,total_driving,NA
T54,T43,D.J. Trahan,27,161,66,95,2012,total_driving,NA
T54,T53,Rory McIlroy,16,161,5,156,2012,total_driving,NA
T56,T53,Dustin Johnson,19,162,4,158,2012,total_driving,NA
T56,T58,Sergio Garcia,16,162,64,98,2012,total_driving,NA
58,T53,Brendan Steele,24,163,105,58,2012,total_driving,NA
59,60,Brendon de Jonge,31,164,105,59,2012,total_driving,NA
60,T58,Camilo Villegas,25,165,87,78,2012,total_driving,NA
61,T63,Geoff Ogilvy,20,168,90,78,2012,total_driving,NA
T62,61,Rod Pampling,26,169,105,64,2012,total_driving,NA
T62,T63,Davis Love III,20,169,39,130,2012,total_driving,NA
T64,T69,Matt Kuchar,22,170,128,42,2012,total_driving,NA
T64,T63,Nick Watney,26,170,36,134,2012,total_driving,NA
66,T69,Erik Compton,26,171,33,138,2012,total_driving,NA
T67,T72,Ben Crane,23,172,122,50,2012,total_driving,NA
T67,62,Garth Mulroy,20,172,55,117,2012,total_driving,NA
T69,T63,Scott Piercy,28,173,12,161,2012,total_driving,NA
T69,T69,Gary Christian,28,173,164,9,2012,total_driving,NA
T69,T63,John Daly,15,173,9,164,2012,total_driving,NA
T72,T63,Chez Reavie,26,174,161,13,2012,total_driving,NA
T72,T79,Kris Blanks,23,174,148,26,2012,total_driving,NA
T74,T74,Jim Furyk,24,175,171,4,2012,total_driving,NA
T74,T72,Ángel Cabrera,20,175,22,153,2012,total_driving,NA
T76,T77,Padraig Harrington,18,177,57,120,2012,total_driving,NA
T76,T77,Heath Slocum,29,177,175,2,2012,total_driving,NA
T76,56,Kyle Reifers,27,177,92,85,2012,total_driving,NA
79,T74,J.J. Henry,28,178,115,63,2012,total_driving,NA
T80,T99,Roland Thatcher,21,179,104,75,2012,total_driving,NA
T80,T79,J.B. Holmes,25,179,6,173,2012,total_driving,NA
T82,81,John Mallinger,25,182,166,16,2012,total_driving,NA
T82,T74,Daniel Summerhays,26,182,101,81,2012,total_driving,NA
T82,T83,Zach Johnson,25,182,168,14,2012,total_driving,NA
T85,T85,Carl Pettersson,26,183,35,148,2012,total_driving,NA
T85,T83,Tim Clark,20,183,180,3,2012,total_driving,NA
T85,82,Jerry Kelly,26,183,182,1,2012,total_driving,NA
88,T88,Ian Poulter,15,184,145,39,2012,total_driving,NA
89,T85,Bud Cauley,28,186,74,112,2012,total_driving,NA
90,T88,Steve Wheatcroft,22,189,121,68,2012,total_driving,NA
T91,T94,Kevin Na,25,190,165,25,2012,total_driving,NA
T91,92,Jhonattan Vegas,25,190,10,180,2012,total_driving,NA
T91,96,David Toms,19,190,184,6,2012,total_driving,NA
T91,T114,Ken Duke,30,190,160,30,2012,total_driving,NA
T91,T88,Jason Kokrak,27,190,14,176,2012,total_driving,NA
T91,91,Gary Woodland,22,190,18,172,2012,total_driving,NA
T91,87,Scott Brown,24,190,77,113,2012,total_driving,NA
T98,T94,Jason Day,17,191,7,184,2012,total_driving,NA
T98,97,Stuart Appleby,24,191,159,32,2012,total_driving,NA
100,93,Ben Curtis,19,193,186,7,2012,total_driving,NA
101,T114,Chris Kirk,27,194,73,121,2012,total_driving,NA
102,T99,Mark Wilson,25,195,183,12,2012,total_driving,NA
T103,T102,Chris DiMarco,29,196,188,8,2012,total_driving,NA
T103,T102,David Hearn,28,196,124,72,2012,total_driving,NA
T105,T102,D.A. Points,29,197,152,45,2012,total_driving,NA
T105,T102,Brian Davis,29,197,179,18,2012,total_driving,NA
T105,T99,Chris Stroud,28,197,126,71,2012,total_driving,NA
108,T106,Tommy Gainey,32,198,33,165,2012,total_driving,NA
109,T108,Steve Stricker,19,199,138,61,2012,total_driving,NA
T110,T114,Harrison Frazar,20,200,30,170,2012,total_driving,NA
T110,T111,"Ted Potter, Jr.",25,200,148,52,2012,total_driving,NA
T112,T108,Trevor Immelman,24,201,80,121,2012,total_driving,NA
T112,110,Hunter Haas,24,201,117,84,2012,total_driving,NA
114,T111,Webb Simpson,22,203,111,92,2012,total_driving,NA
T115,T121,Colt Knost,29,204,189,15,2012,total_driving,NA
T115,T118,George McNeill,25,204,105,99,2012,total_driving,NA
T115,T118,Alexandre Rocha,21,204,147,57,2012,total_driving,NA
T115,123,Chad Campbell,27,204,90,114,2012,total_driving,NA
T119,T121,Ernie Els,22,206,51,155,2012,total_driving,NA
T119,T118,Troy Kelly,23,206,23,183,2012,total_driving,NA
T121,117,Edward Loar,23,207,44,163,2012,total_driving,NA
T121,124,Luke Donald,17,207,170,37,2012,total_driving,NA
T123,T126,Ricky Barnes,28,208,68,140,2012,total_driving,NA
T123,T126,Troy Matteson,32,208,26,182,2012,total_driving,NA
125,98,Scott Dunlap,20,211,166,45,2012,total_driving,NA
126,T130,Kevin Chappell,29,212,58,154,2012,total_driving,NA
127,133,Bill Lunde,25,215,84,131,2012,total_driving,NA
T128,T130,K.J. Choi,21,216,162,54,2012,total_driving,NA
T128,T126,Kyle Thompson,22,216,151,65,2012,total_driving,NA
T130,125,Robert Karlsson,17,217,50,167,2012,total_driving,NA
T130,T111,Jason Bohn,28,217,174,43,2012,total_driving,NA
T130,T106,Kevin Kisner,24,217,116,101,2012,total_driving,NA
133,129,Tim Herron,27,218,99,119,2012,total_driving,NA
T134,132,Brandt Snedeker,22,219,110,109,2012,total_driving,NA
T134,T134,Jimmy Walker,28,219,38,181,2012,total_driving,NA
T136,136,Matt Jones,19,221,55,166,2012,total_driving,NA
T136,141,Charlie Wi,25,221,134,87,2012,total_driving,NA
T138,T142,Charles Howell III,29,222,51,171,2012,total_driving,NA
T138,T137,Johnson Wagner,27,222,152,70,2012,total_driving,NA
T138,T137,Rory Sabbatini,29,222,119,103,2012,total_driving,NA
T138,T134,Danny Lee,26,222,72,150,2012,total_driving,NA
142,T142,Dicky Pride,19,224,130,94,2012,total_driving,NA
143,T142,Martin Flores,30,226,49,177,2012,total_driving,NA
144,145,Phil Mickelson,22,227,53,174,2012,total_driving,NA
145,T137,Cameron Beckman,26,228,142,86,2012,total_driving,NA
T146,T137,Mathew Goggin,23,229,82,147,2012,total_driving,NA
T146,T146,Mark Anderson,25,229,43,186,2012,total_driving,NA
148,T149,Gavin Coles,23,231,190,41,2012,total_driving,NA
T149,T149,Daniel Chopra,21,235,44,191,2012,total_driving,NA
T149,T159,Vaughn Taylor,26,235,129,106,2012,total_driving,NA
T151,T153,Andres Romero,22,237,68,169,2012,total_driving,NA
T151,155,Sangmoon Bae,25,237,95,142,2012,total_driving,NA
T153,T151,David Mathis,29,238,176,62,2012,total_driving,NA
T153,T151,Stephen Ames,20,238,155,83,2012,total_driving,NA
155,T164,Matt Every,25,240,136,104,2012,total_driving,NA
T156,T146,Miguel Angel Carballo,25,241,96,145,2012,total_driving,NA
T156,T159,Jonathan Byrd,21,241,96,145,2012,total_driving,NA
T158,T146,Rocco Mediate,23,243,169,74,2012,total_driving,NA
T158,157,Aaron Baddeley,22,243,68,175,2012,total_driving,NA
T158,156,Greg Chalmers,25,243,163,80,2012,total_driving,NA
161,T153,Arjun Atwal,27,244,144,100,2012,total_driving,NA
162,158,William McGirt,30,245,138,107,2012,total_driving,NA
163,162,Bob Estes,23,247,142,105,2012,total_driving,NA
164,161,Y.E. Yang,20,248,146,102,2012,total_driving,NA
T165,163,Robert Allenby,27,251,124,127,2012,total_driving,NA
T165,T164,Nick O'Hern,26,251,191,60,2012,total_driving,NA
T167,167,Brian Gay,28,254,177,77,2012,total_driving,NA
T167,166,J.J. Killeen,33,254,94,160,2012,total_driving,NA
169,168,Jonas Blixt,21,260,127,133,2012,total_driving,NA
170,T169,Freddie Jacobson,17,262,119,143,2012,total_driving,NA
171,T169,Stephen Gangluff,23,265,75,190,2012,total_driving,NA
T172,171,James Driscoll,27,267,78,189,2012,total_driving,NA
T172,T172,Marc Leishman,23,267,99,168,2012,total_driving,NA
174,T172,Bryce Molder,25,269,178,91,2012,total_driving,NA
175,175,Ryo Ishikawa,18,271,92,179,2012,total_driving,NA
176,177,Sung Kang,30,282,133,149,2012,total_driving,NA
T177,184,Stewart Cink,22,283,105,178,2012,total_driving,NA
T177,174,Justin Leonard,26,283,172,111,2012,total_driving,NA
T179,183,Tom Pernice Jr.,23,284,187,97,2012,total_driving,NA
T179,178,Michael Thompson,25,284,158,126,2012,total_driving,NA
181,179,Nathan Green,22,286,154,132,2012,total_driving,NA
T182,182,Derek Lamely,25,289,102,187,2012,total_driving,NA
T182,187,Patrick Sheehan,21,289,173,116,2012,total_driving,NA
184,180,Tommy Biershenk,27,290,138,152,2012,total_driving,NA
185,186,Marco Dawson,22,292,130,162,2012,total_driving,NA
T186,176,Brendon Todd,29,293,157,136,2012,total_driving,NA
T186,181,Billy Hurley III,27,293,185,108,2012,total_driving,NA
188,185,Matt Bettencourt,31,299,114,185,2012,total_driving,NA
189,188,Spencer Levin,26,306,155,151,2012,total_driving,NA
190,189,Michael Bradley,23,336,148,188,2012,total_driving,NA
191,190,Ryuji Imada,28,340,181,159,2012,total_driving,NA
1,1,Graham DeLaet,26,53,19,34,2013,total_driving,NA
2,3,Keegan Bradley,25,72,11,61,2013,total_driving,NA
3,2,Henrik Stenson,18,73,66,7,2013,total_driving,NA
4,4,Justin Rose,17,79,27,52,2013,total_driving,NA
5,5,Jim Herman,19,82,17,65,2013,total_driving,NA
6,T9,Billy Horschel,26,92,42,50,2013,total_driving,NA
7,6,Boo Weekley,27,94,66,28,2013,total_driving,NA
T8,15,Hunter Mahan,25,98,73,25,2013,total_driving,NA
T8,8,Jordan Spieth,23,98,80,18,2013,total_driving,NA
10,12,D.J. Trahan,16,99,46,53,2013,total_driving,NA
11,T9,Brandt Jobe,19,100,57,43,2013,total_driving,NA
12,11,Matt Jones,24,101,56,45,2013,total_driving,NA
13,T13,Nicholas Thompson,29,105,60,45,2013,total_driving,NA
14,T13,Adam Scott,16,107,23,84,2013,total_driving,NA
15,16,Vaughn Taylor,16,112,75,37,2013,total_driving,NA
16,17,Kevin Streelman,25,117,94,23,2013,total_driving,NA
17,7,Tiger Woods,16,118,49,69,2013,total_driving,NA
18,18,Kevin Stadler,25,124,75,49,2013,total_driving,NA
19,22,Steve Stricker,13,127,124,3,2013,total_driving,NA
20,T20,Lucas Glover,23,128,43,85,2013,total_driving,NA
21,19,Russell Henley,24,130,83,47,2013,total_driving,NA
22,T24,Bubba Watson,21,131,5,126,2013,total_driving,NA
23,23,Brendon de Jonge,30,133,104,29,2013,total_driving,NA
24,27,Chez Reavie,22,134,128,6,2013,total_driving,NA
25,28,Lee Westwood,19,135,69,66,2013,total_driving,NA
26,26,Nick Watney,26,136,63,73,2013,total_driving,NA
T27,T24,Charl Schwartzel,19,139,29,110,2013,total_driving,NA
T27,T30,Kevin Chappell,24,139,52,87,2013,total_driving,NA
T29,29,Robert Streb,25,140,24,116,2013,total_driving,NA
T29,T30,Kyle Stanley,24,140,22,118,2013,total_driving,NA
T31,T33,Josh Teater,24,142,43,99,2013,total_driving,NA
T31,T30,George McNeill,21,142,106,36,2013,total_driving,NA
33,35,Charlie Beljan,24,143,32,111,2013,total_driving,NA
34,36,Martin Laird,21,144,46,98,2013,total_driving,NA
35,T37,Henrik Norlander,22,145,36,109,2013,total_driving,NA
T36,T39,Steve LeBrun,21,146,38,108,2013,total_driving,NA
T36,T39,Ryan Moore,22,146,130,16,2013,total_driving,NA
38,T39,John Huh,28,147,133,14,2013,total_driving,NA
T39,51,Jason Dufner,22,148,107,41,2013,total_driving,NA
T39,43,Rory McIlroy,16,148,8,140,2013,total_driving,NA
T39,T37,Tom Gillis,22,148,104,44,2013,total_driving,NA
42,T39,David Lingmerth,23,149,109,40,2013,total_driving,NA
43,T46,Gary Woodland,26,150,4,146,2013,total_driving,NA
44,45,Roberto Castro,29,152,130,22,2013,total_driving,NA
T45,T49,Scott Brown,21,154,78,76,2013,total_driving,NA
T45,48,Brendan Steele,26,154,68,86,2013,total_driving,NA
T45,T33,Jason Day,21,154,16,138,2013,total_driving,NA
T48,T49,Justin Hicks,25,155,146,9,2013,total_driving,NA
T48,T52,Ryan Palmer,22,155,10,145,2013,total_driving,NA
T50,44,Sergio Garcia,17,156,64,92,2013,total_driving,NA
T50,T52,Charley Hoffman,23,156,40,116,2013,total_driving,NA
T50,T52,Scott Stallings,27,156,30,126,2013,total_driving,NA
T50,T56,Eric Meierdierks,19,156,9,147,2013,total_driving,NA
54,T58,Cameron Tringale,24,157,98,59,2013,total_driving,NA
T55,T52,J.J. Henry,26,158,119,39,2013,total_driving,NA
T55,T56,Bo Van Pelt,22,158,107,51,2013,total_driving,NA
57,T58,Mark Wilson,19,160,158,2,2013,total_driving,NA
T58,T61,Zach Johnson,24,161,153,8,2013,total_driving,NA
T58,T61,Fabián Gómez,23,161,78,83,2013,total_driving,NA
T58,T58,"Ted Potter, Jr.",22,161,144,17,2013,total_driving,NA
T61,T64,Pat Perez,22,162,71,91,2013,total_driving,NA
T61,T61,John Rollins,24,162,31,131,2013,total_driving,NA
63,T66,Brad Fritsch,24,163,26,137,2013,total_driving,NA
T64,T66,Harris English,26,164,35,129,2013,total_driving,NA
T64,T64,Rory Sabbatini,27,164,50,114,2013,total_driving,NA
T66,T66,Cameron Percy,21,165,45,120,2013,total_driving,NA
T66,T66,Greg Owen,24,165,53,112,2013,total_driving,NA
T66,T73,Y.E. Yang,19,165,101,64,2013,total_driving,NA
T69,T81,Webb Simpson,25,166,111,55,2013,total_driving,NA
T69,T66,Brian Davis,28,166,153,13,2013,total_driving,NA
T69,T73,Doug LaBelle II,23,166,145,21,2013,total_driving,NA
T69,T71,Derek Ernst,21,166,61,105,2013,total_driving,NA
T69,T71,Brian Stuard,25,166,134,32,2013,total_driving,NA
74,T46,Bill Haas,25,167,90,77,2013,total_driving,NA
T75,T77,Andrew Svoboda,18,168,71,97,2013,total_driving,NA
T75,76,Vijay Singh,19,168,91,77,2013,total_driving,NA
77,T77,Robert Garrigus,22,169,7,162,2013,total_driving,NA
T78,T73,D.H. Lee,22,170,140,30,2013,total_driving,NA
T78,T77,Nicolas Colsaerts,17,170,3,167,2013,total_driving,NA
T78,T77,Ben Kohles,25,170,151,19,2013,total_driving,NA
T81,83,Bob Estes,18,171,115,56,2013,total_driving,NA
T81,T81,Jeff Maggert,21,171,160,11,2013,total_driving,NA
83,84,Sean O'Hair,22,172,14,158,2013,total_driving,NA
T84,T87,Jim Furyk,22,173,169,4,2013,total_driving,NA
T84,T85,Richard Lee,24,173,149,24,2013,total_driving,NA
T84,T85,Dustin Johnson,22,173,2,171,2013,total_driving,NA
87,T87,Morgan Hoffmann,20,175,32,143,2013,total_driving,NA
T88,90,Martin Kaymer,17,176,87,89,2013,total_driving,NA
T88,89,Graeme McDowell,16,176,161,15,2013,total_driving,NA
T90,T91,Will Claxton,24,178,116,62,2013,total_driving,NA
T90,T91,Jerry Kelly,22,178,177,1,2013,total_driving,NA
T90,T91,Jason Kokrak,25,178,6,172,2013,total_driving,NA
T90,T94,James Hahn,26,178,48,130,2013,total_driving,NA
T94,T94,Ken Duke,28,180,170,10,2013,total_driving,NA
T94,T97,Tim Clark,20,180,175,5,2013,total_driving,NA
T94,96,Martin Flores,25,180,12,168,2013,total_driving,NA
97,T97,Luke List,24,181,1,180,2013,total_driving,NA
98,T101,Rickie Fowler,22,183,103,80,2013,total_driving,NA
99,99,John Senden,25,184,82,102,2013,total_driving,NA
T100,T101,Chad Campbell,25,185,85,100,2013,total_driving,NA
T100,T101,Tag Ridings,24,185,15,170,2013,total_driving,NA
102,T104,Ricky Barnes,26,186,80,106,2013,total_driving,NA
T103,T104,Steven Bowditch,22,187,13,174,2013,total_driving,NA
T103,T104,K.J. Choi,24,187,156,31,2013,total_driving,NA
T103,T109,Stuart Appleby,25,187,119,68,2013,total_driving,NA
T106,T107,David Toms,16,188,162,26,2013,total_driving,NA
T106,T107,Peter Hanson,15,188,34,154,2013,total_driving,NA
T108,T109,Jin Park,20,189,177,12,2013,total_driving,NA
T108,T114,Carl Pettersson,24,189,70,119,2013,total_driving,NA
T108,T109,Shawn Stefani,21,189,25,164,2013,total_driving,NA
T111,T109,Scott Piercy,24,190,21,169,2013,total_driving,NA
T111,116,Camilo Villegas,23,190,59,131,2013,total_driving,NA
T111,118,Charlie Wi,23,190,132,58,2013,total_driving,NA
T111,T109,Darron Stiles,20,190,170,20,2013,total_driving,NA
115,117,Daniel Summerhays,26,191,110,81,2013,total_driving,NA
116,T120,D.A. Points,28,192,138,54,2013,total_driving,NA
117,T120,Brian Harman,29,195,94,101,2013,total_driving,NA
T118,T120,Seung-Yul Noh,25,196,18,178,2013,total_driving,NA
T118,119,Jimmy Walker,24,196,20,176,2013,total_driving,NA
T118,T120,Ángel Cabrera,21,196,40,156,2013,total_driving,NA
121,T124,Jeff Overton,24,197,55,142,2013,total_driving,NA
T122,T126,Andres Romero,21,198,50,148,2013,total_driving,NA
T122,T126,Chris Kirk,24,198,83,115,2013,total_driving,NA
124,128,Troy Matteson,24,199,38,161,2013,total_driving,NA
125,129,Jason Bohn,23,201,166,35,2013,total_driving,NA
T126,T124,Brandt Snedeker,23,204,137,67,2013,total_driving,NA
T126,132,Rod Pampling,16,204,129,75,2013,total_driving,NA
T128,T133,Robert Karlsson,18,205,98,107,2013,total_driving,NA
T128,T130,Erik Compton,24,205,54,151,2013,total_driving,NA
T128,T130,Bobby Gates,20,205,28,177,2013,total_driving,NA
131,T133,Colt Knost,25,206,179,27,2013,total_driving,NA
132,T138,Ian Poulter,16,207,136,71,2013,total_driving,NA
T133,T136,Bryce Molder,24,209,176,33,2013,total_driving,NA
T133,135,Geoff Ogilvy,19,209,114,95,2013,total_driving,NA
135,T136,Charles Howell III,26,210,37,173,2013,total_driving,NA
T136,T138,Brian Gay,24,212,170,42,2013,total_driving,NA
T136,T138,Dicky Pride,23,212,174,38,2013,total_driving,NA
T138,T143,David Mathis,24,213,142,71,2013,total_driving,NA
T138,T145,William McGirt,24,213,134,79,2013,total_driving,NA
T140,T141,Justin Leonard,24,214,166,48,2013,total_driving,NA
T140,T141,Matt Every,28,214,91,123,2013,total_driving,NA
142,T143,Patrick Reed,26,215,58,157,2013,total_driving,NA
143,147,Bud Cauley,24,216,94,122,2013,total_driving,NA
T144,148,Tommy Gainey,28,217,64,153,2013,total_driving,NA
T144,T145,Luke Donald,17,217,157,60,2013,total_driving,NA
146,150,Trevor Immelman,24,218,124,94,2013,total_driving,NA
T147,149,Ernie Els,19,220,77,143,2013,total_driving,NA
T147,T154,Aaron Watkins,19,220,163,57,2013,total_driving,NA
T147,T151,Luke Guthrie,27,220,127,93,2013,total_driving,NA
T150,T151,Ryo Ishikawa,23,221,62,159,2013,total_driving,NA
T150,153,Scott Gardiner,23,221,87,134,2013,total_driving,NA
152,T156,Scott Langley,27,222,152,70,2013,total_driving,NA
153,T154,Stewart Cink,22,223,73,150,2013,total_driving,NA
154,T156,Padraig Harrington,17,224,89,135,2013,total_driving,NA
155,158,John Merrick,23,226,122,104,2013,total_driving,NA
T156,T160,Marc Leishman,23,227,102,125,2013,total_driving,NA
T156,159,Greg Chalmers,25,227,165,62,2013,total_driving,NA
158,162,David Hearn,26,228,147,81,2013,total_driving,NA
159,163,Ben Crane,21,234,139,95,2013,total_driving,NA
160,165,Michael Thompson,22,236,148,88,2013,total_driving,NA
161,T166,Chris Stroud,26,237,164,73,2013,total_driving,NA
162,T166,Justin Bolli,23,238,149,89,2013,total_driving,NA
163,168,Matt Kuchar,23,240,116,124,2013,total_driving,NA
164,164,Phil Mickelson,21,242,93,149,2013,total_driving,NA
165,169,Sangmoon Bae,26,247,112,135,2013,total_driving,NA
166,170,Freddie Jacobson,19,252,97,155,2013,total_driving,NA
167,171,Robert Allenby,24,257,116,141,2013,total_driving,NA
168,172,Alistair Presnell,23,260,121,139,2013,total_driving,NA
169,173,Aaron Baddeley,24,265,86,179,2013,total_driving,NA
170,174,James Driscoll,23,266,100,166,2013,total_driving,NA
171,175,Michael Bradley,21,272,112,160,2013,total_driving,NA
172,176,Stephen Ames,19,274,141,133,2013,total_driving,NA
173,177,Jonas Blixt,24,275,123,152,2013,total_driving,NA
174,178,Ben Curtis,20,276,173,103,2013,total_driving,NA
T175,179,David Lynn,22,280,159,121,2013,total_driving,NA
T175,180,Lee Williams,22,280,168,112,2013,total_driving,NA
177,181,Johnson Wagner,24,283,155,128,2013,total_driving,NA
178,182,Tim Herron,15,299,124,175,2013,total_driving,NA
179,183,Casey Wittenberg,27,308,143,165,2013,total_driving,NA
180,184,Mike Weir,22,343,180,163,2013,total_driving,NA
1,1,Lucas Glover,26,74,20,54,2014,total_driving,NA
2,2,Henrik Stenson,15,78,64,14,2014,total_driving,NA
3,3,Hunter Mahan,25,81,45,36,2014,total_driving,NA
4,4,Hudson Swafford,26,82,33,49,2014,total_driving,NA
5,T5,Derek Ernst,28,83,38,45,2014,total_driving,NA
T6,T5,Kevin Chappell,28,84,43,41,2014,total_driving,NA
T6,7,Shawn Stefani,17,84,31,53,2014,total_driving,NA
8,8,Keegan Bradley,26,86,17,69,2014,total_driving,NA
9,9,Graham DeLaet,24,89,14,75,2014,total_driving,NA
10,10,Adam Scott,17,93,13,80,2014,total_driving,NA
11,11,Billy Horschel,27,99,76,23,2014,total_driving,NA
T12,T12,Jhonattan Vegas,23,101,8,93,2014,total_driving,NA
T12,T12,Nick Watney,25,101,45,56,2014,total_driving,NA
14,T12,Bubba Watson,21,103,1,102,2014,total_driving,NA
15,15,Boo Weekley,24,110,100,10,2014,total_driving,NA
16,T16,Rory McIlroy,17,111,3,108,2014,total_driving,NA
17,T16,Kevin Streelman,24,113,97,16,2014,total_driving,NA
18,20,Louis Oosthuizen,16,119,21,98,2014,total_driving,NA
19,21,Will Wilcox,16,121,36,85,2014,total_driving,NA
T20,T22,Ben Martin,26,122,75,47,2014,total_driving,NA
T20,T22,Kyle Stanley,28,122,33,89,2014,total_driving,NA
T22,T24,Brendon de Jonge,31,123,106,17,2014,total_driving,NA
T22,18,Russell Henley,29,123,61,62,2014,total_driving,NA
24,27,Kevin Stadler,26,125,76,49,2014,total_driving,NA
T25,T28,Martin Laird,20,126,37,89,2014,total_driving,NA
T25,T28,Jim Herman,21,126,52,74,2014,total_driving,NA
T27,19,Gary Woodland,25,128,9,119,2014,total_driving,NA
T27,T31,Justin Hicks,30,128,125,3,2014,total_driving,NA
T27,T33,J.J. Henry,28,128,82,46,2014,total_driving,NA
T27,T33,Will MacKenzie,27,128,84,44,2014,total_driving,NA
T31,T28,Sergio Garcia,16,130,57,73,2014,total_driving,NA
T31,T31,Hideki Matsuyama,24,130,51,79,2014,total_driving,NA
33,T37,Harris English,28,132,26,106,2014,total_driving,NA
T34,T41,Charlie Beljan,26,136,11,125,2014,total_driving,NA
T34,T35,Nicholas Thompson,30,136,114,22,2014,total_driving,NA
T36,T35,John Merrick,25,137,122,15,2014,total_driving,NA
T36,T41,Bill Haas,28,137,73,64,2014,total_driving,NA
T38,T37,Scott Brown,30,138,112,26,2014,total_driving,NA
T38,T37,Ryan Moore,24,138,129,9,2014,total_driving,NA
T38,T24,Martin Kaymer,19,138,50,88,2014,total_driving,NA
T38,T41,Russell Knox,26,138,120,18,2014,total_driving,NA
T42,T47,Rickie Fowler,26,141,33,108,2014,total_driving,NA
T42,T47,Robert Streb,21,141,25,116,2014,total_driving,NA
T44,44,Andrew Svoboda,24,142,111,31,2014,total_driving,NA
T44,T45,Chad Campbell,18,142,107,35,2014,total_driving,NA
46,T45,Bo Van Pelt,25,143,78,65,2014,total_driving,NA
47,50,Josh Teater,28,144,53,91,2014,total_driving,NA
48,52,Brendan Steele,26,145,28,117,2014,total_driving,NA
T49,T47,Chris Kirk,28,146,80,66,2014,total_driving,NA
T49,T37,John Senden,27,146,95,51,2014,total_driving,NA
51,51,Zach Johnson,26,147,141,6,2014,total_driving,NA
52,53,Dustin Johnson,17,148,2,146,2014,total_driving,NA
53,T24,Jason Day,15,149,18,131,2014,total_driving,NA
T54,T55,Charl Schwartzel,18,151,30,121,2014,total_driving,NA
T54,54,Ángel Cabrera,23,151,12,139,2014,total_driving,NA
56,57,Robert Garrigus,25,153,7,146,2014,total_driving,NA
T57,T55,Matt Kuchar,24,156,136,20,2014,total_driving,NA
T57,T61,Ryan Palmer,23,156,23,133,2014,total_driving,NA
T57,60,Brooks Koepka,16,156,6,150,2014,total_driving,NA
60,T58,John Peterson,25,157,102,55,2014,total_driving,NA
61,T64,Charley Hoffman,25,158,26,132,2014,total_driving,NA
T62,T61,Jim Furyk,21,159,155,4,2014,total_driving,NA
T62,T64,Michael Putnam,30,159,65,94,2014,total_driving,NA
T62,T61,John Huh,28,159,134,25,2014,total_driving,NA
T65,T66,Brad Fritsch,18,160,56,104,2014,total_driving,NA
T65,T58,Justin Rose,19,160,49,111,2014,total_driving,NA
67,T66,Wes Roach,22,161,65,96,2014,total_driving,NA
68,68,Lee Westwood,18,162,71,91,2014,total_driving,NA
69,T69,Michael Thompson,22,164,93,71,2014,total_driving,NA
70,T73,Davis Love III,22,165,41,124,2014,total_driving,NA
71,T71,Paul Casey,16,166,65,101,2014,total_driving,NA
T72,75,J.B. Holmes,24,168,4,164,2014,total_driving,NA
T72,T69,Webb Simpson,25,168,98,70,2014,total_driving,NA
T72,T71,Brian Stuard,29,168,137,31,2014,total_driving,NA
75,T73,Danny Lee,28,169,132,37,2014,total_driving,NA
T76,T78,Jason Kokrak,19,171,14,157,2014,total_driving,NA
T76,T76,Daniel Summerhays,27,171,141,30,2014,total_driving,NA
T76,T76,Heath Slocum,23,171,166,5,2014,total_driving,NA
T79,80,Marc Leishman,24,173,32,141,2014,total_driving,NA
T79,T78,"Ted Potter, Jr.",24,173,162,11,2014,total_driving,NA
T81,T92,Camilo Villegas,29,174,68,106,2014,total_driving,NA
T81,T81,David Toms,20,174,173,1,2014,total_driving,NA
T83,T81,Billy Hurley III,26,175,168,7,2014,total_driving,NA
T83,T83,David Hearn,28,175,156,19,2014,total_driving,NA
T85,T87,Chris Stroud,25,176,119,57,2014,total_driving,NA
T85,T87,Tim Clark,26,176,174,2,2014,total_driving,NA
T85,T90,Carl Pettersson,28,176,47,129,2014,total_driving,NA
T88,T83,Y.E. Yang,28,177,143,34,2014,total_driving,NA
T88,T83,Mark Wilson,25,177,153,24,2014,total_driving,NA
T88,T87,Matt Jones,25,177,41,136,2014,total_driving,NA
T88,T83,Graeme McDowell,17,177,165,12,2014,total_driving,NA
92,T92,Scott Stallings,28,178,23,155,2014,total_driving,NA
93,T90,Ken Duke,25,179,171,8,2014,total_driving,NA
94,T100,Jonathan Byrd,24,180,102,78,2014,total_driving,NA
T95,T96,Charles Howell III,29,181,9,172,2014,total_driving,NA
T95,T94,Jason Dufner,17,181,122,59,2014,total_driving,NA
T95,T94,Brandt Snedeker,25,181,121,60,2014,total_driving,NA
T95,T96,Andrew Loupe,22,181,4,177,2014,total_driving,NA
T99,T103,Kevin Tway,23,182,55,127,2014,total_driving,NA
T99,T100,Jamie Lovemark,20,182,16,166,2014,total_driving,NA
T99,T96,Stewart Cink,25,182,61,121,2014,total_driving,NA
T99,T96,Jeff Maggert,19,182,169,13,2014,total_driving,NA
T103,102,Brian Davis,28,184,163,21,2014,total_driving,NA
T103,105,Sangmoon Bae,24,184,98,86,2014,total_driving,NA
105,T103,Ben Crane,25,186,157,29,2014,total_driving,NA
T106,T106,Sean O'Hair,25,188,21,167,2014,total_driving,NA
T106,T106,George McNeill,24,188,117,71,2014,total_driving,NA
T108,T110,Ian Poulter,17,189,102,87,2014,total_driving,NA
T108,T113,Vijay Singh,25,189,89,100,2014,total_driving,NA
T108,T110,Steven Bowditch,30,189,29,160,2014,total_driving,NA
T111,T106,Spencer Levin,20,190,150,40,2014,total_driving,NA
T111,T116,Kevin Kisner,26,190,107,83,2014,total_driving,NA
T111,T113,Brendon Todd,29,190,148,42,2014,total_driving,NA
T111,T106,Jason Bohn,25,190,151,39,2014,total_driving,NA
T111,T110,James Hahn,27,190,91,99,2014,total_driving,NA
116,T116,Brian Harman,32,191,94,97,2014,total_driving,NA
117,T116,William McGirt,29,193,160,33,2014,total_driving,NA
118,119,Jerry Kelly,23,194,167,27,2014,total_driving,NA
119,T120,Jimmy Walker,27,195,19,176,2014,total_driving,NA
T120,T113,Kevin Na,27,196,148,48,2014,total_driving,NA
T120,124,Martin Flores,26,196,44,152,2014,total_driving,NA
T122,T120,Ben Curtis,24,197,154,43,2014,total_driving,NA
T122,T125,Roberto Castro,27,197,134,63,2014,total_driving,NA
T122,T120,Cameron Tringale,31,197,139,58,2014,total_driving,NA
T125,T127,D.A. Points,27,198,131,67,2014,total_driving,NA
T125,T125,D.H. Lee,20,198,170,28,2014,total_driving,NA
127,129,John Rollins,28,199,86,113,2014,total_driving,NA
128,T131,David Lingmerth,26,200,88,112,2014,total_driving,NA
T129,130,Seung-Yul Noh,27,201,40,161,2014,total_driving,NA
T129,T127,Tommy Gainey,26,201,59,142,2014,total_driving,NA
T131,T120,Geoff Ogilvy,26,202,68,134,2014,total_driving,NA
T131,T131,Richard Lee,27,202,125,77,2014,total_driving,NA
T133,134,Briny Baird,17,204,144,60,2014,total_driving,NA
T133,T131,K.J. Choi,23,204,152,52,2014,total_driving,NA
T135,135,Bud Cauley,19,207,63,144,2014,total_driving,NA
T135,136,Troy Merritt,20,207,124,83,2014,total_driving,NA
137,T137,Robert Allenby,29,208,127,81,2014,total_driving,NA
T138,T139,Phil Mickelson,21,210,70,140,2014,total_driving,NA
T138,T137,Trevor Immelman,28,210,74,136,2014,total_driving,NA
T138,143,Gonzalo Fernandez-Castaño,25,210,102,108,2014,total_driving,NA
T138,T139,Troy Matteson,23,210,39,171,2014,total_driving,NA
142,142,Morgan Hoffmann,32,213,48,165,2014,total_driving,NA
143,144,Justin Leonard,22,215,177,38,2014,total_driving,NA
144,T145,Andres Romero,26,216,53,163,2014,total_driving,NA
145,T145,Rory Sabbatini,26,217,58,159,2014,total_driving,NA
146,141,Jordan Spieth,27,218,89,129,2014,total_driving,NA
T147,149,Pat Perez,25,220,115,105,2014,total_driving,NA
T147,147,Brice Garnett,28,220,92,128,2014,total_driving,NA
149,148,Patrick Reed,28,229,71,158,2014,total_driving,NA
150,T150,Luke Donald,17,231,164,67,2014,total_driving,NA
151,T150,Chesson Hadley,29,232,84,148,2014,total_driving,NA
T152,154,Luke Guthrie,26,235,109,126,2014,total_driving,NA
T152,152,Aaron Baddeley,24,235,60,175,2014,total_driving,NA
154,155,Scott Langley,29,239,145,94,2014,total_driving,NA
155,T156,Bronson La'Cassie,18,241,127,114,2014,total_driving,NA
156,T156,Woody Austin,22,242,160,82,2014,total_driving,NA
157,158,Ricky Barnes,27,244,82,162,2014,total_driving,NA
158,161,Ernie Els,24,248,79,169,2014,total_driving,NA
159,162,Ryo Ishikawa,24,249,80,169,2014,total_driving,NA
160,T163,Brian Gay,26,251,175,76,2014,total_driving,NA
161,T163,Retief Goosen,26,252,96,156,2014,total_driving,NA
162,T165,Freddie Jacobson,27,253,130,123,2014,total_driving,NA
163,T165,Jim Renner,25,254,101,153,2014,total_driving,NA
T164,168,Jeff Overton,24,255,110,145,2014,total_driving,NA
T164,167,Tyrone Van Aswegen,25,255,87,168,2014,total_driving,NA
166,169,Tim Wilkinson,25,257,140,117,2014,total_driving,NA
T167,170,Stuart Appleby,29,262,159,103,2014,total_driving,NA
T167,171,Johnson Wagner,24,262,113,149,2014,total_driving,NA
169,172,Matt Every,26,267,116,151,2014,total_driving,NA
170,173,Jonas Blixt,21,271,117,154,2014,total_driving,NA
171,174,Erik Compton,28,276,138,138,2014,total_driving,NA
172,175,Bryce Molder,25,277,158,119,2014,total_driving,NA
173,176,Greg Chalmers,27,281,147,134,2014,total_driving,NA
174,178,Chad Collins,28,287,172,115,2014,total_driving,NA
175,177,Charlie Wi,25,289,146,143,2014,total_driving,NA
176,179,James Driscoll,25,306,132,174,2014,total_driving,NA
177,180,Mike Weir,25,349,176,173,2014,total_driving,NA
1,1,Henrik Stenson,16,55,43,12,2015,total_driving,NA
2,2,Will Wilcox,17,60,42,18,2015,total_driving,NA
3,3,Keegan Bradley,24,62,10,52,2015,total_driving,NA
4,4,Justin Rose,20,78,14,64,2015,total_driving,NA
5,5,Graham DeLaet,22,79,32,47,2015,total_driving,NA
6,6,Charlie Beljan,27,89,6,83,2015,total_driving,NA
7,7,Russell Henley,24,90,36,54,2015,total_driving,NA
8,10,Paul Casey,24,93,35,58,2015,total_driving,NA
9,T8,Jim Herman,27,95,62,33,2015,total_driving,NA
10,11,Hudson Swafford,30,103,29,74,2015,total_driving,NA
11,T12,Lucas Glover,26,104,38,66,2015,total_driving,NA
T12,T12,Derek Ernst,26,106,50,56,2015,total_driving,NA
T12,T8,Hideki Matsuyama,25,106,57,49,2015,total_driving,NA
14,14,Davis Love III,18,107,56,51,2015,total_driving,NA
15,15,Adam Scott,15,111,4,107,2015,total_driving,NA
T16,T16,Kevin Streelman,27,113,93,20,2015,total_driving,NA
T16,T16,Brendan Steele,24,113,16,97,2015,total_driving,NA
T18,20,Billy Horschel,28,122,53,69,2015,total_driving,NA
T18,T21,Daniel Berger,31,122,18,104,2015,total_driving,NA
T20,19,Webb Simpson,22,123,97,26,2015,total_driving,NA
T20,T21,Jason Gore,26,123,87,36,2015,total_driving,NA
T22,24,John Senden,24,126,89,37,2015,total_driving,NA
T22,18,Rickie Fowler,21,126,39,87,2015,total_driving,NA
24,23,Charl Schwartzel,19,127,24,103,2015,total_driving,NA
25,25,Chez Reavie,19,128,125,3,2015,total_driving,NA
26,T26,Sam Saunders,28,130,68,62,2015,total_driving,NA
T27,28,Kevin Chappell,26,132,67,65,2015,total_driving,NA
T27,T26,Shawn Stefani,26,132,44,88,2015,total_driving,NA
29,30,Alex Prugh,27,138,49,89,2015,total_driving,NA
30,31,David Lingmerth,28,139,93,46,2015,total_driving,NA
31,32,John Peterson,25,140,110,30,2015,total_driving,NA
32,33,Lee Westwood,15,144,25,119,2015,total_driving,NA
33,35,Nicholas Thompson,31,146,127,19,2015,total_driving,NA
T34,T36,Louis Oosthuizen,20,148,31,117,2015,total_driving,NA
T34,29,Kevin Kisner,30,148,114,34,2015,total_driving,NA
T34,T38,Sergio Garcia,15,148,25,123,2015,total_driving,NA
T34,T36,Jason Dufner,21,148,121,27,2015,total_driving,NA
38,40,Carlos Ortiz,30,150,33,117,2015,total_driving,NA
T39,41,Sean O'Hair,26,151,47,104,2015,total_driving,NA
T39,42,Boo Weekley,24,151,76,75,2015,total_driving,NA
41,T44,Justin Thomas,30,152,15,137,2015,total_driving,NA
42,43,Brooks Koepka,23,153,8,145,2015,total_driving,NA
43,T49,Francesco Molinari,16,154,153,1,2015,total_driving,NA
T44,34,Bill Haas,25,155,82,73,2015,total_driving,NA
T44,T44,Bubba Watson,19,155,2,153,2015,total_driving,NA
T44,T49,Spencer Levin,31,155,139,16,2015,total_driving,NA
T44,T44,John Merrick,27,155,133,22,2015,total_driving,NA
T44,51,Patrick Rodgers,17,155,9,146,2015,total_driving,NA
T49,52,Adam Hadwin,30,156,108,48,2015,total_driving,NA
T49,T44,Zach Johnson,25,156,148,8,2015,total_driving,NA
51,T53,Martin Laird,24,157,22,135,2015,total_driving,NA
52,T44,Jordan Spieth,25,158,78,80,2015,total_driving,NA
T53,T60,Robert Streb,30,159,36,123,2015,total_driving,NA
T53,T53,Nick Watney,28,159,61,98,2015,total_driving,NA
T53,T55,Ryan Moore,24,159,148,11,2015,total_driving,NA
56,T57,Ben Martin,27,160,110,50,2015,total_driving,NA
57,T60,Jonathan Byrd,22,162,117,45,2015,total_driving,NA
T58,66,Ryan Palmer,22,164,13,151,2015,total_driving,NA
T58,T60,Russell Knox,28,164,136,28,2015,total_driving,NA
T60,63,Matt Jones,25,165,46,119,2015,total_driving,NA
T60,T57,Jason Day,20,165,3,162,2015,total_driving,NA
T62,T73,Dustin Johnson,21,166,1,165,2015,total_driving,NA
T62,T67,Jason Kokrak,28,166,11,155,2015,total_driving,NA
T62,64,James Hahn,28,166,50,116,2015,total_driving,NA
65,T67,Jamie Donaldson,16,167,54,113,2015,total_driving,NA
T66,T67,Jim Furyk,19,168,151,17,2015,total_driving,NA
T66,T70,Johnson Wagner,23,168,82,86,2015,total_driving,NA
T66,T70,Brian Harman,29,168,113,55,2015,total_driving,NA
T69,T57,Scott Piercy,28,169,41,128,2015,total_driving,NA
T69,T55,Harris English,29,169,33,136,2015,total_driving,NA
T71,T78,Robert Garrigus,25,170,20,150,2015,total_driving,NA
T71,72,Charley Hoffman,28,170,29,141,2015,total_driving,NA
T71,T76,Gary Woodland,24,170,12,158,2015,total_driving,NA
74,75,Chad Campbell,30,172,131,41,2015,total_driving,NA
T75,T78,Steven Alker,22,173,167,6,2015,total_driving,NA
T75,T76,Cameron Tringale,28,173,152,21,2015,total_driving,NA
T75,82,Blayne Barber,26,173,103,70,2015,total_driving,NA
T78,T80,John Huh,31,174,160,14,2015,total_driving,NA
T78,T80,Brendon de Jonge,31,174,130,44,2015,total_driving,NA
80,83,Jason Bohn,27,176,171,5,2015,total_driving,NA
81,T84,Pat Perez,26,178,135,43,2015,total_driving,NA
T82,87,Jerry Kelly,24,179,170,9,2015,total_driving,NA
T82,T88,Tony Finau,31,179,7,172,2015,total_driving,NA
T84,T90,Colt Knost,29,180,173,7,2015,total_driving,NA
T84,T84,J.B. Holmes,25,180,5,175,2015,total_driving,NA
T84,T73,Matt Kuchar,25,180,104,76,2015,total_driving,NA
T87,T93,Hunter Mahan,24,181,50,131,2015,total_driving,NA
T87,T88,Sung Joon Park,27,181,139,42,2015,total_driving,NA
T89,T95,Phil Mickelson,19,183,22,161,2015,total_driving,NA
T89,T90,Greg Owen,19,183,62,121,2015,total_driving,NA
T89,T90,J.J. Henry,30,183,72,111,2015,total_driving,NA
T89,T93,William McGirt,30,183,158,25,2015,total_driving,NA
T93,T101,Brendon Todd,27,186,176,10,2015,total_driving,NA
T93,T95,Oscar Fraustro,21,186,93,93,2015,total_driving,NA
T93,T98,Bill Lunde,18,186,115,71,2015,total_driving,NA
T93,T98,Geoff Ogilvy,15,186,64,122,2015,total_driving,NA
T93,T101,David Toms,21,186,184,2,2015,total_driving,NA
T93,T101,Justin Leonard,22,186,182,4,2015,total_driving,NA
T93,T95,George McNeill,27,186,126,60,2015,total_driving,NA
T93,T98,Steve Wheatcroft,28,186,107,79,2015,total_driving,NA
T101,T105,Jhonattan Vegas,27,187,27,160,2015,total_driving,NA
T101,111,Martin Flores,30,187,39,148,2015,total_driving,NA
T103,T105,Brian Stuard,31,189,174,15,2015,total_driving,NA
T103,104,Scott Pinckney,27,189,88,101,2015,total_driving,NA
T105,T107,Roger Sloan,20,190,65,125,2015,total_driving,NA
T105,T107,Scott Brown,30,190,108,82,2015,total_driving,NA
T105,T107,Heath Slocum,22,190,177,13,2015,total_driving,NA
T108,113,Ángel Cabrera,19,191,28,163,2015,total_driving,NA
T108,T107,Ken Duke,30,191,168,23,2015,total_driving,NA
110,112,Ian Poulter,19,193,121,72,2015,total_driving,NA
111,114,Steven Bowditch,32,194,18,176,2015,total_driving,NA
T112,T115,Charles Howell III,30,196,17,179,2015,total_driving,NA
T112,T115,Michael Putnam,28,196,101,95,2015,total_driving,NA
114,126,Andres Gonzales,28,197,57,140,2015,total_driving,NA
115,T115,Gonzalo Fernandez-Castaño,28,198,98,100,2015,total_driving,NA
T116,T115,Bo Van Pelt,28,199,93,106,2015,total_driving,NA
T116,120,Cameron Percy,23,199,90,109,2015,total_driving,NA
T116,119,Vijay Singh,23,199,85,114,2015,total_driving,NA
T119,121,Rory Sabbatini,25,200,90,110,2015,total_driving,NA
T119,T122,Roberto Castro,16,200,160,40,2015,total_driving,NA
121,T122,Jimmy Walker,24,201,21,180,2015,total_driving,NA
T122,T128,Chris Stroud,28,203,146,57,2015,total_driving,NA
T122,T128,Mark Hubbard,25,203,165,38,2015,total_driving,NA
T122,T128,Zac Blair,34,203,180,23,2015,total_driving,NA
T125,T122,Brandt Snedeker,27,204,105,99,2015,total_driving,NA
T125,131,Bryce Molder,26,204,169,35,2015,total_driving,NA
127,132,Kyle Reifers,31,206,112,94,2015,total_driving,NA
T128,T122,Sangmoon Bae,30,207,92,115,2015,total_driving,NA
T128,133,Brian Davis,31,207,178,29,2015,total_driving,NA
T130,127,Danny Lee,36,208,145,63,2015,total_driving,NA
T130,134,Tom Hoge,26,208,74,134,2015,total_driving,NA
T132,T138,Stewart Cink,23,209,65,144,2015,total_driving,NA
T132,135,Alex Cejka,30,209,141,68,2015,total_driving,NA
T134,T136,Carl Pettersson,32,211,81,130,2015,total_driving,NA
T134,T138,Jon Curran,28,211,179,32,2015,total_driving,NA
136,T136,Troy Merritt,29,212,131,81,2015,total_driving,NA
137,T141,Max Homa,27,213,59,154,2015,total_driving,NA
T138,T141,David Hearn,30,214,156,58,2015,total_driving,NA
T138,T144,Ben Crane,22,214,183,31,2015,total_driving,NA
T140,T141,Mark Wilson,28,215,162,53,2015,total_driving,NA
T140,140,Brice Garnett,29,215,119,96,2015,total_driving,NA
T140,T144,Morgan Hoffmann,26,215,45,170,2015,total_driving,NA
143,147,Byron Smith,21,216,77,139,2015,total_driving,NA
144,146,Chris Kirk,21,218,128,90,2015,total_driving,NA
T145,149,Scott Stallings,19,220,78,142,2015,total_driving,NA
T145,148,Billy Hurley III,28,220,181,39,2015,total_driving,NA
T147,150,Marc Leishman,23,222,55,167,2015,total_driving,NA
T147,T151,Retief Goosen,25,222,71,151,2015,total_driving,NA
T149,T151,Robert Allenby,25,225,147,78,2015,total_driving,NA
T149,T153,Andres Romero,24,225,47,178,2015,total_driving,NA
151,T153,Jonas Blixt,26,228,116,112,2015,total_driving,NA
T152,155,Daniel Summerhays,29,229,137,92,2015,total_driving,NA
T152,156,Ernie Els,18,229,80,149,2015,total_driving,NA
T152,T157,Chesson Hadley,30,229,82,147,2015,total_driving,NA
155,T159,Nick Taylor,28,231,72,159,2015,total_driving,NA
T156,T157,Chad Collins,24,232,166,66,2015,total_driving,NA
T156,161,Erik Compton,28,232,105,127,2015,total_driving,NA
T158,162,K.J. Choi,19,235,174,61,2015,total_driving,NA
T158,163,Michael Thompson,27,235,98,137,2015,total_driving,NA
T160,168,Seung-Yul Noh,21,239,70,169,2015,total_driving,NA
T160,T166,Greg Chalmers,17,239,154,85,2015,total_driving,NA
T162,T166,Tim Wilkinson,28,240,163,77,2015,total_driving,NA
T162,T159,Patrick Reed,27,240,69,171,2015,total_driving,NA
164,169,Kevin Na,27,243,159,84,2015,total_driving,NA
165,T170,Aaron Baddeley,25,244,60,184,2015,total_driving,NA
166,T170,Andrew Svoboda,30,245,119,126,2015,total_driving,NA
167,172,Fabián Gómez,26,246,144,102,2015,total_driving,NA
168,174,Camilo Villegas,27,247,74,173,2015,total_driving,NA
169,173,Scott Langley,28,248,157,91,2015,total_driving,NA
170,176,Ryo Ishikawa,28,256,100,156,2015,total_driving,NA
171,175,Whee Kim,23,258,150,108,2015,total_driving,NA
172,177,Jeff Overton,30,266,134,132,2015,total_driving,NA
173,178,Padraig Harrington,21,267,86,181,2015,total_driving,NA
174,179,Luke Guthrie,27,271,138,133,2015,total_driving,NA
175,181,Derek Fathauer,27,283,101,182,2015,total_driving,NA
T176,182,Jim Renner,27,284,141,143,2015,total_driving,NA
T176,180,Jonathan Randolph,25,284,118,166,2015,total_driving,NA
178,183,Eric Axley,21,288,124,164,2015,total_driving,NA
179,184,Luke Donald,20,301,172,129,2015,total_driving,NA
T180,T185,Matt Every,26,306,123,183,2015,total_driving,NA
T180,T185,Tyrone Van Aswegen,20,306,129,177,2015,total_driving,NA
182,188,D.A. Points,26,312,155,157,2015,total_driving,NA
183,189,Ricky Barnes,27,315,141,174,2015,total_driving,NA
184,190,Andrew Putnam,23,332,164,168,2015,total_driving,NA
1,1,Keegan Bradley,26,64,27,37,2016,total_driving,NA
2,2,Lucas Glover,23,75,35,40,2016,total_driving,NA
3,3,Hudson Swafford,30,81,7,74,2016,total_driving,NA
4,T5,Emiliano Grillo,25,84,67,17,2016,total_driving,NA
5,T5,Andrew Landry,18,85,59,26,2016,total_driving,NA
6,4,Rory McIlroy,18,86,9,77,2016,total_driving,NA
7,8,Paul Casey,22,90,54,36,2016,total_driving,NA
8,7,Thomas Aiken,23,91,89,2,2016,total_driving,NA
9,9,Sergio Garcia,15,98,28,70,2016,total_driving,NA
10,T10,Scott Pinckney,29,99,43,56,2016,total_driving,NA
11,12,Boo Weekley,26,100,84,16,2016,total_driving,NA
12,T10,Shane Lowry,17,101,32,69,2016,total_driving,NA
13,13,Russell Henley,25,103,48,55,2016,total_driving,NA
14,14,Jim Herman,29,112,87,25,2016,total_driving,NA
15,15,Brendan Steele,25,114,20,94,2016,total_driving,NA
16,T17,Scott Brown,27,123,76,47,2016,total_driving,NA
17,20,Jason Kokrak,28,125,6,119,2016,total_driving,NA
T18,19,Harold Varner III,28,126,22,104,2016,total_driving,NA
T18,16,Si Woo Kim,34,126,69,57,2016,total_driving,NA
20,22,Jason Dufner,28,128,70,58,2016,total_driving,NA
T21,T24,Sean O'Hair,27,132,20,112,2016,total_driving,NA
T21,23,Brett Stegmaier,29,132,52,80,2016,total_driving,NA
T21,T17,Hideki Matsuyama,23,132,65,67,2016,total_driving,NA
T21,T24,Graham DeLaet,21,132,37,95,2016,total_driving,NA
T25,26,Chez Reavie,27,133,123,10,2016,total_driving,NA
T25,21,Kevin Chappell,27,133,46,87,2016,total_driving,NA
T27,30,Rickie Fowler,23,136,23,113,2016,total_driving,NA
T27,29,Brooks Koepka,21,136,19,117,2016,total_driving,NA
29,T27,Wes Roach,21,137,59,78,2016,total_driving,NA
T30,T38,Kevin Kisner,27,138,105,33,2016,total_driving,NA
T30,31,Scott Piercy,24,138,37,101,2016,total_driving,NA
32,32,Louis Oosthuizen,17,139,68,71,2016,total_driving,NA
T33,T33,Ryan Palmer,23,140,12,128,2016,total_driving,NA
T33,T27,Dustin Johnson,22,140,2,138,2016,total_driving,NA
35,T35,Adam Hadwin,27,141,92,49,2016,total_driving,NA
36,37,Justin Rose,18,143,16,127,2016,total_driving,NA
37,40,Kevin Streelman,26,144,104,40,2016,total_driving,NA
T38,T38,Marc Leishman,25,145,55,90,2016,total_driving,NA
T38,T42,Russell Knox,25,145,137,8,2016,total_driving,NA
T40,T42,Brian Harman,31,146,95,51,2016,total_driving,NA
T40,T42,Jamie Lovemark,27,146,11,135,2016,total_driving,NA
T40,41,Greg Owen,29,146,39,107,2016,total_driving,NA
43,T35,William McGirt,28,149,118,31,2016,total_driving,NA
44,45,Kyle Stanley,28,150,112,38,2016,total_driving,NA
45,46,Jason Gore,27,151,103,48,2016,total_driving,NA
46,T51,Kyle Reifers,34,153,123,30,2016,total_driving,NA
T47,47,Gary Woodland,26,154,10,144,2016,total_driving,NA
T47,T48,John Huh,28,154,145,9,2016,total_driving,NA
T49,T48,Roberto Castro,27,155,149,6,2016,total_driving,NA
T49,T51,Geoff Ogilvy,22,155,80,75,2016,total_driving,NA
T49,T51,Chad Campbell,28,155,116,39,2016,total_driving,NA
52,T51,Billy Horschel,20,156,72,84,2016,total_driving,NA
T53,57,Blayne Barber,27,157,97,60,2016,total_driving,NA
T53,T55,Patrick Rodgers,28,157,26,131,2016,total_driving,NA
T55,T55,Derek Ernst,20,159,63,96,2016,total_driving,NA
T55,T58,David Lingmerth,24,159,144,15,2016,total_driving,NA
T55,T58,Bill Haas,24,159,97,62,2016,total_driving,NA
58,62,Matt Kuchar,26,161,137,24,2016,total_driving,NA
T59,T60,Stewart Cink,19,162,42,120,2016,total_driving,NA
T59,T60,Rod Pampling,18,162,117,45,2016,total_driving,NA
T59,T48,Jhonattan Vegas,27,162,14,148,2016,total_driving,NA
T62,T63,Henrik Norlander,21,164,112,52,2016,total_driving,NA
T62,T63,Bubba Watson,19,164,4,160,2016,total_driving,NA
64,T65,Adam Scott,20,166,13,153,2016,total_driving,NA
65,T65,Jim Furyk,14,167,160,7,2016,total_driving,NA
T66,T65,Ryan Moore,23,168,150,18,2016,total_driving,NA
T66,68,Whee Kim,27,168,118,50,2016,total_driving,NA
T68,T69,Spencer Levin,32,169,157,12,2016,total_driving,NA
T68,T69,Graeme McDowell,21,169,156,13,2016,total_driving,NA
70,73,James Hahn,26,172,88,84,2016,total_driving,NA
T71,74,Michael Thompson,23,174,85,89,2016,total_driving,NA
T71,T75,Danny Lee,28,174,130,44,2016,total_driving,NA
T71,T75,Scott Langley,22,174,139,35,2016,total_driving,NA
T71,T75,Ben Martin,28,174,108,66,2016,total_driving,NA
T71,72,Jordan Spieth,21,174,51,123,2016,total_driving,NA
76,T78,Francesco Molinari,18,175,129,46,2016,total_driving,NA
77,T78,Will Wilcox,23,176,73,103,2016,total_driving,NA
T78,T81,Jerry Kelly,23,177,174,3,2016,total_driving,NA
T78,T85,Alex Cejka,22,177,155,22,2016,total_driving,NA
T78,T81,Johnson Wagner,26,177,101,76,2016,total_driving,NA
T81,T85,Fabián Gómez,26,178,105,73,2016,total_driving,NA
T81,T81,Tony Finau,28,178,3,175,2016,total_driving,NA
T83,T85,Sam Saunders,24,179,81,98,2016,total_driving,NA
T83,T81,Sung Kang,29,179,77,102,2016,total_driving,NA
T83,T89,David Hearn,29,179,158,21,2016,total_driving,NA
T86,88,J.B. Holmes,22,180,1,179,2016,total_driving,NA
T86,T89,Brian Stuard,20,180,176,4,2016,total_driving,NA
T86,T78,Daniel Berger,26,180,34,146,2016,total_driving,NA
89,91,Rory Sabbatini,20,182,118,64,2016,total_driving,NA
90,92,Nick Taylor,26,184,47,137,2016,total_driving,NA
T91,T93,Padraig Harrington,16,185,97,88,2016,total_driving,NA
T91,T96,Colt Knost,26,185,184,1,2016,total_driving,NA
T91,T93,Kelly Kraft,20,185,93,92,2016,total_driving,NA
T91,T98,Zac Blair,31,185,180,5,2016,total_driving,NA
T95,T69,Charl Schwartzel,19,186,44,142,2016,total_driving,NA
T95,T96,Robert Garrigus,21,186,18,168,2016,total_driving,NA
T97,T93,Ángel Cabrera,22,187,63,124,2016,total_driving,NA
T97,T98,Luke List,27,187,7,180,2016,total_driving,NA
T99,101,Brandt Snedeker,27,188,75,113,2016,total_driving,NA
T99,100,Matt Jones,27,188,56,132,2016,total_driving,NA
101,102,Andrew Loupe,27,189,5,184,2016,total_driving,NA
102,T110,Scott Stallings,27,190,50,140,2016,total_driving,NA
T103,T106,Martin Laird,24,191,33,158,2016,total_driving,NA
T103,T103,Charles Howell III,25,191,17,174,2016,total_driving,NA
T103,T106,Harris English,27,191,29,162,2016,total_driving,NA
T103,T103,Justin Thomas,28,191,24,167,2016,total_driving,NA
T107,T103,Patrick Reed,28,192,41,151,2016,total_driving,NA
T107,T106,Robert Streb,27,192,59,133,2016,total_driving,NA
T107,T106,Chesson Hadley,27,192,45,147,2016,total_driving,NA
T107,T110,John Senden,28,192,95,97,2016,total_driving,NA
111,112,Jason Bohn,21,193,179,14,2016,total_driving,NA
T112,T116,Hunter Mahan,22,195,56,139,2016,total_driving,NA
T112,T114,David Toms,19,195,184,11,2016,total_driving,NA
T112,113,Morgan Hoffmann,25,195,66,129,2016,total_driving,NA
T115,T118,Dicky Pride,21,196,173,23,2016,total_driving,NA
T115,T116,Jason Day,20,196,15,181,2016,total_driving,NA
T117,T118,Steve Marino,24,197,79,118,2016,total_driving,NA
T117,T118,Webb Simpson,20,197,132,65,2016,total_driving,NA
T119,T121,Shawn Stefani,29,198,78,120,2016,total_driving,NA
T119,124,Mark Hubbard,30,198,164,34,2016,total_driving,NA
T121,T121,Vaughn Taylor,24,199,127,72,2016,total_driving,NA
T121,T126,Zach Johnson,24,199,167,32,2016,total_driving,NA
T121,T114,Kevin Na,26,199,170,29,2016,total_driving,NA
T124,T126,K.J. Choi,22,200,180,20,2016,total_driving,NA
T124,T121,Charley Hoffman,26,200,36,164,2016,total_driving,NA
T126,128,Mark Wilson,21,201,182,19,2016,total_driving,NA
T126,125,Smylie Kaufman,28,201,30,171,2016,total_driving,NA
T128,129,Carlos Ortiz,29,204,31,173,2016,total_driving,NA
T128,T131,Billy Hurley III,20,204,176,28,2016,total_driving,NA
T128,130,Chris Kirk,28,204,136,68,2016,total_driving,NA
131,T131,Abraham Ancer,19,205,178,27,2016,total_driving,NA
132,T133,Branden Grace,18,206,48,158,2016,total_driving,NA
T133,T133,Troy Merritt,26,207,126,81,2016,total_driving,NA
T133,T133,Bronson Burgoon,27,207,71,136,2016,total_driving,NA
T133,T133,Ken Duke,20,207,164,43,2016,total_driving,NA
T133,T133,Jimmy Walker,25,207,24,183,2016,total_driving,NA
137,T138,Stuart Appleby,23,215,152,63,2016,total_driving,NA
T138,T140,Ben Crane,27,216,162,54,2016,total_driving,NA
T138,T138,Rhein Gibson,20,216,40,176,2016,total_driving,NA
140,142,Chris Stroud,27,218,132,86,2016,total_driving,NA
141,T140,Phil Mickelson,22,219,56,163,2016,total_driving,NA
142,143,Jonas Blixt,26,220,90,130,2016,total_driving,NA
T143,T144,Will MacKenzie,26,223,140,83,2016,total_driving,NA
T143,T146,Bryce Molder,26,223,164,59,2016,total_driving,NA
145,T144,Andres Gonzales,28,224,59,165,2016,total_driving,NA
T146,T146,George McNeill,23,225,147,78,2016,total_driving,NA
T146,148,Jon Curran,30,225,183,42,2016,total_driving,NA
148,T149,J.J. Henry,24,227,123,104,2016,total_driving,NA
T149,T152,Steve Stricker,15,228,175,53,2016,total_driving,NA
T149,T149,Steve Wheatcroft,26,228,135,93,2016,total_driving,NA
151,T152,Daniel Summerhays,28,229,114,115,2016,total_driving,NA
152,T154,Hiroshi Iwata,29,230,108,122,2016,total_driving,NA
153,T154,Brendon de Jonge,30,231,122,109,2016,total_driving,NA
T154,T156,Tim Wilkinson,22,232,171,61,2016,total_driving,NA
T154,159,Dawie van der Walt,25,232,91,141,2016,total_driving,NA
T154,T156,Anirban Lahiri,21,232,82,150,2016,total_driving,NA
157,T156,Seung-Yul Noh,28,234,52,182,2016,total_driving,NA
158,T161,Vijay Singh,22,236,93,143,2016,total_driving,NA
159,160,Aaron Baddeley,28,237,82,155,2016,total_driving,NA
160,T161,Cameron Smith,24,240,132,108,2016,total_driving,NA
T161,163,Cameron Tringale,25,241,142,99,2016,total_driving,NA
T161,164,Martin Piller,22,241,130,111,2016,total_driving,NA
T163,T165,Patton Kizzire,27,243,86,157,2016,total_driving,NA
T163,T165,D.H. Lee,22,243,161,82,2016,total_driving,NA
165,T165,Ernie Els,21,244,74,170,2016,total_driving,NA
166,168,Jeff Overton,25,249,143,106,2016,total_driving,NA
167,T169,Tom Hoge,26,252,100,152,2016,total_driving,NA
168,T169,D.A. Points,18,253,153,100,2016,total_driving,NA
169,172,Luke Guthrie,19,256,102,154,2016,total_driving,NA
170,171,Retief Goosen,16,257,108,149,2016,total_driving,NA
171,173,Peter Malnati,32,260,169,91,2016,total_driving,NA
172,174,Michael Kim,29,264,148,116,2016,total_driving,NA
173,175,Tyler Aldridge,28,267,141,126,2016,total_driving,NA
174,176,Freddie Jacobson,26,272,162,110,2016,total_driving,NA
175,177,Ricky Barnes,29,284,118,166,2016,total_driving,NA
176,178,Tyrone Van Aswegen,31,285,114,171,2016,total_driving,NA
177,179,Derek Fathauer,30,289,111,178,2016,total_driving,NA
T178,181,Brendon Todd,29,292,167,125,2016,total_driving,NA
T178,180,Steven Bowditch,26,292,107,185,2016,total_driving,NA
180,182,Luke Donald,23,295,151,144,2016,total_driving,NA
181,183,Camilo Villegas,27,304,127,177,2016,total_driving,NA
182,184,Chad Collins,26,305,171,134,2016,total_driving,NA
T183,185,Erik Compton,24,314,145,169,2016,total_driving,NA
T183,186,Rob Oppenheim,21,314,158,156,2016,total_driving,NA
185,187,Robert Allenby,23,315,154,161,2016,total_driving,NA
1,1,Keegan Bradley,29,69,44,25,2017,total_driving,NA
2,2,Kyle Stanley,29,79,66,13,2017,total_driving,NA
3,5,Graham DeLaet,25,89,34,55,2017,total_driving,NA
4,4,Lucas Glover,26,90,50,40,2017,total_driving,NA
5,3,Rickie Fowler,21,93,41,52,2017,total_driving,NA
6,T6,Rick Lamb,19,98,54,44,2017,total_driving,NA
7,T6,Martin Laird,25,99,62,37,2017,total_driving,NA
8,8,Shane Lowry,16,100,67,33,2017,total_driving,NA
9,9,Francesco Molinari,21,104,98,6,2017,total_driving,NA
10,T12,Sergio Garcia,17,105,30,75,2017,total_driving,NA
T11,T12,Paul Casey,24,107,58,49,2017,total_driving,NA
T11,10,Jim Herman,25,107,96,11,2017,total_driving,NA
13,14,Brendan Steele,25,109,40,69,2017,total_driving,NA
T14,15,Kevin Streelman,26,114,84,30,2017,total_driving,NA
T14,11,Russell Henley,27,114,54,60,2017,total_driving,NA
16,T16,Hudson Swafford,28,116,22,94,2017,total_driving,NA
17,18,Boo Weekley,27,119,116,3,2017,total_driving,NA
18,T16,Gary Woodland,26,128,13,115,2017,total_driving,NA
19,T21,Patrick Cantlay,13,129,48,81,2017,total_driving,NA
20,20,Emiliano Grillo,25,130,91,39,2017,total_driving,NA
21,T21,Jason Kokrak,28,131,17,114,2017,total_driving,NA
T22,19,Jason Dufner,24,132,78,54,2017,total_driving,NA
T22,T21,Bubba Watson,22,132,20,112,2017,total_driving,NA
24,T21,Sam Saunders,24,133,88,45,2017,total_driving,NA
25,26,Xander Schauffele,28,134,16,118,2017,total_driving,NA
T26,T27,Harold Varner III,31,139,29,110,2017,total_driving,NA
T26,25,Kevin Kisner,28,139,120,19,2017,total_driving,NA
28,T27,Jon Rahm,23,140,20,120,2017,total_driving,NA
T29,T30,Richy Werenski,26,141,109,32,2017,total_driving,NA
T29,T30,Billy Horschel,28,141,43,98,2017,total_driving,NA
T31,T27,Kevin Chappell,27,142,23,119,2017,total_driving,NA
T31,T30,Hunter Mahan,26,142,79,63,2017,total_driving,NA
33,34,Dustin Johnson,20,145,2,143,2017,total_driving,NA
T34,T35,Tony Finau,29,146,10,136,2017,total_driving,NA
T34,T35,Russell Knox,24,146,126,20,2017,total_driving,NA
T36,33,Hideki Matsuyama,22,147,26,121,2017,total_driving,NA
T36,T38,Ryan Moore,24,147,130,17,2017,total_driving,NA
T36,T35,Sean O'Hair,25,147,58,89,2017,total_driving,NA
T39,T38,Robert Garrigus,26,148,37,111,2017,total_driving,NA
T39,T38,Rory Sabbatini,23,148,105,43,2017,total_driving,NA
41,41,J.J. Spaun,29,149,107,42,2017,total_driving,NA
42,T42,Louis Oosthuizen,18,152,69,83,2017,total_driving,NA
T43,T44,Chez Reavie,28,153,149,4,2017,total_driving,NA
T43,T42,James Hahn,28,153,86,67,2017,total_driving,NA
T43,T44,Julián Etulain,22,153,89,64,2017,total_driving,NA
T46,T46,William McGirt,28,156,149,7,2017,total_driving,NA
T46,T46,J.J. Henry,29,156,83,73,2017,total_driving,NA
T48,T48,Tag Ridings,20,159,32,127,2017,total_driving,NA
T48,T48,Ryan Palmer,20,159,27,132,2017,total_driving,NA
T48,T48,Adam Scott,16,159,15,144,2017,total_driving,NA
T48,T53,Ben Martin,27,159,103,56,2017,total_driving,NA
52,T65,Justin Rose,18,160,35,125,2017,total_driving,NA
T53,T53,Jamie Lovemark,28,161,24,137,2017,total_driving,NA
T53,T56,Luke List,31,161,4,157,2017,total_driving,NA
T53,T48,Brooks Koepka,24,161,7,154,2017,total_driving,NA
T56,T58,Daniel Berger,26,162,62,100,2017,total_driving,NA
T56,T58,Rory McIlroy,14,162,1,161,2017,total_driving,NA
T56,T56,Zach Johnson,23,162,140,22,2017,total_driving,NA
T59,60,Anirban Lahiri,22,164,61,103,2017,total_driving,NA
T59,61,Grayson Murray,30,164,12,152,2017,total_driving,NA
61,T48,Jhonattan Vegas,29,166,33,133,2017,total_driving,NA
T62,T63,Matt Jones,20,168,28,140,2017,total_driving,NA
T62,62,Bud Cauley,28,168,72,96,2017,total_driving,NA
T64,T67,David Lingmerth,23,169,113,56,2017,total_driving,NA
T64,T63,Bryson DeChambeau,31,169,45,124,2017,total_driving,NA
T66,T74,Justin Thomas,25,170,8,162,2017,total_driving,NA
T66,T67,Chad Campbell,29,170,147,23,2017,total_driving,NA
T66,T67,Webb Simpson,28,170,142,28,2017,total_driving,NA
T66,T70,Brett Stegmaier,27,170,124,46,2017,total_driving,NA
70,T65,Charley Hoffman,31,171,49,122,2017,total_driving,NA
71,T70,Adam Hadwin,28,173,108,65,2017,total_driving,NA
72,T76,Scott Brown,29,174,121,53,2017,total_driving,NA
T73,T74,Sung Kang,32,175,67,108,2017,total_driving,NA
T73,73,Shawn Stefani,26,175,84,91,2017,total_driving,NA
T73,80,Vaughn Taylor,26,175,161,14,2017,total_driving,NA
T76,T76,Chris Stroud,22,176,141,35,2017,total_driving,NA
T76,T76,Jordan Spieth,23,176,75,101,2017,total_driving,NA
T76,T76,Trey Mullinax,28,176,9,167,2017,total_driving,NA
79,T82,Ryan Armour,20,177,176,1,2017,total_driving,NA
T80,T82,Scott Piercy,22,179,72,107,2017,total_driving,NA
T80,72,Marc Leishman,25,179,50,129,2017,total_driving,NA
T80,T86,Matt Kuchar,26,179,148,31,2017,total_driving,NA
T80,81,Morgan Hoffmann,29,179,86,93,2017,total_driving,NA
T80,85,Jonathan Randolph,22,179,132,47,2017,total_driving,NA
85,84,Byeong Hun An,22,180,41,139,2017,total_driving,NA
86,T86,Graeme McDowell,17,181,173,8,2017,total_driving,NA
T87,T89,C.T. Pan,29,182,134,48,2017,total_driving,NA
T87,T86,Danny Lee,32,182,111,71,2017,total_driving,NA
89,T89,Brandon Hagy,26,183,3,180,2017,total_driving,NA
T90,93,Nick Taylor,29,184,105,79,2017,total_driving,NA
T90,T94,Steve Wheatcroft,17,184,169,15,2017,total_driving,NA
92,92,Rafa Cabrera Bello,19,185,103,82,2017,total_driving,NA
T93,T94,Brian Harman,30,186,116,70,2017,total_driving,NA
T93,T97,John Huh,28,186,136,50,2017,total_driving,NA
95,T94,Kyle Reifers,32,187,146,41,2017,total_driving,NA
T96,T99,Ryan Brehm,25,188,4,184,2017,total_driving,NA
T96,T99,Alex Cejka,28,188,164,24,2017,total_driving,NA
T96,T89,Pat Perez,26,188,112,76,2017,total_driving,NA
T99,T103,Miguel Angel Carballo,22,189,128,61,2017,total_driving,NA
T99,107,Kevin Tway,27,189,10,179,2017,total_driving,NA
T99,T97,Smylie Kaufman,26,189,25,164,2017,total_driving,NA
T99,T103,Blayne Barber,25,189,109,80,2017,total_driving,NA
T103,T99,Mackenzie Hughes,31,190,81,109,2017,total_driving,NA
T103,T99,J.T. Poston,28,190,77,113,2017,total_driving,NA
T103,T109,Chris Kirk,28,190,139,51,2017,total_driving,NA
T106,T103,Jason Day,20,191,19,172,2017,total_driving,NA
T106,108,Nick Watney,23,191,35,156,2017,total_driving,NA
T106,T103,Cameron Percy,23,191,96,95,2017,total_driving,NA
T109,T109,K.J. Choi,25,192,163,29,2017,total_driving,NA
T109,T111,Jim Furyk,18,192,190,2,2017,total_driving,NA
T109,T111,Daniel Summerhays,29,192,136,56,2017,total_driving,NA
T112,T114,David Hearn,29,193,167,26,2017,total_driving,NA
T112,T117,Spencer Levin,31,193,175,18,2017,total_driving,NA
T114,T117,Brian Stuard,31,194,189,5,2017,total_driving,NA
T114,T111,Johnson Wagner,26,194,128,66,2017,total_driving,NA
T114,120,Ben Crane,26,194,178,16,2017,total_driving,NA
T114,T114,Patrick Rodgers,27,194,18,176,2017,total_driving,NA
118,T117,Andrew Loupe,21,195,6,189,2017,total_driving,NA
T119,T114,Brian Campbell,20,196,70,126,2017,total_driving,NA
T119,T121,Roberto Castro,25,196,169,27,2017,total_driving,NA
T121,T123,Søren Kjeldsen,17,197,187,10,2017,total_driving,NA
T121,T123,Zac Blair,32,197,188,9,2017,total_driving,NA
T123,T127,Ken Duke,26,198,186,12,2017,total_driving,NA
T123,T121,Scott Stallings,27,198,57,141,2017,total_driving,NA
125,T123,Troy Merritt,28,199,114,85,2017,total_driving,NA
126,126,Kelly Kraft,27,200,101,99,2017,total_driving,NA
T127,T127,J.B. Holmes,23,201,14,187,2017,total_driving,NA
T127,129,Andres Gonzales,24,201,46,155,2017,total_driving,NA
129,130,Steven Alker,23,204,183,21,2017,total_driving,NA
T130,132,Tim Wilkinson,22,209,173,36,2017,total_driving,NA
T130,131,Bill Haas,25,209,92,117,2017,total_driving,NA
132,133,Patrick Reed,29,213,75,138,2017,total_driving,NA
T133,T135,D.A. Points,22,214,180,34,2017,total_driving,NA
T133,T135,Geoff Ogilvy,25,214,142,72,2017,total_driving,NA
135,T137,Brian Gay,25,215,177,38,2017,total_driving,NA
T136,T137,Martin Flores,27,216,39,177,2017,total_driving,NA
T136,134,Robert Streb,30,216,81,135,2017,total_driving,NA
T136,139,Harris English,27,216,30,186,2017,total_driving,NA
T139,T140,Jonas Blixt,25,218,122,96,2017,total_driving,NA
T139,T140,Rod Pampling,22,218,131,87,2017,total_driving,NA
T139,143,Charl Schwartzel,18,218,47,171,2017,total_driving,NA
142,T140,Jimmy Walker,21,219,74,145,2017,total_driving,NA
143,146,Ollie Schniederjans,28,222,37,185,2017,total_driving,NA
144,145,Branden Grace,20,223,100,123,2017,total_driving,NA
T145,T147,Stewart Cink,26,225,65,160,2017,total_driving,NA
T145,T147,Cody Gribble,28,225,60,165,2017,total_driving,NA
T145,T150,Michael Kim,28,225,119,106,2017,total_driving,NA
T148,T147,Dominic Bozzelli,24,226,80,146,2017,total_driving,NA
T148,T152,Seamus Power,25,226,53,173,2017,total_driving,NA
T150,T150,Seung-Yul Noh,31,227,52,175,2017,total_driving,NA
T150,155,Brandt Snedeker,15,227,165,62,2017,total_driving,NA
T152,T152,Fabián Gómez,21,228,151,77,2017,total_driving,NA
T152,T152,Charles Howell III,23,228,62,166,2017,total_driving,NA
154,156,Peter Malnati,29,230,162,68,2017,total_driving,NA
155,T157,Michael Thompson,21,232,154,78,2017,total_driving,NA
T156,T157,Retief Goosen,19,233,102,131,2017,total_driving,NA
T156,T159,Ian Poulter,20,233,159,74,2017,total_driving,NA
T156,T159,Brett Drewitt,19,233,145,88,2017,total_driving,NA
159,161,Sebastián Muñoz,17,238,70,168,2017,total_driving,NA
160,162,Tyrone Van Aswegen,32,239,134,105,2017,total_driving,NA
161,T167,Jason Bohn,28,241,185,56,2017,total_driving,NA
T162,T163,Kevin Na,26,242,158,84,2017,total_driving,NA
T162,T163,Ryan Blaum,29,242,156,86,2017,total_driving,NA
164,T163,Cameron Smith,26,243,94,149,2017,total_driving,NA
165,T167,Matt Every,30,244,56,188,2017,total_driving,NA
166,169,Phil Mickelson,22,251,89,162,2017,total_driving,NA
167,170,Mark Hubbard,27,252,160,92,2017,total_driving,NA
168,172,Mark Anderson,20,259,157,102,2017,total_driving,NA
169,173,Si Woo Kim,30,260,118,142,2017,total_driving,NA
170,174,Patton Kizzire,28,270,92,178,2017,total_driving,NA
T171,T176,Billy Hurley III,25,273,183,90,2017,total_driving,NA
T171,175,Gonzalo Fernandez-Castaño,22,273,99,174,2017,total_driving,NA
173,T176,Whee Kim,27,274,115,159,2017,total_driving,NA
T174,T176,Aaron Baddeley,20,275,94,181,2017,total_driving,NA
T174,179,Brad Fritsch,18,275,127,148,2017,total_driving,NA
176,180,Chad Collins,26,281,166,115,2017,total_driving,NA
177,T181,Greg Chalmers,28,285,181,104,2017,total_driving,NA
178,T181,Nicholas Lindheim,21,287,136,151,2017,total_driving,NA
179,183,Camilo Villegas,25,293,124,169,2017,total_driving,NA
180,184,Cameron Tringale,28,296,168,128,2017,total_driving,NA
181,185,Derek Fathauer,27,300,142,158,2017,total_driving,NA
182,T186,Wesley Bryan,28,302,172,130,2017,total_driving,NA
183,T186,Tom Hoge,17,304,151,153,2017,total_driving,NA
T184,189,Ryo Ishikawa,20,305,122,183,2017,total_driving,NA
T184,188,Ernie Els,20,305,155,150,2017,total_driving,NA
186,190,Bryce Molder,26,316,182,134,2017,total_driving,NA
T187,192,Ricky Barnes,31,323,153,170,2017,total_driving,NA
T187,191,Steven Bowditch,27,323,133,190,2017,total_driving,NA
189,193,Luke Donald,18,325,178,147,2017,total_driving,NA
190,194,Carl Pettersson,27,353,171,182,2017,total_driving,NA
1,1,Justin Rose,18,67,34,33,2018,total_driving,NA
2,3,Tommy Fleetwood,19,72,23,49,2018,total_driving,NA
3,4,Gary Woodland,27,73,7,66,2018,total_driving,NA
4,2,Keegan Bradley,27,80,65,15,2018,total_driving,NA
T5,5,Hudson Swafford,22,98,41,57,2018,total_driving,NA
T5,8,Francesco Molinari,20,98,52,46,2018,total_driving,NA
7,6,Bronson Burgoon,24,99,41,58,2018,total_driving,NA
8,12,Rickie Fowler,20,101,61,40,2018,total_driving,NA
9,T9,Kyle Stanley,26,105,98,7,2018,total_driving,NA
T10,T9,Paul Casey,20,109,31,78,2018,total_driving,NA
T10,11,Sam Ryder,26,109,87,22,2018,total_driving,NA
12,T30,Louis Oosthuizen,17,112,61,51,2018,total_driving,NA
13,7,Aaron Wise,29,113,40,73,2018,total_driving,NA
T14,T15,J.J. Spaun,27,114,82,32,2018,total_driving,NA
T14,T19,Emiliano Grillo,25,114,106,8,2018,total_driving,NA
16,T13,Corey Conners,28,115,36,79,2018,total_driving,NA
T17,T13,Bryson DeChambeau,26,117,25,92,2018,total_driving,NA
T17,17,Xinjun Zhang,28,117,77,40,2018,total_driving,NA
T17,18,Billy Horschel,27,117,100,17,2018,total_driving,NA
T17,T15,Adam Scott,21,117,29,88,2018,total_driving,NA
21,T19,Kevin Chappell,23,118,17,101,2018,total_driving,NA
22,21,Kevin Streelman,27,119,107,12,2018,total_driving,NA
23,T25,Brendan Steele,22,121,12,109,2018,total_driving,NA
24,24,Rafa Cabrera Bello,20,123,107,16,2018,total_driving,NA
25,23,Joel Dahmen,28,126,97,29,2018,total_driving,NA
26,T27,Scott Piercy,26,128,92,36,2018,total_driving,NA
27,T27,Lucas Glover,18,129,85,44,2018,total_driving,NA
28,T42,Dustin Johnson,20,131,6,125,2018,total_driving,NA
29,T42,Hideki Matsuyama,21,132,49,83,2018,total_driving,NA
30,T40,Russell Henley,23,134,125,9,2018,total_driving,NA
31,T30,Byeong Hun An,24,135,19,116,2018,total_driving,NA
T32,T25,Hunter Mahan,21,136,90,46,2018,total_driving,NA
T32,22,Patrick Cantlay,23,136,38,98,2018,total_driving,NA
T34,T27,Patrick Rodgers,30,137,34,103,2018,total_driving,NA
T34,T34,Tyler Duncan,31,137,112,25,2018,total_driving,NA
36,T34,C.T. Pan,30,139,126,13,2018,total_driving,NA
37,T42,Henrik Stenson,16,140,139,1,2018,total_driving,NA
T38,T34,Charles Howell III,28,141,54,87,2018,total_driving,NA
T38,T45,Daniel Berger,23,141,85,56,2018,total_driving,NA
40,T30,James Hahn,26,142,77,65,2018,total_driving,NA
T41,T37,Branden Grace,18,145,74,71,2018,total_driving,NA
T41,47,Keith Mitchell,29,145,10,135,2018,total_driving,NA
T41,T37,Jon Rahm,20,145,16,129,2018,total_driving,NA
44,T63,Ian Poulter,20,146,118,28,2018,total_driving,NA
T45,T45,Martin Laird,22,147,71,76,2018,total_driving,NA
T45,T37,Michael Thompson,19,147,93,54,2018,total_driving,NA
T47,T52,Justin Thomas,23,149,11,138,2018,total_driving,NA
T47,51,Harold Varner III,27,149,18,131,2018,total_driving,NA
49,48,Brice Garnett,30,150,91,59,2018,total_driving,NA
50,T30,Bubba Watson,24,151,9,142,2018,total_driving,NA
T51,T90,Kiradech Aphibarnrat,14,152,110,42,2018,total_driving,NA
T51,50,Xander Schauffele,27,152,28,124,2018,total_driving,NA
T53,T52,Austin Cook,29,154,130,24,2018,total_driving,NA
T53,T66,Brian Harman,25,154,133,21,2018,total_driving,NA
T55,T40,Jason Day,20,155,14,141,2018,total_driving,NA
T55,60,Russell Knox,27,155,137,18,2018,total_driving,NA
T55,49,J.T. Poston,22,155,55,100,2018,total_driving,NA
58,T61,Matt Jones,23,156,30,126,2018,total_driving,NA
T59,T54,Ryan Palmer,22,157,27,130,2018,total_driving,NA
T59,T61,Shane Lowry,19,157,55,102,2018,total_driving,NA
T59,68,Satoshi Kodaira,18,157,118,39,2018,total_driving,NA
62,T56,Jason Kokrak,29,158,15,143,2018,total_driving,NA
T63,T56,Sam Saunders,26,159,41,118,2018,total_driving,NA
T63,T70,Tiger Woods,18,159,32,127,2018,total_driving,NA
65,T63,Jordan Spieth,23,160,61,99,2018,total_driving,NA
66,T95,Jason Dufner,22,162,88,74,2018,total_driving,NA
T67,T63,Sean O'Hair,22,163,44,119,2018,total_driving,NA
T67,T56,Blayne Barber,22,163,110,53,2018,total_driving,NA
T67,T54,Brooks Koepka,17,163,8,155,2018,total_driving,NA
70,T56,Rory McIlroy,18,164,1,163,2018,total_driving,NA
71,T66,Abraham Ancer,30,165,96,69,2018,total_driving,NA
T72,T87,Alex Noren,18,166,69,97,2018,total_driving,NA
T72,T70,J.J. Henry,28,166,135,31,2018,total_driving,NA
T74,69,Cameron Percy,16,167,99,68,2018,total_driving,NA
T74,73,Ryan Moore,22,167,163,4,2018,total_driving,NA
T74,T70,Beau Hossler,28,167,58,109,2018,total_driving,NA
T77,74,Adam Schenk,28,171,26,145,2018,total_driving,NA
T77,T82,Graeme McDowell,20,171,121,50,2018,total_driving,NA
T79,T93,Tyrrell Hatton,16,172,76,96,2018,total_driving,NA
T79,T75,Denny McCarthy,22,172,100,72,2018,total_driving,NA
81,T79,J.B. Holmes,24,174,24,150,2018,total_driving,NA
T82,85,Chez Reavie,28,176,173,3,2018,total_driving,NA
T82,T98,Jhonattan Vegas,27,176,32,144,2018,total_driving,NA
T82,T82,Kevin Kisner,25,176,146,30,2018,total_driving,NA
T82,T79,Conrad Shindler,20,176,141,35,2018,total_driving,NA
T86,T77,Trey Mullinax,24,177,2,175,2018,total_driving,NA
T86,T82,Steve Wheatcroft,20,177,166,11,2018,total_driving,NA
T88,86,Robert Garrigus,27,178,19,159,2018,total_driving,NA
T88,T87,Tony Finau,28,178,4,174,2018,total_driving,NA
T90,T77,Chesson Hadley,30,179,58,121,2018,total_driving,NA
T90,T79,Harris English,31,179,47,132,2018,total_driving,NA
T90,T75,Richy Werenski,32,179,135,44,2018,total_driving,NA
T93,T90,Troy Merritt,27,181,100,81,2018,total_driving,NA
T93,89,Nick Watney,26,181,21,160,2018,total_driving,NA
95,T90,Tom Lovelady,28,183,3,180,2018,total_driving,NA
96,T93,Grayson Murray,22,184,22,162,2018,total_driving,NA
97,T98,Ethan Tracy,23,186,71,115,2018,total_driving,NA
T98,T95,Luke List,29,187,5,182,2018,total_driving,NA
T98,T101,Pat Perez,23,187,144,43,2018,total_driving,NA
T98,T101,Ryan Armour,32,187,185,2,2018,total_driving,NA
T101,103,Jamie Lovemark,26,190,37,153,2018,total_driving,NA
T101,T95,Fabián Gómez,28,190,142,48,2018,total_driving,NA
T101,100,Ben Silverman,28,190,152,38,2018,total_driving,NA
104,T104,Brian Gay,30,192,186,6,2018,total_driving,NA
105,T104,David Lingmerth,26,194,180,14,2018,total_driving,NA
T106,T104,Adam Hadwin,25,196,159,37,2018,total_driving,NA
T106,T107,Vaughn Taylor,25,196,176,20,2018,total_driving,NA
T108,T117,Marc Leishman,25,197,80,117,2018,total_driving,NA
T108,T107,Matt Atkins,21,197,50,147,2018,total_driving,NA
110,T111,Brian Stuard,32,198,193,5,2018,total_driving,NA
111,T109,Alex Cejka,24,199,172,27,2018,total_driving,NA
112,T113,Jim Furyk,15,200,190,10,2018,total_driving,NA
T113,116,"Ted Potter, Jr.",28,201,178,23,2018,total_driving,NA
T113,T111,Kelly Kraft,31,201,167,34,2018,total_driving,NA
T115,T113,Stephan Jaeger,26,203,69,134,2018,total_driving,NA
T115,T113,Kevin Tway,31,203,13,190,2018,total_driving,NA
T117,T120,Bud Cauley,17,206,100,106,2018,total_driving,NA
T117,123,Brandt Snedeker,25,206,122,84,2018,total_driving,NA
T119,T127,Charley Hoffman,25,207,67,140,2018,total_driving,NA
T119,119,Ben Crane,21,207,188,19,2018,total_driving,NA
T119,122,Webb Simpson,26,207,117,90,2018,total_driving,NA
T122,T117,Chris Kirk,29,209,154,55,2018,total_driving,NA
T122,T120,David Hearn,21,209,183,26,2018,total_driving,NA
124,142,Lanto Griffin,26,215,46,169,2018,total_driving,NA
T125,125,Seamus Power,28,216,45,171,2018,total_driving,NA
T125,124,Brandon Harkins,30,216,38,178,2018,total_driving,NA
127,T136,Zach Johnson,25,217,154,63,2018,total_driving,NA
T128,T109,Kevin Na,26,219,157,62,2018,total_driving,NA
T128,126,Cody Gribble,25,219,52,167,2018,total_driving,NA
130,138,Scott Stallings,30,221,64,157,2018,total_driving,NA
131,T132,Talor Gooch,27,222,74,148,2018,total_driving,NA
T132,T129,Nate Lashley,17,223,115,108,2018,total_driving,NA
T132,T129,Scott Brown,32,223,128,95,2018,total_driving,NA
T132,T129,Shawn Stefani,25,223,65,158,2018,total_driving,NA
T135,T134,Andrew Landry,27,224,142,82,2018,total_driving,NA
T135,T134,Rory Sabbatini,27,224,130,94,2018,total_driving,NA
T137,T127,Chad Campbell,28,225,173,52,2018,total_driving,NA
T137,T132,Ryan Blaum,28,225,165,60,2018,total_driving,NA
139,T139,Ben Martin,20,227,157,70,2018,total_driving,NA
T140,T143,Andrew Putnam,28,229,116,113,2018,total_driving,NA
T140,T139,Stewart Cink,25,229,83,146,2018,total_driving,NA
T140,T139,Tom Hoge,31,229,140,89,2018,total_driving,NA
T143,T146,Mackenzie Hughes,28,231,109,122,2018,total_driving,NA
T143,T143,Nick Taylor,30,231,126,105,2018,total_driving,NA
T145,T136,Cameron Smith,24,232,81,151,2018,total_driving,NA
T145,145,Nicholas Lindheim,26,232,120,112,2018,total_driving,NA
147,T146,Anirban Lahiri,24,233,114,119,2018,total_driving,NA
T148,T146,Danny Lee,30,234,148,86,2018,total_driving,NA
T148,T146,Martin Flores,29,234,58,176,2018,total_driving,NA
T148,T146,John Huh,29,234,170,64,2018,total_driving,NA
T148,T146,Rod Pampling,20,234,168,66,2018,total_driving,NA
T152,T152,Jonas Blixt,23,236,122,114,2018,total_driving,NA
T152,154,Peter Uihlein,26,236,48,188,2018,total_driving,NA
154,T152,Johnson Wagner,21,237,176,61,2018,total_driving,NA
155,157,Charl Schwartzel,20,238,67,171,2018,total_driving,NA
156,158,Brett Stegmaier,21,239,100,139,2018,total_driving,NA
157,T155,Ollie Schniederjans,27,241,50,191,2018,total_driving,NA
158,160,Patton Kizzire,29,242,77,165,2018,total_driving,NA
159,T165,Bill Haas,25,243,94,149,2018,total_driving,NA
160,161,Matt Kuchar,24,244,169,75,2018,total_driving,NA
161,159,Chris Stroud,27,245,154,91,2018,total_driving,NA
162,162,Phil Mickelson,24,246,57,189,2018,total_driving,NA
T163,163,Roberto Díaz,25,252,175,77,2018,total_driving,NA
T163,164,Jonathan Randolph,25,252,159,93,2018,total_driving,NA
T165,T165,Dominic Bozzelli,20,253,89,164,2018,total_driving,NA
T165,167,Si Woo Kim,31,253,146,107,2018,total_driving,NA
T167,T155,Patrick Reed,26,256,83,173,2018,total_driving,NA
T167,170,Jimmy Walker,23,256,71,185,2018,total_driving,NA
169,168,Kyle Thompson,22,260,181,79,2018,total_driving,NA
170,169,Retief Goosen,20,264,94,170,2018,total_driving,NA
171,171,Martin Piller,28,269,132,137,2018,total_driving,NA
172,T172,Jonathan Byrd,24,272,137,135,2018,total_driving,NA
173,T172,Zac Blair,20,277,192,85,2018,total_driving,NA
174,174,Sung Kang,29,278,122,156,2018,total_driving,NA
175,176,Matt Every,30,279,113,166,2018,total_driving,NA
176,175,Whee Kim,30,283,179,104,2018,total_driving,NA
177,178,William McGirt,26,284,161,123,2018,total_driving,NA
178,179,Aaron Baddeley,27,291,105,186,2018,total_driving,NA
T179,180,D.A. Points,25,298,189,109,2018,total_driving,NA
T179,181,Peter Malnati,28,298,144,154,2018,total_driving,NA
181,182,Tyrone Van Aswegen,31,303,151,152,2018,total_driving,NA
182,T183,Robert Streb,29,311,128,183,2018,total_driving,NA
T183,T183,Billy Hurley III,27,312,184,128,2018,total_driving,NA
T183,185,Zecheng Dou,23,312,133,179,2018,total_driving,NA
185,186,Greg Chalmers,20,320,187,133,2018,total_driving,NA
186,187,Michael Kim,27,330,153,177,2018,total_driving,NA
187,188,Andrew Yun,22,332,148,184,2018,total_driving,NA
188,189,Ricky Barnes,22,341,148,193,2018,total_driving,NA
189,190,Rob Oppenheim,26,343,182,161,2018,total_driving,NA
190,191,Derek Fathauer,28,350,164,186,2018,total_driving,NA
191,192,Daniel Summerhays,19,351,170,181,2018,total_driving,NA
192,193,Cameron Tringale,26,353,161,192,2018,total_driving,NA
193,194,Wesley Bryan,23,359,191,168,2018,total_driving,NA
1,1,Brendan Steele,22,56,34,22,2019,total_driving,NA
2,2,Gary Woodland,24,92,13,79,2019,total_driving,NA
3,3,Paul Casey,22,95,62,33,2019,total_driving,NA
4,4,Sepp Straka,25,96,22,74,2019,total_driving,NA
5,5,Alex Prugh,26,98,27,71,2019,total_driving,NA
6,7,Bryson DeChambeau,21,100,34,66,2019,total_driving,NA
7,8,Daniel Berger,20,103,44,59,2019,total_driving,NA
8,13,Rory McIlroy,19,106,2,104,2019,total_driving,NA
9,9,Jason Kokrak,24,107,17,90,2019,total_driving,NA
10,14,Corey Conners,28,108,66,42,2019,total_driving,NA
11,T11,Keegan Bradley,25,111,61,50,2019,total_driving,NA
T12,T11,Emiliano Grillo,23,112,85,27,2019,total_driving,NA
T12,10,Brooks Koepka,21,112,10,102,2019,total_driving,NA
14,15,Abraham Ancer,27,113,103,10,2019,total_driving,NA
15,6,Jon Rahm,20,115,20,95,2019,total_driving,NA
16,17,Louis Oosthuizen,19,118,77,41,2019,total_driving,NA
17,16,Charles Howell III,27,120,32,88,2019,total_driving,NA
18,19,Bronson Burgoon,20,126,79,47,2019,total_driving,NA
19,23,Austin Cook,23,129,120,9,2019,total_driving,NA
T20,18,Lucas Glover,26,130,79,51,2019,total_driving,NA
T20,T21,Joel Dahmen,29,130,106,24,2019,total_driving,NA
22,T21,Tommy Fleetwood,18,132,59,73,2019,total_driving,NA
23,24,Kramer Hickok,26,137,120,17,2019,total_driving,NA
T24,T25,Aaron Wise,21,140,33,107,2019,total_driving,NA
T24,T25,Alex Noren,18,140,43,97,2019,total_driving,NA
T26,T31,Scott Piercy,24,141,106,35,2019,total_driving,NA
T26,T27,Martin Laird,26,141,57,84,2019,total_driving,NA
T26,T27,Sungjae Im,35,141,81,60,2019,total_driving,NA
T29,T31,Kevin Streelman,26,142,114,28,2019,total_driving,NA
T29,T31,Carlos Ortiz,28,142,44,98,2019,total_driving,NA
31,T27,Hunter Mahan,21,143,85,58,2019,total_driving,NA
32,30,Jason Day,21,144,38,106,2019,total_driving,NA
33,20,Hideki Matsuyama,24,145,31,114,2019,total_driving,NA
34,T35,Wes Roach,21,147,93,54,2019,total_driving,NA
T35,T37,Chase Wright,26,149,56,93,2019,total_driving,NA
T35,T37,Joaquin Niemann,28,149,41,108,2019,total_driving,NA
37,T39,Fabián Gómez,20,150,125,25,2019,total_driving,NA
T38,T42,Adam Hadwin,24,151,119,32,2019,total_driving,NA
T38,T35,Xander Schauffele,21,151,24,127,2019,total_driving,NA
T40,T39,Hank Lebioda,23,152,95,57,2019,total_driving,NA
T40,34,Rickie Fowler,20,152,30,122,2019,total_driving,NA
T40,T39,Troy Merritt,21,152,103,49,2019,total_driving,NA
43,46,Keith Mitchell,26,153,28,125,2019,total_driving,NA
44,44,Harris English,28,155,44,111,2019,total_driving,NA
T45,45,Tyrrell Hatton,17,157,72,85,2019,total_driving,NA
T45,T42,Justin Rose,17,157,28,129,2019,total_driving,NA
T47,T47,Jhonattan Vegas,23,158,12,146,2019,total_driving,NA
T47,T47,Adam Long,27,158,112,46,2019,total_driving,NA
T49,T49,Chez Reavie,28,159,158,1,2019,total_driving,NA
T49,T49,Bubba Watson,19,159,6,153,2019,total_driving,NA
T51,T54,Jason Dufner,25,160,129,31,2019,total_driving,NA
T51,51,Kyle Stanley,25,160,141,19,2019,total_driving,NA
T53,T52,Brice Garnett,28,161,154,7,2019,total_driving,NA
T53,T52,Jim Herman,21,161,149,12,2019,total_driving,NA
55,T54,Adam Schenk,31,162,47,115,2019,total_driving,NA
T56,T58,Tyler Duncan,29,164,150,14,2019,total_driving,NA
T56,57,Cameron Davis,25,164,10,154,2019,total_driving,NA
T56,T54,Dylan Frittelli,24,164,73,91,2019,total_driving,NA
T59,T58,Michael Thompson,22,165,147,18,2019,total_driving,NA
T59,T58,Andrew Landry,25,165,159,6,2019,total_driving,NA
61,T65,Sung Kang,27,166,48,118,2019,total_driving,NA
62,T63,Russell Henley,25,168,152,16,2019,total_driving,NA
63,T63,Seth Reeves,25,169,7,162,2019,total_driving,NA
T64,T67,Byeong Hun An,22,170,15,155,2019,total_driving,NA
T64,T65,Justin Thomas,20,170,37,133,2019,total_driving,NA
66,T67,Sam Ryder,23,171,96,75,2019,total_driving,NA
T67,T67,Harold Varner III,26,172,38,134,2019,total_driving,NA
T67,T71,Brian Harman,29,172,147,25,2019,total_driving,NA
69,61,Matt Kuchar,22,173,135,38,2019,total_driving,NA
T70,76,Kevin Kisner,25,175,160,15,2019,total_driving,NA
T70,T71,Wyndham Clark,27,175,5,170,2019,total_driving,NA
T72,T74,Cameron Champ,26,176,1,175,2019,total_driving,NA
T72,T74,Tony Finau,25,176,9,167,2019,total_driving,NA
T74,77,Dustin Johnson,19,178,4,174,2019,total_driving,NA
T74,T81,Rory Sabbatini,26,178,136,42,2019,total_driving,NA
T74,T78,Sam Burns,26,178,14,164,2019,total_driving,NA
T74,T78,Denny McCarthy,28,178,122,56,2019,total_driving,NA
78,80,Ryan Moore,22,179,177,2,2019,total_driving,NA
T79,T88,Ryan Palmer,21,180,60,120,2019,total_driving,NA
T79,T81,Henrik Stenson,15,180,175,5,2019,total_driving,NA
T81,T81,Sergio Garcia,15,181,34,147,2019,total_driving,NA
T81,70,Patrick Cantlay,21,181,21,160,2019,total_driving,NA
T83,T81,Shawn Stefani,25,182,81,101,2019,total_driving,NA
T83,T88,Bud Cauley,25,182,102,80,2019,total_driving,NA
T83,T86,Nick Watney,26,182,40,142,2019,total_driving,NA
T83,T81,Billy Horschel,26,182,114,68,2019,total_driving,NA
87,T95,Roberto Díaz,23,184,154,30,2019,total_driving,NA
T88,T90,Sangmoon Bae,22,185,73,112,2019,total_driving,NA
T88,T92,Luke List,22,185,3,182,2019,total_driving,NA
T88,T92,J.B. Holmes,25,185,16,169,2019,total_driving,NA
T88,T92,J.T. Poston,29,185,98,87,2019,total_driving,NA
T88,T95,Ben Silverman,24,185,156,29,2019,total_driving,NA
93,T90,Roger Sloan,27,186,84,102,2019,total_driving,NA
94,97,Kiradech Aphibarnrat,20,187,106,81,2019,total_driving,NA
95,98,Ryan Armour,28,188,184,4,2019,total_driving,NA
T96,T99,Jim Furyk,21,189,186,3,2019,total_driving,NA
T96,73,Adam Scott,18,189,54,135,2019,total_driving,NA
T96,T86,Webb Simpson,21,189,145,44,2019,total_driving,NA
T96,T99,Brandon Harkins,28,189,23,166,2019,total_driving,NA
T100,T99,Josh Teater,24,190,112,78,2019,total_driving,NA
T100,T99,Joey Garber,22,190,96,94,2019,total_driving,NA
102,T105,Francesco Molinari,15,191,143,48,2019,total_driving,NA
T103,T105,Matt Jones,27,192,93,99,2019,total_driving,NA
T103,T105,Trey Mullinax,25,192,8,184,2019,total_driving,NA
T103,T105,Si Woo Kim,28,192,106,86,2019,total_driving,NA
T106,T109,Kyle Jones,26,193,170,23,2019,total_driving,NA
T106,T109,Adam Svensson,25,193,130,63,2019,total_driving,NA
T106,T109,Ian Poulter,18,193,117,76,2019,total_driving,NA
T106,T109,Brian Stuard,29,193,185,8,2019,total_driving,NA
T110,T113,Russell Knox,22,194,139,55,2019,total_driving,NA
T110,117,Cameron Tringale,21,194,70,124,2019,total_driving,NA
T110,T113,Vaughn Taylor,27,194,174,20,2019,total_driving,NA
T110,T113,David Hearn,18,194,181,13,2019,total_driving,NA
T110,T113,Sebastián Muñoz,26,194,58,136,2019,total_driving,NA
115,T118,Nate Lashley,21,196,132,64,2019,total_driving,NA
116,T118,Beau Hossler,27,197,53,144,2019,total_driving,NA
T117,120,Brian Gay,28,198,187,11,2019,total_driving,NA
T117,121,Zach Johnson,19,198,153,45,2019,total_driving,NA
T119,T122,Chesson Hadley,26,200,63,137,2019,total_driving,NA
T119,T124,J.J. Spaun,26,200,123,77,2019,total_driving,NA
T121,T122,Kevin Tway,26,201,25,176,2019,total_driving,NA
T121,T124,Rafa Cabrera Bello,19,201,132,69,2019,total_driving,NA
T123,126,John Chin,21,202,50,152,2019,total_driving,NA
T123,103,Patrick Reed,25,202,71,131,2019,total_driving,NA
125,127,Matthew Fitzpatrick,14,203,151,52,2019,total_driving,NA
T126,T132,Dominic Bozzelli,24,204,76,128,2019,total_driving,NA
T126,129,Kevin Na,19,204,132,72,2019,total_driving,NA
T126,128,Phil Mickelson,20,204,19,185,2019,total_driving,NA
129,T130,Ollie Schniederjans,28,205,17,188,2019,total_driving,NA
T130,T132,Jonas Blixt,26,206,136,70,2019,total_driving,NA
T130,T130,Scott Brown,27,206,145,61,2019,total_driving,NA
T132,T132,Danny Lee,27,207,42,165,2019,total_driving,NA
T132,T136,Roberto Castro,22,207,171,36,2019,total_driving,NA
T132,T132,J.J. Henry,22,207,142,65,2019,total_driving,NA
135,T136,Max Homa,25,208,49,159,2019,total_driving,NA
136,T136,Scott Langley,27,209,188,21,2019,total_driving,NA
T137,T139,Satoshi Kodaira,22,210,176,34,2019,total_driving,NA
T137,T145,Patton Kizzire,25,210,91,119,2019,total_driving,NA
T137,T141,Brady Schnell,21,210,173,37,2019,total_driving,NA
140,T139,Martin Trainer,25,211,25,186,2019,total_driving,NA
141,147,Johnson Wagner,19,212,172,40,2019,total_driving,NA
T142,T141,Talor Gooch,17,213,65,148,2019,total_driving,NA
T142,T145,Patrick Rodgers,18,213,52,161,2019,total_driving,NA
144,T141,Scott Stallings,26,214,69,145,2019,total_driving,NA
145,148,Kyoung-Hoon Lee,30,216,163,53,2019,total_driving,NA
146,149,Richy Werenski,27,217,101,116,2019,total_driving,NA
147,T141,Marc Leishman,21,218,78,140,2019,total_driving,NA
148,T150,Sam Saunders,26,219,51,168,2019,total_driving,NA
149,T150,Nick Taylor,28,220,111,109,2019,total_driving,NA
T150,153,Alex Cejka,22,222,183,39,2019,total_driving,NA
T150,152,Mackenzie Hughes,25,222,67,155,2019,total_driving,NA
152,154,Pat Perez,21,226,164,62,2019,total_driving,NA
T153,T156,Jimmy Walker,22,228,55,173,2019,total_driving,NA
T153,T156,Tom Hoge,32,228,123,105,2019,total_driving,NA
155,158,Bill Haas,23,230,117,113,2019,total_driving,NA
156,159,Cameron Smith,23,233,92,141,2019,total_driving,NA
T157,T161,Ryan Blaum,28,234,139,95,2019,total_driving,NA
T157,160,C.T. Pan,25,234,167,67,2019,total_driving,NA
T159,T163,Kelly Kraft,31,235,125,110,2019,total_driving,NA
T159,T163,Anders Albertson,25,235,105,130,2019,total_driving,NA
161,T163,Danny Willett,19,236,98,138,2019,total_driving,NA
T162,166,Brandt Snedeker,27,237,156,81,2019,total_driving,NA
T162,T161,Charley Hoffman,24,237,87,150,2019,total_driving,NA
164,167,Stephan Jaeger,26,239,100,139,2019,total_driving,NA
165,T168,Hudson Swafford,20,246,88,158,2019,total_driving,NA
166,T168,Cody Gribble,26,247,67,180,2019,total_driving,NA
167,172,Rod Pampling,22,249,160,89,2019,total_driving,NA
168,T170,Jim Knous,18,250,73,177,2019,total_driving,NA
T169,175,José de Jesús Rodríguez,23,251,125,126,2019,total_driving,NA
T169,T173,Peter Uihlein,29,251,64,187,2019,total_driving,NA
T171,T173,Branden Grace,22,252,90,162,2019,total_driving,NA
T171,T170,Seamus Power,27,252,81,171,2019,total_driving,NA
T173,176,Graeme McDowell,20,257,165,92,2019,total_driving,NA
T173,177,Anirban Lahiri,23,257,125,132,2019,total_driving,NA
175,178,Robert Streb,28,260,143,117,2019,total_driving,NA
176,179,"Ted Potter, Jr.",23,263,180,83,2019,total_driving,NA
T177,180,Jordan Spieth,23,269,88,181,2019,total_driving,NA
T177,181,Whee Kim,27,269,169,100,2019,total_driving,NA
179,182,Chris Stroud,26,279,130,149,2019,total_driving,NA
180,185,Freddie Jacobson,19,288,166,122,2019,total_driving,NA
181,183,Peter Malnati,26,289,110,179,2019,total_driving,NA
182,184,Julián Etulain,24,292,114,178,2019,total_driving,NA
183,187,Andrew Putnam,23,300,179,121,2019,total_driving,NA
184,188,Curtis Luck,23,308,136,172,2019,total_driving,NA
185,189,Ernie Els,18,311,168,143,2019,total_driving,NA
186,190,Aaron Baddeley,18,319,162,157,2019,total_driving,NA
187,191,Jonathan Byrd,17,329,178,151,2019,total_driving,NA
188,192,Michael Kim,26,364,181,183,2019,total_driving,NA
1,1,Andrew Novak,2,35,17,18,2004,total_driving,NA
2,3,Viktor Hovland,4,63,16,47,2004,total_driving,NA
3,4,Chase Koepka,2,72,34,38,2004,total_driving,NA
4,5,John Oda,2,74,70,4,2004,total_driving,NA
5,6,D.J. Trahan,7,91,47,44,2004,total_driving,NA
6,8,Gary Woodland,4,98,94,4,2004,total_driving,NA
7,9,Branden Grace,4,99,21,78,2004,total_driving,NA
T8,10,Patrick Cantlay,3,103,86,17,2004,total_driving,NA
T8,7,Doc Redman,10,103,77,26,2004,total_driving,NA
10,2,Ryan Moore,5,105,94,11,2004,total_driving,NA
11,13,Scottie Scheffler,8,126,15,111,2004,total_driving,NA
12,T19,Kyoung-Hoon Lee,10,128,106,22,2004,total_driving,NA
13,14,Martin Laird,8,129,42,87,2004,total_driving,NA
14,11,Kevin Streelman,9,130,62,68,2004,total_driving,NA
15,25,Jhonattan Vegas,6,132,24,108,2004,total_driving,NA
T16,15,Nick Taylor,8,133,109,24,2004,total_driving,NA
T16,T23,Brendan Steele,8,133,63,70,2004,total_driving,NA
18,12,Harris English,7,135,36,99,2004,total_driving,NA
T19,T27,Harry Higgs,10,140,79,61,2004,total_driving,NA
T19,T27,Sung Kang,7,140,53,87,2004,total_driving,NA
T21,22,Emiliano Grillo,7,142,110,32,2004,total_driving,NA
T21,18,Bubba Watson,4,142,1,141,2004,total_driving,NA
23,T19,Bryson DeChambeau,3,144,13,131,2004,total_driving,NA
24,T52,Matthew Wolff,5,145,40,105,2004,total_driving,NA
25,29,Joel Dahmen,8,149,100,49,2004,total_driving,NA
26,16,Jason Kokrak,5,153,8,145,2004,total_driving,NA
27,17,Josh Teater,6,156,83,73,2004,total_driving,NA
28,T23,Cameron Champ,7,157,2,155,2004,total_driving,NA
29,33,Ryan Palmer,5,160,146,14,2004,total_driving,NA
30,T35,Adam Hadwin,5,164,121,43,2004,total_driving,NA
31,26,Sungjae Im,8,165,50,115,2004,total_driving,NA
32,31,Henrik Norlander,10,168,132,36,2004,total_driving,NA
T33,38,Boo Weekley,5,169,147,22,2004,total_driving,NA
T33,T35,Harold Varner III,7,169,18,151,2004,total_driving,NA
35,37,Lanto Griffin,10,170,40,130,2004,total_driving,NA
36,T19,Lucas Glover,7,174,98,76,2004,total_driving,NA
37,34,Scott Brown,9,175,151,24,2004,total_driving,NA
38,T44,Sebastián Muñoz,10,176,60,116,2004,total_driving,NA
T39,40,Daniel Berger,6,177,56,121,2004,total_driving,NA
T39,42,Keegan Bradley,7,177,71,106,2004,total_driving,NA
41,39,Chesson Hadley,7,179,106,73,2004,total_driving,NA
42,43,Webb Simpson,3,182,170,12,2004,total_driving,NA
43,48,Danny Lee,7,185,9,176,2004,total_driving,NA
44,T50,Pat Perez,6,186,130,56,2004,total_driving,NA
45,T52,Matthew NeSmith,9,188,154,34,2004,total_driving,NA
46,T99,Sepp Straka,10,191,92,99,2004,total_driving,NA
T47,T90,Isaiah Salinda,3,192,14,178,2004,total_driving,NA
T47,T56,John Merrick,4,192,135,57,2004,total_driving,NA
T49,T50,Jim Furyk,3,193,192,1,2004,total_driving,NA
T49,55,Chad Campbell,4,193,178,15,2004,total_driving,NA
T49,T44,Wyndham Clark,7,193,32,161,2004,total_driving,NA
52,32,Alex Noren,4,195,108,87,2004,total_driving,NA
53,NA,Rickie Fowler,2,196,194,2,2004,total_driving,NA
T54,T56,Tony Finau,5,198,12,186,2004,total_driving,NA
T54,T62,Phil Mickelson,5,198,31,167,2004,total_driving,NA
T54,T62,Aaron Wise,7,198,51,147,2004,total_driving,NA
T54,T69,Chase Seiffert,9,198,127,71,2004,total_driving,NA
T58,T73,Abraham Ancer,8,199,113,86,2004,total_driving,NA
T58,61,Adam Schenk,10,199,33,166,2004,total_driving,NA
T58,T64,Scott Harrington,9,199,34,165,2004,total_driving,NA
T61,T52,Brian Harman,8,200,143,57,2004,total_driving,NA
T61,47,Jason Dufner,7,200,140,60,2004,total_driving,NA
T61,59,Cameron Smith,6,200,77,123,2004,total_driving,NA
T64,46,Kramer Hickok,9,201,124,77,2004,total_driving,NA
T64,60,Matt Jones,8,201,49,152,2004,total_driving,NA
66,30,Robby Shelton,10,202,88,114,2004,total_driving,NA
T67,83,Grayson Murray,6,203,4,199,2004,total_driving,NA
T67,T73,Russell Knox,8,203,138,65,2004,total_driving,NA
69,41,Denny McCarthy,8,204,101,103,2004,total_driving,NA
70,T80,Sam Ryder,10,209,53,156,2004,total_driving,NA
71,58,Brice Garnett,8,214,150,64,2004,total_driving,NA
72,66,Michael Thompson,7,215,175,40,2004,total_driving,NA
73,76,Collin Morikawa,6,216,168,48,2004,total_driving,NA
T74,T69,Derek Ernst,4,217,80,137,2004,total_driving,NA
T74,T67,Adam Long,10,217,189,28,2004,total_driving,NA
T74,96,Andrew Landry,9,217,171,46,2004,total_driving,NA
77,T84,Akshay Bhatia,5,218,7,211,2004,total_driving,NA
78,T69,Rod Pampling,3,220,28,192,2004,total_driving,NA
79,136,Nick Watney,7,222,73,149,2004,total_driving,NA
T80,T84,Hideki Matsuyama,6,223,115,108,2004,total_driving,NA
T80,115,Doug Ghim,7,223,116,107,2004,total_driving,NA
T80,T90,Kristoffer Ventura,9,223,44,179,2004,total_driving,NA
T83,T73,Byeong Hun An,8,225,10,215,2004,total_driving,NA
T83,T90,Chandler Phillips,2,225,57,168,2004,total_driving,NA
T83,T69,Brian Stuard,10,225,215,10,2004,total_driving,NA
T83,T97,Alex Cejka,5,225,175,50,2004,total_driving,NA
T83,T80,Ryan Armour,9,225,217,8,2004,total_driving,NA
T88,T90,Graham DeLaet,5,226,36,190,2004,total_driving,NA
T88,T77,Tim Wilkinson,6,226,189,37,2004,total_driving,NA
T88,T86,Brandon Wu,2,226,188,38,2004,total_driving,NA
T91,T88,Hank Lebioda,9,228,104,124,2004,total_driving,NA
T91,79,Charles Howell III,9,228,69,159,2004,total_driving,NA
93,T67,Tyler McCumber,9,229,11,218,2004,total_driving,NA
94,T90,Fabián Gómez,9,230,167,63,2004,total_driving,NA
95,T90,Brendon Todd,11,231,228,3,2004,total_driving,NA
T96,49,Cameron Percy,8,233,61,172,2004,total_driving,NA
T96,T99,Adam Scott,4,233,46,187,2004,total_driving,NA
T96,T80,Luke List,9,233,80,153,2004,total_driving,NA
T96,T86,Russell Henley,8,233,179,54,2004,total_driving,NA
T96,T130,Mackenzie Hughes,8,233,101,132,2004,total_driving,NA
101,T109,J.T. Poston,9,234,175,59,2004,total_driving,NA
102,T64,Vince Covello,8,235,73,162,2004,total_driving,NA
103,T99,Xinjun Zhang,10,236,116,120,2004,total_driving,NA
104,105,K.J. Choi,3,237,233,4,2004,total_driving,NA
T105,107,Tim Herron,4,238,220,18,2004,total_driving,NA
T105,T109,Corey Conners,7,238,186,52,2004,total_driving,NA
T107,108,Keith Mitchell,7,239,135,104,2004,total_driving,NA
T107,T130,Cameron Davis,8,239,22,217,2004,total_driving,NA
T107,T99,Richy Werenski,4,239,45,194,2004,total_driving,NA
T107,T88,Vaughn Taylor,8,239,212,27,2004,total_driving,NA
111,168,Chris Baker,9,240,168,72,2004,total_driving,NA
T112,T112,Jim Herman,8,241,221,20,2004,total_driving,NA
T112,T127,Scott Piercy,8,241,105,136,2004,total_driving,NA
T114,T120,J.J. Henry,5,242,173,69,2004,total_driving,NA
T114,T103,Tyler Duncan,10,242,221,21,2004,total_driving,NA
116,T112,Davis Riley,2,243,83,160,2004,total_driving,NA
T117,T125,Bo Hoag,10,244,127,117,2004,total_driving,NA
T117,T116,Chez Reavie,9,244,228,16,2004,total_driving,NA
119,T116,Matt Kuchar,4,245,238,7,2004,total_driving,NA
T120,223,Paul Casey,4,247,160,87,2004,total_driving,NA
T120,T116,Satoshi Kodaira,6,247,234,13,2004,total_driving,NA
T120,T127,Shawn Stefani,6,247,73,174,2004,total_driving,NA
123,106,Carlos Ortiz,8,248,67,181,2004,total_driving,NA
124,T122,Ben Crane,6,249,207,42,2004,total_driving,NA
125,T130,Tom Lewis,3,252,5,247,2004,total_driving,NA
126,T139,Michael Gligic,9,253,73,180,2004,total_driving,NA
T127,T139,Scott Stallings,8,254,47,207,2004,total_driving,NA
T127,T137,Kyle Stanley,8,254,213,41,2004,total_driving,NA
T129,T137,Henrik Stenson,2,255,202,53,2004,total_driving,NA
T129,T125,Austin Cook,8,255,127,128,2004,total_driving,NA
T131,T120,Beau Hossler,8,256,29,227,2004,total_driving,NA
T131,T122,Patrick Rodgers,10,256,26,230,2004,total_driving,NA
T131,T143,Sebastian Cappelen,8,256,30,226,2004,total_driving,NA
T131,T133,Kurt Kitayama,2,256,3,253,2004,total_driving,NA
T131,T77,Vincent Whaley,7,256,103,153,2004,total_driving,NA
T131,T141,Ryan Brehm,10,256,6,250,2004,total_driving,NA
137,T122,Mark Hubbard,10,257,149,108,2004,total_driving,NA
T138,T163,Brandon Hagy,8,258,22,236,2004,total_driving,NA
T138,T109,Billy Horschel,6,258,196,62,2004,total_driving,NA
T140,T147,Sam Burns,6,259,20,239,2004,total_driving,NA
T140,T133,David Lingmerth,5,259,230,29,2004,total_driving,NA
T142,T187,Bud Cauley,6,262,125,137,2004,total_driving,NA
T142,T143,Cameron Tringale,7,262,55,207,2004,total_driving,NA
144,T143,Rikuya Hoshino,2,264,138,126,2004,total_driving,NA
145,T155,Jonathan Byrd,5,265,72,193,2004,total_driving,NA
T146,T116,Maverick McNealy,9,266,89,177,2004,total_driving,NA
T146,T147,Xander Schauffele,3,266,231,35,2004,total_driving,NA
T148,154,Whee Kim,2,267,180,87,2004,total_driving,NA
T148,T141,Lucas Bjerregaard,3,267,18,249,2004,total_driving,NA
150,T152,Chip McDaniel,2,268,59,209,2004,total_driving,NA
T151,T178,Max Homa,6,269,187,82,2004,total_driving,NA
T151,T112,Bill Haas,6,269,147,122,2004,total_driving,NA
T151,146,J.B. Holmes,3,269,224,45,2004,total_driving,NA
T154,129,Zack Sucher,6,270,24,246,2004,total_driving,NA
T154,T157,Roberto Castro,5,270,183,87,2004,total_driving,NA
156,151,Kevin Tway,6,271,27,244,2004,total_driving,NA
T157,T155,Kevin Chappell,6,272,43,229,2004,total_driving,NA
T157,T152,Dominic Bozzelli,7,272,38,234,2004,total_driving,NA
T159,T147,David Hearn,9,273,206,67,2004,total_driving,NA
T159,174,Jimmy Walker,4,273,92,181,2004,total_driving,NA
161,165,Sangmoon Bae,6,274,64,210,2004,total_driving,NA
162,167,Michael Gellerman,8,275,135,140,2004,total_driving,NA
163,T159,Kevin Kisner,7,277,227,50,2004,total_driving,NA
T164,T159,Justin Thomas,5,278,161,117,2004,total_driving,NA
T164,T187,Troy Merritt,7,278,182,96,2004,total_driving,NA
T164,T163,Freddie Jacobson,3,278,141,137,2004,total_driving,NA
167,T175,Talor Gooch,8,280,122,158,2004,total_driving,NA
168,T103,Andrew Putnam,6,283,181,102,2004,total_driving,NA
T169,T157,Si Woo Kim,8,284,99,185,2004,total_driving,NA
T169,T97,Charley Hoffman,7,284,87,197,2004,total_driving,NA
T169,169,Seamus Power,5,284,83,201,2004,total_driving,NA
172,T133,John Huh,5,285,166,119,2004,total_driving,NA
T173,T172,Jason Day,3,286,80,206,2004,total_driving,NA
T173,T172,Chris Kirk,3,286,199,87,2004,total_driving,NA
T173,T175,Rafael Campos,9,286,67,219,2004,total_driving,NA
176,T159,Nate Lashley,8,287,204,83,2004,total_driving,NA
177,177,Brandt Snedeker,4,288,155,133,2004,total_driving,NA
178,T178,Peter Uihlein,6,289,38,251,2004,total_driving,NA
179,150,Kevin Na,7,290,203,87,2004,total_driving,NA
180,T170,Ben Taylor,10,291,134,157,2004,total_driving,NA
181,162,Anirban Lahiri,8,292,118,174,2004,total_driving,NA
182,T208,Roger Sloan,8,293,158,135,2004,total_driving,NA
T183,182,Johnson Wagner,5,294,207,87,2004,total_driving,NA
T183,T183,Robert Garrigus,5,294,52,242,2004,total_driving,NA
T183,T187,Wes Roach,7,294,151,143,2004,total_driving,NA
186,181,Zach Johnson,7,299,216,83,2004,total_driving,NA
187,191,Mikumu Horikawa,3,303,237,66,2004,total_driving,NA
T188,194,Will Gordon,4,304,64,240,2004,total_driving,NA
T188,210,Rory Sabbatini,7,304,219,85,2004,total_driving,NA
T188,T183,Dylan Frittelli,9,304,193,111,2004,total_driving,NA
191,185,Nelson Ledesma,10,305,57,248,2004,total_driving,NA
192,192,Marc Leishman,5,306,90,216,2004,total_driving,NA
193,166,Joseph Bramlett,7,307,94,213,2004,total_driving,NA
194,195,Joaquin Niemann,8,308,164,144,2004,total_driving,NA
T195,T196,Graeme McDowell,5,311,236,75,2004,total_driving,NA
T195,T201,Bronson Burgoon,8,311,130,181,2004,total_driving,NA
197,T187,Brian Gay,9,312,162,150,2004,total_driving,NA
198,193,Rhein Gibson,9,313,90,223,2004,total_driving,NA
199,T196,Tom Hoge,8,314,185,129,2004,total_driving,NA
200,200,Mark Anderson,7,319,132,187,2004,total_driving,NA
201,204,Smylie Kaufman,3,320,64,256,2004,total_driving,NA
T202,199,Zac Blair,10,322,225,97,2004,total_driving,NA
T202,214,Francesco Molinari,3,322,125,197,2004,total_driving,NA
T204,T170,John Senden,5,324,120,204,2004,total_driving,NA
T204,180,Ben Martin,6,324,223,101,2004,total_driving,NA
T206,T205,James Hahn,6,325,163,162,2004,total_driving,NA
T206,186,Aaron Baddeley,6,325,198,127,2004,total_driving,NA
208,T211,J.J. Spaun,9,330,118,212,2004,total_driving,NA
T209,203,Robert Streb,9,332,141,191,2004,total_driving,NA
T209,T208,Robert Allenby,3,332,164,168,2004,total_driving,NA
211,T211,Martin Trainer,8,339,94,245,2004,total_driving,NA
212,T205,"Ted Potter, Jr.",7,340,151,189,2004,total_driving,NA
213,T201,Chris Stroud,6,341,194,147,2004,total_driving,NA
T214,T205,Rob Oppenheim,10,342,200,142,2004,total_driving,NA
T214,198,Matt Every,7,342,122,220,2004,total_driving,NA
T214,213,Morgan Hoffmann,4,342,143,199,2004,total_driving,NA
217,215,Roberto Díaz,2,345,110,235,2004,total_driving,NA
218,216,Stewart Cink,4,350,112,238,2004,total_driving,NA
219,217,C.T. Pan,5,353,189,164,2004,total_driving,NA
220,T218,Patton Kizzire,9,354,158,196,2004,total_driving,NA
221,222,Hudson Swafford,4,356,183,173,2004,total_driving,NA
222,T218,George McNeill,6,359,145,214,2004,total_driving,NA
223,220,Patrick Reed,4,363,239,124,2004,total_driving,NA
224,221,Jamie Lovemark,4,365,114,251,2004,total_driving,NA
225,224,Luke Donald,2,378,232,146,2004,total_driving,NA
226,226,Bo Van Pelt,7,387,155,232,2004,total_driving,NA
227,225,Davis Love III,3,400,172,228,2004,total_driving,NA
228,228,Arjun Atwal,5,404,173,231,2004,total_driving,NA
T229,231,Daniel Chopra,3,411,157,254,2004,total_driving,NA
T229,227,Kevin Stadler,6,411,217,194,2004,total_driving,NA
231,229,John Rollins,4,414,209,205,2004,total_driving,NA
232,230,Parker McLachlin,4,421,201,220,2004,total_driving,NA
233,232,Peter Malnati,9,422,197,225,2004,total_driving,NA
234,233,Michael Kim,8,435,211,224,2004,total_driving,NA
235,235,Tommy Gainey,4,442,209,233,2004,total_driving,NA
236,234,D.A. Points,4,446,226,220,2004,total_driving,NA
237,236,Ricky Barnes,6,451,214,237,2004,total_driving,NA
238,237,Brendon de Jonge,3,462,205,257,2004,total_driving,NA
239,238,Shugo Imahira,2,490,235,255,2004,total_driving,NA
1,1,Andrew Novak,2,35,17,18,2005,total_driving,NA
2,3,Viktor Hovland,4,63,16,47,2005,total_driving,NA
3,4,Chase Koepka,2,72,34,38,2005,total_driving,NA
4,5,John Oda,2,74,70,4,2005,total_driving,NA
5,6,D.J. Trahan,7,91,47,44,2005,total_driving,NA
6,8,Gary Woodland,4,98,94,4,2005,total_driving,NA
7,9,Branden Grace,4,99,21,78,2005,total_driving,NA
T8,10,Patrick Cantlay,3,103,86,17,2005,total_driving,NA
T8,7,Doc Redman,10,103,77,26,2005,total_driving,NA
10,2,Ryan Moore,5,105,94,11,2005,total_driving,NA
11,13,Scottie Scheffler,8,126,15,111,2005,total_driving,NA
12,T19,Kyoung-Hoon Lee,10,128,106,22,2005,total_driving,NA
13,14,Martin Laird,8,129,42,87,2005,total_driving,NA
14,11,Kevin Streelman,9,130,62,68,2005,total_driving,NA
15,25,Jhonattan Vegas,6,132,24,108,2005,total_driving,NA
T16,15,Nick Taylor,8,133,109,24,2005,total_driving,NA
T16,T23,Brendan Steele,8,133,63,70,2005,total_driving,NA
18,12,Harris English,7,135,36,99,2005,total_driving,NA
T19,T27,Harry Higgs,10,140,79,61,2005,total_driving,NA
T19,T27,Sung Kang,7,140,53,87,2005,total_driving,NA
T21,22,Emiliano Grillo,7,142,110,32,2005,total_driving,NA
T21,18,Bubba Watson,4,142,1,141,2005,total_driving,NA
23,T19,Bryson DeChambeau,3,144,13,131,2005,total_driving,NA
24,T52,Matthew Wolff,5,145,40,105,2005,total_driving,NA
25,29,Joel Dahmen,8,149,100,49,2005,total_driving,NA
26,16,Jason Kokrak,5,153,8,145,2005,total_driving,NA
27,17,Josh Teater,6,156,83,73,2005,total_driving,NA
28,T23,Cameron Champ,7,157,2,155,2005,total_driving,NA
29,33,Ryan Palmer,5,160,146,14,2005,total_driving,NA
30,T35,Adam Hadwin,5,164,121,43,2005,total_driving,NA
31,26,Sungjae Im,8,165,50,115,2005,total_driving,NA
32,31,Henrik Norlander,10,168,132,36,2005,total_driving,NA
T33,38,Boo Weekley,5,169,147,22,2005,total_driving,NA
T33,T35,Harold Varner III,7,169,18,151,2005,total_driving,NA
35,37,Lanto Griffin,10,170,40,130,2005,total_driving,NA
36,T19,Lucas Glover,7,174,98,76,2005,total_driving,NA
37,34,Scott Brown,9,175,151,24,2005,total_driving,NA
38,T44,Sebastián Muñoz,10,176,60,116,2005,total_driving,NA
T39,40,Daniel Berger,6,177,56,121,2005,total_driving,NA
T39,42,Keegan Bradley,7,177,71,106,2005,total_driving,NA
41,39,Chesson Hadley,7,179,106,73,2005,total_driving,NA
42,43,Webb Simpson,3,182,170,12,2005,total_driving,NA
43,48,Danny Lee,7,185,9,176,2005,total_driving,NA
44,T50,Pat Perez,6,186,130,56,2005,total_driving,NA
45,T52,Matthew NeSmith,9,188,154,34,2005,total_driving,NA
46,T99,Sepp Straka,10,191,92,99,2005,total_driving,NA
T47,T90,Isaiah Salinda,3,192,14,178,2005,total_driving,NA
T47,T56,John Merrick,4,192,135,57,2005,total_driving,NA
T49,T50,Jim Furyk,3,193,192,1,2005,total_driving,NA
T49,55,Chad Campbell,4,193,178,15,2005,total_driving,NA
T49,T44,Wyndham Clark,7,193,32,161,2005,total_driving,NA
52,32,Alex Noren,4,195,108,87,2005,total_driving,NA
53,NA,Rickie Fowler,2,196,194,2,2005,total_driving,NA
T54,T56,Tony Finau,5,198,12,186,2005,total_driving,NA
T54,T62,Phil Mickelson,5,198,31,167,2005,total_driving,NA
T54,T62,Aaron Wise,7,198,51,147,2005,total_driving,NA
T54,T69,Chase Seiffert,9,198,127,71,2005,total_driving,NA
T58,T73,Abraham Ancer,8,199,113,86,2005,total_driving,NA
T58,61,Adam Schenk,10,199,33,166,2005,total_driving,NA
T58,T64,Scott Harrington,9,199,34,165,2005,total_driving,NA
T61,T52,Brian Harman,8,200,143,57,2005,total_driving,NA
T61,47,Jason Dufner,7,200,140,60,2005,total_driving,NA
T61,59,Cameron Smith,6,200,77,123,2005,total_driving,NA
T64,46,Kramer Hickok,9,201,124,77,2005,total_driving,NA
T64,60,Matt Jones,8,201,49,152,2005,total_driving,NA
66,30,Robby Shelton,10,202,88,114,2005,total_driving,NA
T67,83,Grayson Murray,6,203,4,199,2005,total_driving,NA
T67,T73,Russell Knox,8,203,138,65,2005,total_driving,NA
69,41,Denny McCarthy,8,204,101,103,2005,total_driving,NA
70,T80,Sam Ryder,10,209,53,156,2005,total_driving,NA
71,58,Brice Garnett,8,214,150,64,2005,total_driving,NA
72,66,Michael Thompson,7,215,175,40,2005,total_driving,NA
73,76,Collin Morikawa,6,216,168,48,2005,total_driving,NA
T74,T69,Derek Ernst,4,217,80,137,2005,total_driving,NA
T74,T67,Adam Long,10,217,189,28,2005,total_driving,NA
T74,96,Andrew Landry,9,217,171,46,2005,total_driving,NA
77,T84,Akshay Bhatia,5,218,7,211,2005,total_driving,NA
78,T69,Rod Pampling,3,220,28,192,2005,total_driving,NA
79,136,Nick Watney,7,222,73,149,2005,total_driving,NA
T80,T84,Hideki Matsuyama,6,223,115,108,2005,total_driving,NA
T80,115,Doug Ghim,7,223,116,107,2005,total_driving,NA
T80,T90,Kristoffer Ventura,9,223,44,179,2005,total_driving,NA
T83,T73,Byeong Hun An,8,225,10,215,2005,total_driving,NA
T83,T90,Chandler Phillips,2,225,57,168,2005,total_driving,NA
T83,T69,Brian Stuard,10,225,215,10,2005,total_driving,NA
T83,T97,Alex Cejka,5,225,175,50,2005,total_driving,NA
T83,T80,Ryan Armour,9,225,217,8,2005,total_driving,NA
T88,T90,Graham DeLaet,5,226,36,190,2005,total_driving,NA
T88,T77,Tim Wilkinson,6,226,189,37,2005,total_driving,NA
T88,T86,Brandon Wu,2,226,188,38,2005,total_driving,NA
T91,T88,Hank Lebioda,9,228,104,124,2005,total_driving,NA
T91,79,Charles Howell III,9,228,69,159,2005,total_driving,NA
93,T67,Tyler McCumber,9,229,11,218,2005,total_driving,NA
94,T90,Fabián Gómez,9,230,167,63,2005,total_driving,NA
95,T90,Brendon Todd,11,231,228,3,2005,total_driving,NA
T96,49,Cameron Percy,8,233,61,172,2005,total_driving,NA
T96,T99,Adam Scott,4,233,46,187,2005,total_driving,NA
T96,T80,Luke List,9,233,80,153,2005,total_driving,NA
T96,T86,Russell Henley,8,233,179,54,2005,total_driving,NA
T96,T130,Mackenzie Hughes,8,233,101,132,2005,total_driving,NA
101,T109,J.T. Poston,9,234,175,59,2005,total_driving,NA
102,T64,Vince Covello,8,235,73,162,2005,total_driving,NA
103,T99,Xinjun Zhang,10,236,116,120,2005,total_driving,NA
104,105,K.J. Choi,3,237,233,4,2005,total_driving,NA
T105,107,Tim Herron,4,238,220,18,2005,total_driving,NA
T105,T109,Corey Conners,7,238,186,52,2005,total_driving,NA
T107,108,Keith Mitchell,7,239,135,104,2005,total_driving,NA
T107,T130,Cameron Davis,8,239,22,217,2005,total_driving,NA
T107,T99,Richy Werenski,4,239,45,194,2005,total_driving,NA
T107,T88,Vaughn Taylor,8,239,212,27,2005,total_driving,NA
111,168,Chris Baker,9,240,168,72,2005,total_driving,NA
T112,T112,Jim Herman,8,241,221,20,2005,total_driving,NA
T112,T127,Scott Piercy,8,241,105,136,2005,total_driving,NA
T114,T120,J.J. Henry,5,242,173,69,2005,total_driving,NA
T114,T103,Tyler Duncan,10,242,221,21,2005,total_driving,NA
116,T112,Davis Riley,2,243,83,160,2005,total_driving,NA
T117,T125,Bo Hoag,10,244,127,117,2005,total_driving,NA
T117,T116,Chez Reavie,9,244,228,16,2005,total_driving,NA
119,T116,Matt Kuchar,4,245,238,7,2005,total_driving,NA
T120,223,Paul Casey,4,247,160,87,2005,total_driving,NA
T120,T116,Satoshi Kodaira,6,247,234,13,2005,total_driving,NA
T120,T127,Shawn Stefani,6,247,73,174,2005,total_driving,NA
123,106,Carlos Ortiz,8,248,67,181,2005,total_driving,NA
124,T122,Ben Crane,6,249,207,42,2005,total_driving,NA
125,T130,Tom Lewis,3,252,5,247,2005,total_driving,NA
126,T139,Michael Gligic,9,253,73,180,2005,total_driving,NA
T127,T139,Scott Stallings,8,254,47,207,2005,total_driving,NA
T127,T137,Kyle Stanley,8,254,213,41,2005,total_driving,NA
T129,T137,Henrik Stenson,2,255,202,53,2005,total_driving,NA
T129,T125,Austin Cook,8,255,127,128,2005,total_driving,NA
T131,T120,Beau Hossler,8,256,29,227,2005,total_driving,NA
T131,T122,Patrick Rodgers,10,256,26,230,2005,total_driving,NA
T131,T143,Sebastian Cappelen,8,256,30,226,2005,total_driving,NA
T131,T133,Kurt Kitayama,2,256,3,253,2005,total_driving,NA
T131,T77,Vincent Whaley,7,256,103,153,2005,total_driving,NA
T131,T141,Ryan Brehm,10,256,6,250,2005,total_driving,NA
137,T122,Mark Hubbard,10,257,149,108,2005,total_driving,NA
T138,T163,Brandon Hagy,8,258,22,236,2005,total_driving,NA
T138,T109,Billy Horschel,6,258,196,62,2005,total_driving,NA
T140,T147,Sam Burns,6,259,20,239,2005,total_driving,NA
T140,T133,David Lingmerth,5,259,230,29,2005,total_driving,NA
T142,T187,Bud Cauley,6,262,125,137,2005,total_driving,NA
T142,T143,Cameron Tringale,7,262,55,207,2005,total_driving,NA
144,T143,Rikuya Hoshino,2,264,138,126,2005,total_driving,NA
145,T155,Jonathan Byrd,5,265,72,193,2005,total_driving,NA
T146,T116,Maverick McNealy,9,266,89,177,2005,total_driving,NA
T146,T147,Xander Schauffele,3,266,231,35,2005,total_driving,NA
T148,154,Whee Kim,2,267,180,87,2005,total_driving,NA
T148,T141,Lucas Bjerregaard,3,267,18,249,2005,total_driving,NA
150,T152,Chip McDaniel,2,268,59,209,2005,total_driving,NA
T151,T178,Max Homa,6,269,187,82,2005,total_driving,NA
T151,T112,Bill Haas,6,269,147,122,2005,total_driving,NA
T151,146,J.B. Holmes,3,269,224,45,2005,total_driving,NA
T154,129,Zack Sucher,6,270,24,246,2005,total_driving,NA
T154,T157,Roberto Castro,5,270,183,87,2005,total_driving,NA
156,151,Kevin Tway,6,271,27,244,2005,total_driving,NA
T157,T155,Kevin Chappell,6,272,43,229,2005,total_driving,NA
T157,T152,Dominic Bozzelli,7,272,38,234,2005,total_driving,NA
T159,T147,David Hearn,9,273,206,67,2005,total_driving,NA
T159,174,Jimmy Walker,4,273,92,181,2005,total_driving,NA
161,165,Sangmoon Bae,6,274,64,210,2005,total_driving,NA
162,167,Michael Gellerman,8,275,135,140,2005,total_driving,NA
163,T159,Kevin Kisner,7,277,227,50,2005,total_driving,NA
T164,T159,Justin Thomas,5,278,161,117,2005,total_driving,NA
T164,T187,Troy Merritt,7,278,182,96,2005,total_driving,NA
T164,T163,Freddie Jacobson,3,278,141,137,2005,total_driving,NA
167,T175,Talor Gooch,8,280,122,158,2005,total_driving,NA
168,T103,Andrew Putnam,6,283,181,102,2005,total_driving,NA
T169,T157,Si Woo Kim,8,284,99,185,2005,total_driving,NA
T169,T97,Charley Hoffman,7,284,87,197,2005,total_driving,NA
T169,169,Seamus Power,5,284,83,201,2005,total_driving,NA
172,T133,John Huh,5,285,166,119,2005,total_driving,NA
T173,T172,Jason Day,3,286,80,206,2005,total_driving,NA
T173,T172,Chris Kirk,3,286,199,87,2005,total_driving,NA
T173,T175,Rafael Campos,9,286,67,219,2005,total_driving,NA
176,T159,Nate Lashley,8,287,204,83,2005,total_driving,NA
177,177,Brandt Snedeker,4,288,155,133,2005,total_driving,NA
178,T178,Peter Uihlein,6,289,38,251,2005,total_driving,NA
179,150,Kevin Na,7,290,203,87,2005,total_driving,NA
180,T170,Ben Taylor,10,291,134,157,2005,total_driving,NA
181,162,Anirban Lahiri,8,292,118,174,2005,total_driving,NA
182,T208,Roger Sloan,8,293,158,135,2005,total_driving,NA
T183,182,Johnson Wagner,5,294,207,87,2005,total_driving,NA
T183,T183,Robert Garrigus,5,294,52,242,2005,total_driving,NA
T183,T187,Wes Roach,7,294,151,143,2005,total_driving,NA
186,181,Zach Johnson,7,299,216,83,2005,total_driving,NA
187,191,Mikumu Horikawa,3,303,237,66,2005,total_driving,NA
T188,194,Will Gordon,4,304,64,240,2005,total_driving,NA
T188,210,Rory Sabbatini,7,304,219,85,2005,total_driving,NA
T188,T183,Dylan Frittelli,9,304,193,111,2005,total_driving,NA
191,185,Nelson Ledesma,10,305,57,248,2005,total_driving,NA
192,192,Marc Leishman,5,306,90,216,2005,total_driving,NA
193,166,Joseph Bramlett,7,307,94,213,2005,total_driving,NA
194,195,Joaquin Niemann,8,308,164,144,2005,total_driving,NA
T195,T196,Graeme McDowell,5,311,236,75,2005,total_driving,NA
T195,T201,Bronson Burgoon,8,311,130,181,2005,total_driving,NA
197,T187,Brian Gay,9,312,162,150,2005,total_driving,NA
198,193,Rhein Gibson,9,313,90,223,2005,total_driving,NA
199,T196,Tom Hoge,8,314,185,129,2005,total_driving,NA
200,200,Mark Anderson,7,319,132,187,2005,total_driving,NA
201,204,Smylie Kaufman,3,320,64,256,2005,total_driving,NA
T202,199,Zac Blair,10,322,225,97,2005,total_driving,NA
T202,214,Francesco Molinari,3,322,125,197,2005,total_driving,NA
T204,T170,John Senden,5,324,120,204,2005,total_driving,NA
T204,180,Ben Martin,6,324,223,101,2005,total_driving,NA
T206,T205,James Hahn,6,325,163,162,2005,total_driving,NA
T206,186,Aaron Baddeley,6,325,198,127,2005,total_driving,NA
208,T211,J.J. Spaun,9,330,118,212,2005,total_driving,NA
T209,203,Robert Streb,9,332,141,191,2005,total_driving,NA
T209,T208,Robert Allenby,3,332,164,168,2005,total_driving,NA
211,T211,Martin Trainer,8,339,94,245,2005,total_driving,NA
212,T205,"Ted Potter, Jr.",7,340,151,189,2005,total_driving,NA
213,T201,Chris Stroud,6,341,194,147,2005,total_driving,NA
T214,T205,Rob Oppenheim,10,342,200,142,2005,total_driving,NA
T214,198,Matt Every,7,342,122,220,2005,total_driving,NA
T214,213,Morgan Hoffmann,4,342,143,199,2005,total_driving,NA
217,215,Roberto Díaz,2,345,110,235,2005,total_driving,NA
218,216,Stewart Cink,4,350,112,238,2005,total_driving,NA
219,217,C.T. Pan,5,353,189,164,2005,total_driving,NA
220,T218,Patton Kizzire,9,354,158,196,2005,total_driving,NA
221,222,Hudson Swafford,4,356,183,173,2005,total_driving,NA
222,T218,George McNeill,6,359,145,214,2005,total_driving,NA
223,220,Patrick Reed,4,363,239,124,2005,total_driving,NA
224,221,Jamie Lovemark,4,365,114,251,2005,total_driving,NA
225,224,Luke Donald,2,378,232,146,2005,total_driving,NA
226,226,Bo Van Pelt,7,387,155,232,2005,total_driving,NA
227,225,Davis Love III,3,400,172,228,2005,total_driving,NA
228,228,Arjun Atwal,5,404,173,231,2005,total_driving,NA
T229,231,Daniel Chopra,3,411,157,254,2005,total_driving,NA
T229,227,Kevin Stadler,6,411,217,194,2005,total_driving,NA
231,229,John Rollins,4,414,209,205,2005,total_driving,NA
232,230,Parker McLachlin,4,421,201,220,2005,total_driving,NA
233,232,Peter Malnati,9,422,197,225,2005,total_driving,NA
234,233,Michael Kim,8,435,211,224,2005,total_driving,NA
235,235,Tommy Gainey,4,442,209,233,2005,total_driving,NA
236,234,D.A. Points,4,446,226,220,2005,total_driving,NA
237,236,Ricky Barnes,6,451,214,237,2005,total_driving,NA
238,237,Brendon de Jonge,3,462,205,257,2005,total_driving,NA
239,238,Shugo Imahira,2,490,235,255,2005,total_driving,NA
1,1,Andrew Novak,2,35,17,18,2006,total_driving,NA
2,3,Viktor Hovland,4,63,16,47,2006,total_driving,NA
3,4,Chase Koepka,2,72,34,38,2006,total_driving,NA
4,5,John Oda,2,74,70,4,2006,total_driving,NA
5,6,D.J. Trahan,7,91,47,44,2006,total_driving,NA
6,8,Gary Woodland,4,98,94,4,2006,total_driving,NA
7,9,Branden Grace,4,99,21,78,2006,total_driving,NA
T8,10,Patrick Cantlay,3,103,86,17,2006,total_driving,NA
T8,7,Doc Redman,10,103,77,26,2006,total_driving,NA
10,2,Ryan Moore,5,105,94,11,2006,total_driving,NA
11,13,Scottie Scheffler,8,126,15,111,2006,total_driving,NA
12,T19,Kyoung-Hoon Lee,10,128,106,22,2006,total_driving,NA
13,14,Martin Laird,8,129,42,87,2006,total_driving,NA
14,11,Kevin Streelman,9,130,62,68,2006,total_driving,NA
15,25,Jhonattan Vegas,6,132,24,108,2006,total_driving,NA
T16,15,Nick Taylor,8,133,109,24,2006,total_driving,NA
T16,T23,Brendan Steele,8,133,63,70,2006,total_driving,NA
18,12,Harris English,7,135,36,99,2006,total_driving,NA
T19,T27,Harry Higgs,10,140,79,61,2006,total_driving,NA
T19,T27,Sung Kang,7,140,53,87,2006,total_driving,NA
T21,22,Emiliano Grillo,7,142,110,32,2006,total_driving,NA
T21,18,Bubba Watson,4,142,1,141,2006,total_driving,NA
23,T19,Bryson DeChambeau,3,144,13,131,2006,total_driving,NA
24,T52,Matthew Wolff,5,145,40,105,2006,total_driving,NA
25,29,Joel Dahmen,8,149,100,49,2006,total_driving,NA
26,16,Jason Kokrak,5,153,8,145,2006,total_driving,NA
27,17,Josh Teater,6,156,83,73,2006,total_driving,NA
28,T23,Cameron Champ,7,157,2,155,2006,total_driving,NA
29,33,Ryan Palmer,5,160,146,14,2006,total_driving,NA
30,T35,Adam Hadwin,5,164,121,43,2006,total_driving,NA
31,26,Sungjae Im,8,165,50,115,2006,total_driving,NA
32,31,Henrik Norlander,10,168,132,36,2006,total_driving,NA
T33,38,Boo Weekley,5,169,147,22,2006,total_driving,NA
T33,T35,Harold Varner III,7,169,18,151,2006,total_driving,NA
35,37,Lanto Griffin,10,170,40,130,2006,total_driving,NA
36,T19,Lucas Glover,7,174,98,76,2006,total_driving,NA
37,34,Scott Brown,9,175,151,24,2006,total_driving,NA
38,T44,Sebastián Muñoz,10,176,60,116,2006,total_driving,NA
T39,40,Daniel Berger,6,177,56,121,2006,total_driving,NA
T39,42,Keegan Bradley,7,177,71,106,2006,total_driving,NA
41,39,Chesson Hadley,7,179,106,73,2006,total_driving,NA
42,43,Webb Simpson,3,182,170,12,2006,total_driving,NA
43,48,Danny Lee,7,185,9,176,2006,total_driving,NA
44,T50,Pat Perez,6,186,130,56,2006,total_driving,NA
45,T52,Matthew NeSmith,9,188,154,34,2006,total_driving,NA
46,T99,Sepp Straka,10,191,92,99,2006,total_driving,NA
T47,T90,Isaiah Salinda,3,192,14,178,2006,total_driving,NA
T47,T56,John Merrick,4,192,135,57,2006,total_driving,NA
T49,T50,Jim Furyk,3,193,192,1,2006,total_driving,NA
T49,55,Chad Campbell,4,193,178,15,2006,total_driving,NA
T49,T44,Wyndham Clark,7,193,32,161,2006,total_driving,NA
52,32,Alex Noren,4,195,108,87,2006,total_driving,NA
53,NA,Rickie Fowler,2,196,194,2,2006,total_driving,NA
T54,T56,Tony Finau,5,198,12,186,2006,total_driving,NA
T54,T62,Phil Mickelson,5,198,31,167,2006,total_driving,NA
T54,T62,Aaron Wise,7,198,51,147,2006,total_driving,NA
T54,T69,Chase Seiffert,9,198,127,71,2006,total_driving,NA
T58,T73,Abraham Ancer,8,199,113,86,2006,total_driving,NA
T58,61,Adam Schenk,10,199,33,166,2006,total_driving,NA
T58,T64,Scott Harrington,9,199,34,165,2006,total_driving,NA
T61,T52,Brian Harman,8,200,143,57,2006,total_driving,NA
T61,47,Jason Dufner,7,200,140,60,2006,total_driving,NA
T61,59,Cameron Smith,6,200,77,123,2006,total_driving,NA
T64,46,Kramer Hickok,9,201,124,77,2006,total_driving,NA
T64,60,Matt Jones,8,201,49,152,2006,total_driving,NA
66,30,Robby Shelton,10,202,88,114,2006,total_driving,NA
T67,83,Grayson Murray,6,203,4,199,2006,total_driving,NA
T67,T73,Russell Knox,8,203,138,65,2006,total_driving,NA
69,41,Denny McCarthy,8,204,101,103,2006,total_driving,NA
70,T80,Sam Ryder,10,209,53,156,2006,total_driving,NA
71,58,Brice Garnett,8,214,150,64,2006,total_driving,NA
72,66,Michael Thompson,7,215,175,40,2006,total_driving,NA
73,76,Collin Morikawa,6,216,168,48,2006,total_driving,NA
T74,T69,Derek Ernst,4,217,80,137,2006,total_driving,NA
T74,T67,Adam Long,10,217,189,28,2006,total_driving,NA
T74,96,Andrew Landry,9,217,171,46,2006,total_driving,NA
77,T84,Akshay Bhatia,5,218,7,211,2006,total_driving,NA
78,T69,Rod Pampling,3,220,28,192,2006,total_driving,NA
79,136,Nick Watney,7,222,73,149,2006,total_driving,NA
T80,T84,Hideki Matsuyama,6,223,115,108,2006,total_driving,NA
T80,115,Doug Ghim,7,223,116,107,2006,total_driving,NA
T80,T90,Kristoffer Ventura,9,223,44,179,2006,total_driving,NA
T83,T73,Byeong Hun An,8,225,10,215,2006,total_driving,NA
T83,T90,Chandler Phillips,2,225,57,168,2006,total_driving,NA
T83,T69,Brian Stuard,10,225,215,10,2006,total_driving,NA
T83,T97,Alex Cejka,5,225,175,50,2006,total_driving,NA
T83,T80,Ryan Armour,9,225,217,8,2006,total_driving,NA
T88,T90,Graham DeLaet,5,226,36,190,2006,total_driving,NA
T88,T77,Tim Wilkinson,6,226,189,37,2006,total_driving,NA
T88,T86,Brandon Wu,2,226,188,38,2006,total_driving,NA
T91,T88,Hank Lebioda,9,228,104,124,2006,total_driving,NA
T91,79,Charles Howell III,9,228,69,159,2006,total_driving,NA
93,T67,Tyler McCumber,9,229,11,218,2006,total_driving,NA
94,T90,Fabián Gómez,9,230,167,63,2006,total_driving,NA
95,T90,Brendon Todd,11,231,228,3,2006,total_driving,NA
T96,49,Cameron Percy,8,233,61,172,2006,total_driving,NA
T96,T99,Adam Scott,4,233,46,187,2006,total_driving,NA
T96,T80,Luke List,9,233,80,153,2006,total_driving,NA
T96,T86,Russell Henley,8,233,179,54,2006,total_driving,NA
T96,T130,Mackenzie Hughes,8,233,101,132,2006,total_driving,NA
101,T109,J.T. Poston,9,234,175,59,2006,total_driving,NA
102,T64,Vince Covello,8,235,73,162,2006,total_driving,NA
103,T99,Xinjun Zhang,10,236,116,120,2006,total_driving,NA
104,105,K.J. Choi,3,237,233,4,2006,total_driving,NA
T105,107,Tim Herron,4,238,220,18,2006,total_driving,NA
T105,T109,Corey Conners,7,238,186,52,2006,total_driving,NA
T107,108,Keith Mitchell,7,239,135,104,2006,total_driving,NA
T107,T130,Cameron Davis,8,239,22,217,2006,total_driving,NA
T107,T99,Richy Werenski,4,239,45,194,2006,total_driving,NA
T107,T88,Vaughn Taylor,8,239,212,27,2006,total_driving,NA
111,168,Chris Baker,9,240,168,72,2006,total_driving,NA
T112,T112,Jim Herman,8,241,221,20,2006,total_driving,NA
T112,T127,Scott Piercy,8,241,105,136,2006,total_driving,NA
T114,T120,J.J. Henry,5,242,173,69,2006,total_driving,NA
T114,T103,Tyler Duncan,10,242,221,21,2006,total_driving,NA
116,T112,Davis Riley,2,243,83,160,2006,total_driving,NA
T117,T125,Bo Hoag,10,244,127,117,2006,total_driving,NA
T117,T116,Chez Reavie,9,244,228,16,2006,total_driving,NA
119,T116,Matt Kuchar,4,245,238,7,2006,total_driving,NA
T120,223,Paul Casey,4,247,160,87,2006,total_driving,NA
T120,T116,Satoshi Kodaira,6,247,234,13,2006,total_driving,NA
T120,T127,Shawn Stefani,6,247,73,174,2006,total_driving,NA
123,106,Carlos Ortiz,8,248,67,181,2006,total_driving,NA
124,T122,Ben Crane,6,249,207,42,2006,total_driving,NA
125,T130,Tom Lewis,3,252,5,247,2006,total_driving,NA
126,T139,Michael Gligic,9,253,73,180,2006,total_driving,NA
T127,T139,Scott Stallings,8,254,47,207,2006,total_driving,NA
T127,T137,Kyle Stanley,8,254,213,41,2006,total_driving,NA
T129,T137,Henrik Stenson,2,255,202,53,2006,total_driving,NA
T129,T125,Austin Cook,8,255,127,128,2006,total_driving,NA
T131,T120,Beau Hossler,8,256,29,227,2006,total_driving,NA
T131,T122,Patrick Rodgers,10,256,26,230,2006,total_driving,NA
T131,T143,Sebastian Cappelen,8,256,30,226,2006,total_driving,NA
T131,T133,Kurt Kitayama,2,256,3,253,2006,total_driving,NA
T131,T77,Vincent Whaley,7,256,103,153,2006,total_driving,NA
T131,T141,Ryan Brehm,10,256,6,250,2006,total_driving,NA
137,T122,Mark Hubbard,10,257,149,108,2006,total_driving,NA
T138,T163,Brandon Hagy,8,258,22,236,2006,total_driving,NA
T138,T109,Billy Horschel,6,258,196,62,2006,total_driving,NA
T140,T147,Sam Burns,6,259,20,239,2006,total_driving,NA
T140,T133,David Lingmerth,5,259,230,29,2006,total_driving,NA
T142,T187,Bud Cauley,6,262,125,137,2006,total_driving,NA
T142,T143,Cameron Tringale,7,262,55,207,2006,total_driving,NA
144,T143,Rikuya Hoshino,2,264,138,126,2006,total_driving,NA
145,T155,Jonathan Byrd,5,265,72,193,2006,total_driving,NA
T146,T116,Maverick McNealy,9,266,89,177,2006,total_driving,NA
T146,T147,Xander Schauffele,3,266,231,35,2006,total_driving,NA
T148,154,Whee Kim,2,267,180,87,2006,total_driving,NA
T148,T141,Lucas Bjerregaard,3,267,18,249,2006,total_driving,NA
150,T152,Chip McDaniel,2,268,59,209,2006,total_driving,NA
T151,T178,Max Homa,6,269,187,82,2006,total_driving,NA
T151,T112,Bill Haas,6,269,147,122,2006,total_driving,NA
T151,146,J.B. Holmes,3,269,224,45,2006,total_driving,NA
T154,129,Zack Sucher,6,270,24,246,2006,total_driving,NA
T154,T157,Roberto Castro,5,270,183,87,2006,total_driving,NA
156,151,Kevin Tway,6,271,27,244,2006,total_driving,NA
T157,T155,Kevin Chappell,6,272,43,229,2006,total_driving,NA
T157,T152,Dominic Bozzelli,7,272,38,234,2006,total_driving,NA
T159,T147,David Hearn,9,273,206,67,2006,total_driving,NA
T159,174,Jimmy Walker,4,273,92,181,2006,total_driving,NA
161,165,Sangmoon Bae,6,274,64,210,2006,total_driving,NA
162,167,Michael Gellerman,8,275,135,140,2006,total_driving,NA
163,T159,Kevin Kisner,7,277,227,50,2006,total_driving,NA
T164,T159,Justin Thomas,5,278,161,117,2006,total_driving,NA
T164,T187,Troy Merritt,7,278,182,96,2006,total_driving,NA
T164,T163,Freddie Jacobson,3,278,141,137,2006,total_driving,NA
167,T175,Talor Gooch,8,280,122,158,2006,total_driving,NA
168,T103,Andrew Putnam,6,283,181,102,2006,total_driving,NA
T169,T157,Si Woo Kim,8,284,99,185,2006,total_driving,NA
T169,T97,Charley Hoffman,7,284,87,197,2006,total_driving,NA
T169,169,Seamus Power,5,284,83,201,2006,total_driving,NA
172,T133,John Huh,5,285,166,119,2006,total_driving,NA
T173,T172,Jason Day,3,286,80,206,2006,total_driving,NA
T173,T172,Chris Kirk,3,286,199,87,2006,total_driving,NA
T173,T175,Rafael Campos,9,286,67,219,2006,total_driving,NA
176,T159,Nate Lashley,8,287,204,83,2006,total_driving,NA
177,177,Brandt Snedeker,4,288,155,133,2006,total_driving,NA
178,T178,Peter Uihlein,6,289,38,251,2006,total_driving,NA
179,150,Kevin Na,7,290,203,87,2006,total_driving,NA
180,T170,Ben Taylor,10,291,134,157,2006,total_driving,NA
181,162,Anirban Lahiri,8,292,118,174,2006,total_driving,NA
182,T208,Roger Sloan,8,293,158,135,2006,total_driving,NA
T183,182,Johnson Wagner,5,294,207,87,2006,total_driving,NA
T183,T183,Robert Garrigus,5,294,52,242,2006,total_driving,NA
T183,T187,Wes Roach,7,294,151,143,2006,total_driving,NA
186,181,Zach Johnson,7,299,216,83,2006,total_driving,NA
187,191,Mikumu Horikawa,3,303,237,66,2006,total_driving,NA
T188,194,Will Gordon,4,304,64,240,2006,total_driving,NA
T188,210,Rory Sabbatini,7,304,219,85,2006,total_driving,NA
T188,T183,Dylan Frittelli,9,304,193,111,2006,total_driving,NA
191,185,Nelson Ledesma,10,305,57,248,2006,total_driving,NA
192,192,Marc Leishman,5,306,90,216,2006,total_driving,NA
193,166,Joseph Bramlett,7,307,94,213,2006,total_driving,NA
194,195,Joaquin Niemann,8,308,164,144,2006,total_driving,NA
T195,T196,Graeme McDowell,5,311,236,75,2006,total_driving,NA
T195,T201,Bronson Burgoon,8,311,130,181,2006,total_driving,NA
197,T187,Brian Gay,9,312,162,150,2006,total_driving,NA
198,193,Rhein Gibson,9,313,90,223,2006,total_driving,NA
199,T196,Tom Hoge,8,314,185,129,2006,total_driving,NA
200,200,Mark Anderson,7,319,132,187,2006,total_driving,NA
201,204,Smylie Kaufman,3,320,64,256,2006,total_driving,NA
T202,199,Zac Blair,10,322,225,97,2006,total_driving,NA
T202,214,Francesco Molinari,3,322,125,197,2006,total_driving,NA
T204,T170,John Senden,5,324,120,204,2006,total_driving,NA
T204,180,Ben Martin,6,324,223,101,2006,total_driving,NA
T206,T205,James Hahn,6,325,163,162,2006,total_driving,NA
T206,186,Aaron Baddeley,6,325,198,127,2006,total_driving,NA
208,T211,J.J. Spaun,9,330,118,212,2006,total_driving,NA
T209,203,Robert Streb,9,332,141,191,2006,total_driving,NA
T209,T208,Robert Allenby,3,332,164,168,2006,total_driving,NA
211,T211,Martin Trainer,8,339,94,245,2006,total_driving,NA
212,T205,"Ted Potter, Jr.",7,340,151,189,2006,total_driving,NA
213,T201,Chris Stroud,6,341,194,147,2006,total_driving,NA
T214,T205,Rob Oppenheim,10,342,200,142,2006,total_driving,NA
T214,198,Matt Every,7,342,122,220,2006,total_driving,NA
T214,213,Morgan Hoffmann,4,342,143,199,2006,total_driving,NA
217,215,Roberto Díaz,2,345,110,235,2006,total_driving,NA
218,216,Stewart Cink,4,350,112,238,2006,total_driving,NA
219,217,C.T. Pan,5,353,189,164,2006,total_driving,NA
220,T218,Patton Kizzire,9,354,158,196,2006,total_driving,NA
221,222,Hudson Swafford,4,356,183,173,2006,total_driving,NA
222,T218,George McNeill,6,359,145,214,2006,total_driving,NA
223,220,Patrick Reed,4,363,239,124,2006,total_driving,NA
224,221,Jamie Lovemark,4,365,114,251,2006,total_driving,NA
225,224,Luke Donald,2,378,232,146,2006,total_driving,NA
226,226,Bo Van Pelt,7,387,155,232,2006,total_driving,NA
227,225,Davis Love III,3,400,172,228,2006,total_driving,NA
228,228,Arjun Atwal,5,404,173,231,2006,total_driving,NA
T229,231,Daniel Chopra,3,411,157,254,2006,total_driving,NA
T229,227,Kevin Stadler,6,411,217,194,2006,total_driving,NA
231,229,John Rollins,4,414,209,205,2006,total_driving,NA
232,230,Parker McLachlin,4,421,201,220,2006,total_driving,NA
233,232,Peter Malnati,9,422,197,225,2006,total_driving,NA
234,233,Michael Kim,8,435,211,224,2006,total_driving,NA
235,235,Tommy Gainey,4,442,209,233,2006,total_driving,NA
236,234,D.A. Points,4,446,226,220,2006,total_driving,NA
237,236,Ricky Barnes,6,451,214,237,2006,total_driving,NA
238,237,Brendon de Jonge,3,462,205,257,2006,total_driving,NA
239,238,Shugo Imahira,2,490,235,255,2006,total_driving,NA
1,1,Andrew Novak,2,35,17,18,2007,total_driving,NA
2,3,Viktor Hovland,4,63,16,47,2007,total_driving,NA
3,4,Chase Koepka,2,72,34,38,2007,total_driving,NA
4,5,John Oda,2,74,70,4,2007,total_driving,NA
5,6,D.J. Trahan,7,91,47,44,2007,total_driving,NA
6,8,Gary Woodland,4,98,94,4,2007,total_driving,NA
7,9,Branden Grace,4,99,21,78,2007,total_driving,NA
T8,10,Patrick Cantlay,3,103,86,17,2007,total_driving,NA
T8,7,Doc Redman,10,103,77,26,2007,total_driving,NA
10,2,Ryan Moore,5,105,94,11,2007,total_driving,NA
11,13,Scottie Scheffler,8,126,15,111,2007,total_driving,NA
12,T19,Kyoung-Hoon Lee,10,128,106,22,2007,total_driving,NA
13,14,Martin Laird,8,129,42,87,2007,total_driving,NA
14,11,Kevin Streelman,9,130,62,68,2007,total_driving,NA
15,25,Jhonattan Vegas,6,132,24,108,2007,total_driving,NA
T16,15,Nick Taylor,8,133,109,24,2007,total_driving,NA
T16,T23,Brendan Steele,8,133,63,70,2007,total_driving,NA
18,12,Harris English,7,135,36,99,2007,total_driving,NA
T19,T27,Harry Higgs,10,140,79,61,2007,total_driving,NA
T19,T27,Sung Kang,7,140,53,87,2007,total_driving,NA
T21,22,Emiliano Grillo,7,142,110,32,2007,total_driving,NA
T21,18,Bubba Watson,4,142,1,141,2007,total_driving,NA
23,T19,Bryson DeChambeau,3,144,13,131,2007,total_driving,NA
24,T52,Matthew Wolff,5,145,40,105,2007,total_driving,NA
25,29,Joel Dahmen,8,149,100,49,2007,total_driving,NA
26,16,Jason Kokrak,5,153,8,145,2007,total_driving,NA
27,17,Josh Teater,6,156,83,73,2007,total_driving,NA
28,T23,Cameron Champ,7,157,2,155,2007,total_driving,NA
29,33,Ryan Palmer,5,160,146,14,2007,total_driving,NA
30,T35,Adam Hadwin,5,164,121,43,2007,total_driving,NA
31,26,Sungjae Im,8,165,50,115,2007,total_driving,NA
32,31,Henrik Norlander,10,168,132,36,2007,total_driving,NA
T33,38,Boo Weekley,5,169,147,22,2007,total_driving,NA
T33,T35,Harold Varner III,7,169,18,151,2007,total_driving,NA
35,37,Lanto Griffin,10,170,40,130,2007,total_driving,NA
36,T19,Lucas Glover,7,174,98,76,2007,total_driving,NA
37,34,Scott Brown,9,175,151,24,2007,total_driving,NA
38,T44,Sebastián Muñoz,10,176,60,116,2007,total_driving,NA
T39,40,Daniel Berger,6,177,56,121,2007,total_driving,NA
T39,42,Keegan Bradley,7,177,71,106,2007,total_driving,NA
41,39,Chesson Hadley,7,179,106,73,2007,total_driving,NA
42,43,Webb Simpson,3,182,170,12,2007,total_driving,NA
43,48,Danny Lee,7,185,9,176,2007,total_driving,NA
44,T50,Pat Perez,6,186,130,56,2007,total_driving,NA
45,T52,Matthew NeSmith,9,188,154,34,2007,total_driving,NA
46,T99,Sepp Straka,10,191,92,99,2007,total_driving,NA
T47,T90,Isaiah Salinda,3,192,14,178,2007,total_driving,NA
T47,T56,John Merrick,4,192,135,57,2007,total_driving,NA
T49,T50,Jim Furyk,3,193,192,1,2007,total_driving,NA
T49,55,Chad Campbell,4,193,178,15,2007,total_driving,NA
T49,T44,Wyndham Clark,7,193,32,161,2007,total_driving,NA
52,32,Alex Noren,4,195,108,87,2007,total_driving,NA
53,NA,Rickie Fowler,2,196,194,2,2007,total_driving,NA
T54,T56,Tony Finau,5,198,12,186,2007,total_driving,NA
T54,T62,Phil Mickelson,5,198,31,167,2007,total_driving,NA
T54,T62,Aaron Wise,7,198,51,147,2007,total_driving,NA
T54,T69,Chase Seiffert,9,198,127,71,2007,total_driving,NA
T58,T73,Abraham Ancer,8,199,113,86,2007,total_driving,NA
T58,61,Adam Schenk,10,199,33,166,2007,total_driving,NA
T58,T64,Scott Harrington,9,199,34,165,2007,total_driving,NA
T61,T52,Brian Harman,8,200,143,57,2007,total_driving,NA
T61,47,Jason Dufner,7,200,140,60,2007,total_driving,NA
T61,59,Cameron Smith,6,200,77,123,2007,total_driving,NA
T64,46,Kramer Hickok,9,201,124,77,2007,total_driving,NA
T64,60,Matt Jones,8,201,49,152,2007,total_driving,NA
66,30,Robby Shelton,10,202,88,114,2007,total_driving,NA
T67,83,Grayson Murray,6,203,4,199,2007,total_driving,NA
T67,T73,Russell Knox,8,203,138,65,2007,total_driving,NA
69,41,Denny McCarthy,8,204,101,103,2007,total_driving,NA
70,T80,Sam Ryder,10,209,53,156,2007,total_driving,NA
71,58,Brice Garnett,8,214,150,64,2007,total_driving,NA
72,66,Michael Thompson,7,215,175,40,2007,total_driving,NA
73,76,Collin Morikawa,6,216,168,48,2007,total_driving,NA
T74,T69,Derek Ernst,4,217,80,137,2007,total_driving,NA
T74,T67,Adam Long,10,217,189,28,2007,total_driving,NA
T74,96,Andrew Landry,9,217,171,46,2007,total_driving,NA
77,T84,Akshay Bhatia,5,218,7,211,2007,total_driving,NA
78,T69,Rod Pampling,3,220,28,192,2007,total_driving,NA
79,136,Nick Watney,7,222,73,149,2007,total_driving,NA
T80,T84,Hideki Matsuyama,6,223,115,108,2007,total_driving,NA
T80,115,Doug Ghim,7,223,116,107,2007,total_driving,NA
T80,T90,Kristoffer Ventura,9,223,44,179,2007,total_driving,NA
T83,T73,Byeong Hun An,8,225,10,215,2007,total_driving,NA
T83,T90,Chandler Phillips,2,225,57,168,2007,total_driving,NA
T83,T69,Brian Stuard,10,225,215,10,2007,total_driving,NA
T83,T97,Alex Cejka,5,225,175,50,2007,total_driving,NA
T83,T80,Ryan Armour,9,225,217,8,2007,total_driving,NA
T88,T90,Graham DeLaet,5,226,36,190,2007,total_driving,NA
T88,T77,Tim Wilkinson,6,226,189,37,2007,total_driving,NA
T88,T86,Brandon Wu,2,226,188,38,2007,total_driving,NA
T91,T88,Hank Lebioda,9,228,104,124,2007,total_driving,NA
T91,79,Charles Howell III,9,228,69,159,2007,total_driving,NA
93,T67,Tyler McCumber,9,229,11,218,2007,total_driving,NA
94,T90,Fabián Gómez,9,230,167,63,2007,total_driving,NA
95,T90,Brendon Todd,11,231,228,3,2007,total_driving,NA
T96,49,Cameron Percy,8,233,61,172,2007,total_driving,NA
T96,T99,Adam Scott,4,233,46,187,2007,total_driving,NA
T96,T80,Luke List,9,233,80,153,2007,total_driving,NA
T96,T86,Russell Henley,8,233,179,54,2007,total_driving,NA
T96,T130,Mackenzie Hughes,8,233,101,132,2007,total_driving,NA
101,T109,J.T. Poston,9,234,175,59,2007,total_driving,NA
102,T64,Vince Covello,8,235,73,162,2007,total_driving,NA
103,T99,Xinjun Zhang,10,236,116,120,2007,total_driving,NA
104,105,K.J. Choi,3,237,233,4,2007,total_driving,NA
T105,107,Tim Herron,4,238,220,18,2007,total_driving,NA
T105,T109,Corey Conners,7,238,186,52,2007,total_driving,NA
T107,108,Keith Mitchell,7,239,135,104,2007,total_driving,NA
T107,T130,Cameron Davis,8,239,22,217,2007,total_driving,NA
T107,T99,Richy Werenski,4,239,45,194,2007,total_driving,NA
T107,T88,Vaughn Taylor,8,239,212,27,2007,total_driving,NA
111,168,Chris Baker,9,240,168,72,2007,total_driving,NA
T112,T112,Jim Herman,8,241,221,20,2007,total_driving,NA
T112,T127,Scott Piercy,8,241,105,136,2007,total_driving,NA
T114,T120,J.J. Henry,5,242,173,69,2007,total_driving,NA
T114,T103,Tyler Duncan,10,242,221,21,2007,total_driving,NA
116,T112,Davis Riley,2,243,83,160,2007,total_driving,NA
T117,T125,Bo Hoag,10,244,127,117,2007,total_driving,NA
T117,T116,Chez Reavie,9,244,228,16,2007,total_driving,NA
119,T116,Matt Kuchar,4,245,238,7,2007,total_driving,NA
T120,223,Paul Casey,4,247,160,87,2007,total_driving,NA
T120,T116,Satoshi Kodaira,6,247,234,13,2007,total_driving,NA
T120,T127,Shawn Stefani,6,247,73,174,2007,total_driving,NA
123,106,Carlos Ortiz,8,248,67,181,2007,total_driving,NA
124,T122,Ben Crane,6,249,207,42,2007,total_driving,NA
125,T130,Tom Lewis,3,252,5,247,2007,total_driving,NA
126,T139,Michael Gligic,9,253,73,180,2007,total_driving,NA
T127,T139,Scott Stallings,8,254,47,207,2007,total_driving,NA
T127,T137,Kyle Stanley,8,254,213,41,2007,total_driving,NA
T129,T137,Henrik Stenson,2,255,202,53,2007,total_driving,NA
T129,T125,Austin Cook,8,255,127,128,2007,total_driving,NA
T131,T120,Beau Hossler,8,256,29,227,2007,total_driving,NA
T131,T122,Patrick Rodgers,10,256,26,230,2007,total_driving,NA
T131,T143,Sebastian Cappelen,8,256,30,226,2007,total_driving,NA
T131,T133,Kurt Kitayama,2,256,3,253,2007,total_driving,NA
T131,T77,Vincent Whaley,7,256,103,153,2007,total_driving,NA
T131,T141,Ryan Brehm,10,256,6,250,2007,total_driving,NA
137,T122,Mark Hubbard,10,257,149,108,2007,total_driving,NA
T138,T163,Brandon Hagy,8,258,22,236,2007,total_driving,NA
T138,T109,Billy Horschel,6,258,196,62,2007,total_driving,NA
T140,T147,Sam Burns,6,259,20,239,2007,total_driving,NA
T140,T133,David Lingmerth,5,259,230,29,2007,total_driving,NA
T142,T187,Bud Cauley,6,262,125,137,2007,total_driving,NA
T142,T143,Cameron Tringale,7,262,55,207,2007,total_driving,NA
144,T143,Rikuya Hoshino,2,264,138,126,2007,total_driving,NA
145,T155,Jonathan Byrd,5,265,72,193,2007,total_driving,NA
T146,T116,Maverick McNealy,9,266,89,177,2007,total_driving,NA
T146,T147,Xander Schauffele,3,266,231,35,2007,total_driving,NA
T148,154,Whee Kim,2,267,180,87,2007,total_driving,NA
T148,T141,Lucas Bjerregaard,3,267,18,249,2007,total_driving,NA
150,T152,Chip McDaniel,2,268,59,209,2007,total_driving,NA
T151,T178,Max Homa,6,269,187,82,2007,total_driving,NA
T151,T112,Bill Haas,6,269,147,122,2007,total_driving,NA
T151,146,J.B. Holmes,3,269,224,45,2007,total_driving,NA
T154,129,Zack Sucher,6,270,24,246,2007,total_driving,NA
T154,T157,Roberto Castro,5,270,183,87,2007,total_driving,NA
156,151,Kevin Tway,6,271,27,244,2007,total_driving,NA
T157,T155,Kevin Chappell,6,272,43,229,2007,total_driving,NA
T157,T152,Dominic Bozzelli,7,272,38,234,2007,total_driving,NA
T159,T147,David Hearn,9,273,206,67,2007,total_driving,NA
T159,174,Jimmy Walker,4,273,92,181,2007,total_driving,NA
161,165,Sangmoon Bae,6,274,64,210,2007,total_driving,NA
162,167,Michael Gellerman,8,275,135,140,2007,total_driving,NA
163,T159,Kevin Kisner,7,277,227,50,2007,total_driving,NA
T164,T159,Justin Thomas,5,278,161,117,2007,total_driving,NA
T164,T187,Troy Merritt,7,278,182,96,2007,total_driving,NA
T164,T163,Freddie Jacobson,3,278,141,137,2007,total_driving,NA
167,T175,Talor Gooch,8,280,122,158,2007,total_driving,NA
168,T103,Andrew Putnam,6,283,181,102,2007,total_driving,NA
T169,T157,Si Woo Kim,8,284,99,185,2007,total_driving,NA
T169,T97,Charley Hoffman,7,284,87,197,2007,total_driving,NA
T169,169,Seamus Power,5,284,83,201,2007,total_driving,NA
172,T133,John Huh,5,285,166,119,2007,total_driving,NA
T173,T172,Jason Day,3,286,80,206,2007,total_driving,NA
T173,T172,Chris Kirk,3,286,199,87,2007,total_driving,NA
T173,T175,Rafael Campos,9,286,67,219,2007,total_driving,NA
176,T159,Nate Lashley,8,287,204,83,2007,total_driving,NA
177,177,Brandt Snedeker,4,288,155,133,2007,total_driving,NA
178,T178,Peter Uihlein,6,289,38,251,2007,total_driving,NA
179,150,Kevin Na,7,290,203,87,2007,total_driving,NA
180,T170,Ben Taylor,10,291,134,157,2007,total_driving,NA
181,162,Anirban Lahiri,8,292,118,174,2007,total_driving,NA
182,T208,Roger Sloan,8,293,158,135,2007,total_driving,NA
T183,182,Johnson Wagner,5,294,207,87,2007,total_driving,NA
T183,T183,Robert Garrigus,5,294,52,242,2007,total_driving,NA
T183,T187,Wes Roach,7,294,151,143,2007,total_driving,NA
186,181,Zach Johnson,7,299,216,83,2007,total_driving,NA
187,191,Mikumu Horikawa,3,303,237,66,2007,total_driving,NA
T188,194,Will Gordon,4,304,64,240,2007,total_driving,NA
T188,210,Rory Sabbatini,7,304,219,85,2007,total_driving,NA
T188,T183,Dylan Frittelli,9,304,193,111,2007,total_driving,NA
191,185,Nelson Ledesma,10,305,57,248,2007,total_driving,NA
192,192,Marc Leishman,5,306,90,216,2007,total_driving,NA
193,166,Joseph Bramlett,7,307,94,213,2007,total_driving,NA
194,195,Joaquin Niemann,8,308,164,144,2007,total_driving,NA
T195,T196,Graeme McDowell,5,311,236,75,2007,total_driving,NA
T195,T201,Bronson Burgoon,8,311,130,181,2007,total_driving,NA
197,T187,Brian Gay,9,312,162,150,2007,total_driving,NA
198,193,Rhein Gibson,9,313,90,223,2007,total_driving,NA
199,T196,Tom Hoge,8,314,185,129,2007,total_driving,NA
200,200,Mark Anderson,7,319,132,187,2007,total_driving,NA
201,204,Smylie Kaufman,3,320,64,256,2007,total_driving,NA
T202,199,Zac Blair,10,322,225,97,2007,total_driving,NA
T202,214,Francesco Molinari,3,322,125,197,2007,total_driving,NA
T204,T170,John Senden,5,324,120,204,2007,total_driving,NA
T204,180,Ben Martin,6,324,223,101,2007,total_driving,NA
T206,T205,James Hahn,6,325,163,162,2007,total_driving,NA
T206,186,Aaron Baddeley,6,325,198,127,2007,total_driving,NA
208,T211,J.J. Spaun,9,330,118,212,2007,total_driving,NA
T209,203,Robert Streb,9,332,141,191,2007,total_driving,NA
T209,T208,Robert Allenby,3,332,164,168,2007,total_driving,NA
211,T211,Martin Trainer,8,339,94,245,2007,total_driving,NA
212,T205,"Ted Potter, Jr.",7,340,151,189,2007,total_driving,NA
213,T201,Chris Stroud,6,341,194,147,2007,total_driving,NA
T214,T205,Rob Oppenheim,10,342,200,142,2007,total_driving,NA
T214,198,Matt Every,7,342,122,220,2007,total_driving,NA
T214,213,Morgan Hoffmann,4,342,143,199,2007,total_driving,NA
217,215,Roberto Díaz,2,345,110,235,2007,total_driving,NA
218,216,Stewart Cink,4,350,112,238,2007,total_driving,NA
219,217,C.T. Pan,5,353,189,164,2007,total_driving,NA
220,T218,Patton Kizzire,9,354,158,196,2007,total_driving,NA
221,222,Hudson Swafford,4,356,183,173,2007,total_driving,NA
222,T218,George McNeill,6,359,145,214,2007,total_driving,NA
223,220,Patrick Reed,4,363,239,124,2007,total_driving,NA
224,221,Jamie Lovemark,4,365,114,251,2007,total_driving,NA
225,224,Luke Donald,2,378,232,146,2007,total_driving,NA
226,226,Bo Van Pelt,7,387,155,232,2007,total_driving,NA
227,225,Davis Love III,3,400,172,228,2007,total_driving,NA
228,228,Arjun Atwal,5,404,173,231,2007,total_driving,NA
T229,231,Daniel Chopra,3,411,157,254,2007,total_driving,NA
T229,227,Kevin Stadler,6,411,217,194,2007,total_driving,NA
231,229,John Rollins,4,414,209,205,2007,total_driving,NA
232,230,Parker McLachlin,4,421,201,220,2007,total_driving,NA
233,232,Peter Malnati,9,422,197,225,2007,total_driving,NA
234,233,Michael Kim,8,435,211,224,2007,total_driving,NA
235,235,Tommy Gainey,4,442,209,233,2007,total_driving,NA
236,234,D.A. Points,4,446,226,220,2007,total_driving,NA
237,236,Ricky Barnes,6,451,214,237,2007,total_driving,NA
238,237,Brendon de Jonge,3,462,205,257,2007,total_driving,NA
239,238,Shugo Imahira,2,490,235,255,2007,total_driving,NA
1,1,Andrew Novak,2,35,17,18,2008,total_driving,NA
2,3,Viktor Hovland,4,63,16,47,2008,total_driving,NA
3,4,Chase Koepka,2,72,34,38,2008,total_driving,NA
4,5,John Oda,2,74,70,4,2008,total_driving,NA
5,6,D.J. Trahan,7,91,47,44,2008,total_driving,NA
6,8,Gary Woodland,4,98,94,4,2008,total_driving,NA
7,9,Branden Grace,4,99,21,78,2008,total_driving,NA
T8,10,Patrick Cantlay,3,103,86,17,2008,total_driving,NA
T8,7,Doc Redman,10,103,77,26,2008,total_driving,NA
10,2,Ryan Moore,5,105,94,11,2008,total_driving,NA
11,13,Scottie Scheffler,8,126,15,111,2008,total_driving,NA
12,T19,Kyoung-Hoon Lee,10,128,106,22,2008,total_driving,NA
13,14,Martin Laird,8,129,42,87,2008,total_driving,NA
14,11,Kevin Streelman,9,130,62,68,2008,total_driving,NA
15,25,Jhonattan Vegas,6,132,24,108,2008,total_driving,NA
T16,15,Nick Taylor,8,133,109,24,2008,total_driving,NA
T16,T23,Brendan Steele,8,133,63,70,2008,total_driving,NA
18,12,Harris English,7,135,36,99,2008,total_driving,NA
T19,T27,Harry Higgs,10,140,79,61,2008,total_driving,NA
T19,T27,Sung Kang,7,140,53,87,2008,total_driving,NA
T21,22,Emiliano Grillo,7,142,110,32,2008,total_driving,NA
T21,18,Bubba Watson,4,142,1,141,2008,total_driving,NA
23,T19,Bryson DeChambeau,3,144,13,131,2008,total_driving,NA
24,T52,Matthew Wolff,5,145,40,105,2008,total_driving,NA
25,29,Joel Dahmen,8,149,100,49,2008,total_driving,NA
26,16,Jason Kokrak,5,153,8,145,2008,total_driving,NA
27,17,Josh Teater,6,156,83,73,2008,total_driving,NA
28,T23,Cameron Champ,7,157,2,155,2008,total_driving,NA
29,33,Ryan Palmer,5,160,146,14,2008,total_driving,NA
30,T35,Adam Hadwin,5,164,121,43,2008,total_driving,NA
31,26,Sungjae Im,8,165,50,115,2008,total_driving,NA
32,31,Henrik Norlander,10,168,132,36,2008,total_driving,NA
T33,38,Boo Weekley,5,169,147,22,2008,total_driving,NA
T33,T35,Harold Varner III,7,169,18,151,2008,total_driving,NA
35,37,Lanto Griffin,10,170,40,130,2008,total_driving,NA
36,T19,Lucas Glover,7,174,98,76,2008,total_driving,NA
37,34,Scott Brown,9,175,151,24,2008,total_driving,NA
38,T44,Sebastián Muñoz,10,176,60,116,2008,total_driving,NA
T39,40,Daniel Berger,6,177,56,121,2008,total_driving,NA
T39,42,Keegan Bradley,7,177,71,106,2008,total_driving,NA
41,39,Chesson Hadley,7,179,106,73,2008,total_driving,NA
42,43,Webb Simpson,3,182,170,12,2008,total_driving,NA
43,48,Danny Lee,7,185,9,176,2008,total_driving,NA
44,T50,Pat Perez,6,186,130,56,2008,total_driving,NA
45,T52,Matthew NeSmith,9,188,154,34,2008,total_driving,NA
46,T99,Sepp Straka,10,191,92,99,2008,total_driving,NA
T47,T90,Isaiah Salinda,3,192,14,178,2008,total_driving,NA
T47,T56,John Merrick,4,192,135,57,2008,total_driving,NA
T49,T50,Jim Furyk,3,193,192,1,2008,total_driving,NA
T49,55,Chad Campbell,4,193,178,15,2008,total_driving,NA
T49,T44,Wyndham Clark,7,193,32,161,2008,total_driving,NA
52,32,Alex Noren,4,195,108,87,2008,total_driving,NA
53,NA,Rickie Fowler,2,196,194,2,2008,total_driving,NA
T54,T56,Tony Finau,5,198,12,186,2008,total_driving,NA
T54,T62,Phil Mickelson,5,198,31,167,2008,total_driving,NA
T54,T62,Aaron Wise,7,198,51,147,2008,total_driving,NA
T54,T69,Chase Seiffert,9,198,127,71,2008,total_driving,NA
T58,T73,Abraham Ancer,8,199,113,86,2008,total_driving,NA
T58,61,Adam Schenk,10,199,33,166,2008,total_driving,NA
T58,T64,Scott Harrington,9,199,34,165,2008,total_driving,NA
T61,T52,Brian Harman,8,200,143,57,2008,total_driving,NA
T61,47,Jason Dufner,7,200,140,60,2008,total_driving,NA
T61,59,Cameron Smith,6,200,77,123,2008,total_driving,NA
T64,46,Kramer Hickok,9,201,124,77,2008,total_driving,NA
T64,60,Matt Jones,8,201,49,152,2008,total_driving,NA
66,30,Robby Shelton,10,202,88,114,2008,total_driving,NA
T67,83,Grayson Murray,6,203,4,199,2008,total_driving,NA
T67,T73,Russell Knox,8,203,138,65,2008,total_driving,NA
69,41,Denny McCarthy,8,204,101,103,2008,total_driving,NA
70,T80,Sam Ryder,10,209,53,156,2008,total_driving,NA
71,58,Brice Garnett,8,214,150,64,2008,total_driving,NA
72,66,Michael Thompson,7,215,175,40,2008,total_driving,NA
73,76,Collin Morikawa,6,216,168,48,2008,total_driving,NA
T74,T69,Derek Ernst,4,217,80,137,2008,total_driving,NA
T74,T67,Adam Long,10,217,189,28,2008,total_driving,NA
T74,96,Andrew Landry,9,217,171,46,2008,total_driving,NA
77,T84,Akshay Bhatia,5,218,7,211,2008,total_driving,NA
78,T69,Rod Pampling,3,220,28,192,2008,total_driving,NA
79,136,Nick Watney,7,222,73,149,2008,total_driving,NA
T80,T84,Hideki Matsuyama,6,223,115,108,2008,total_driving,NA
T80,115,Doug Ghim,7,223,116,107,2008,total_driving,NA
T80,T90,Kristoffer Ventura,9,223,44,179,2008,total_driving,NA
T83,T73,Byeong Hun An,8,225,10,215,2008,total_driving,NA
T83,T90,Chandler Phillips,2,225,57,168,2008,total_driving,NA
T83,T69,Brian Stuard,10,225,215,10,2008,total_driving,NA
T83,T97,Alex Cejka,5,225,175,50,2008,total_driving,NA
T83,T80,Ryan Armour,9,225,217,8,2008,total_driving,NA
T88,T90,Graham DeLaet,5,226,36,190,2008,total_driving,NA
T88,T77,Tim Wilkinson,6,226,189,37,2008,total_driving,NA
T88,T86,Brandon Wu,2,226,188,38,2008,total_driving,NA
T91,T88,Hank Lebioda,9,228,104,124,2008,total_driving,NA
T91,79,Charles Howell III,9,228,69,159,2008,total_driving,NA
93,T67,Tyler McCumber,9,229,11,218,2008,total_driving,NA
94,T90,Fabián Gómez,9,230,167,63,2008,total_driving,NA
95,T90,Brendon Todd,11,231,228,3,2008,total_driving,NA
T96,49,Cameron Percy,8,233,61,172,2008,total_driving,NA
T96,T99,Adam Scott,4,233,46,187,2008,total_driving,NA
T96,T80,Luke List,9,233,80,153,2008,total_driving,NA
T96,T86,Russell Henley,8,233,179,54,2008,total_driving,NA
T96,T130,Mackenzie Hughes,8,233,101,132,2008,total_driving,NA
101,T109,J.T. Poston,9,234,175,59,2008,total_driving,NA
102,T64,Vince Covello,8,235,73,162,2008,total_driving,NA
103,T99,Xinjun Zhang,10,236,116,120,2008,total_driving,NA
104,105,K.J. Choi,3,237,233,4,2008,total_driving,NA
T105,107,Tim Herron,4,238,220,18,2008,total_driving,NA
T105,T109,Corey Conners,7,238,186,52,2008,total_driving,NA
T107,108,Keith Mitchell,7,239,135,104,2008,total_driving,NA
T107,T130,Cameron Davis,8,239,22,217,2008,total_driving,NA
T107,T99,Richy Werenski,4,239,45,194,2008,total_driving,NA
T107,T88,Vaughn Taylor,8,239,212,27,2008,total_driving,NA
111,168,Chris Baker,9,240,168,72,2008,total_driving,NA
T112,T112,Jim Herman,8,241,221,20,2008,total_driving,NA
T112,T127,Scott Piercy,8,241,105,136,2008,total_driving,NA
T114,T120,J.J. Henry,5,242,173,69,2008,total_driving,NA
T114,T103,Tyler Duncan,10,242,221,21,2008,total_driving,NA
116,T112,Davis Riley,2,243,83,160,2008,total_driving,NA
T117,T125,Bo Hoag,10,244,127,117,2008,total_driving,NA
T117,T116,Chez Reavie,9,244,228,16,2008,total_driving,NA
119,T116,Matt Kuchar,4,245,238,7,2008,total_driving,NA
T120,223,Paul Casey,4,247,160,87,2008,total_driving,NA
T120,T116,Satoshi Kodaira,6,247,234,13,2008,total_driving,NA
T120,T127,Shawn Stefani,6,247,73,174,2008,total_driving,NA
123,106,Carlos Ortiz,8,248,67,181,2008,total_driving,NA
124,T122,Ben Crane,6,249,207,42,2008,total_driving,NA
125,T130,Tom Lewis,3,252,5,247,2008,total_driving,NA
126,T139,Michael Gligic,9,253,73,180,2008,total_driving,NA
T127,T139,Scott Stallings,8,254,47,207,2008,total_driving,NA
T127,T137,Kyle Stanley,8,254,213,41,2008,total_driving,NA
T129,T137,Henrik Stenson,2,255,202,53,2008,total_driving,NA
T129,T125,Austin Cook,8,255,127,128,2008,total_driving,NA
T131,T120,Beau Hossler,8,256,29,227,2008,total_driving,NA
T131,T122,Patrick Rodgers,10,256,26,230,2008,total_driving,NA
T131,T143,Sebastian Cappelen,8,256,30,226,2008,total_driving,NA
T131,T133,Kurt Kitayama,2,256,3,253,2008,total_driving,NA
T131,T77,Vincent Whaley,7,256,103,153,2008,total_driving,NA
T131,T141,Ryan Brehm,10,256,6,250,2008,total_driving,NA
137,T122,Mark Hubbard,10,257,149,108,2008,total_driving,NA
T138,T163,Brandon Hagy,8,258,22,236,2008,total_driving,NA
T138,T109,Billy Horschel,6,258,196,62,2008,total_driving,NA
T140,T147,Sam Burns,6,259,20,239,2008,total_driving,NA
T140,T133,David Lingmerth,5,259,230,29,2008,total_driving,NA
T142,T187,Bud Cauley,6,262,125,137,2008,total_driving,NA
T142,T143,Cameron Tringale,7,262,55,207,2008,total_driving,NA
144,T143,Rikuya Hoshino,2,264,138,126,2008,total_driving,NA
145,T155,Jonathan Byrd,5,265,72,193,2008,total_driving,NA
T146,T116,Maverick McNealy,9,266,89,177,2008,total_driving,NA
T146,T147,Xander Schauffele,3,266,231,35,2008,total_driving,NA
T148,154,Whee Kim,2,267,180,87,2008,total_driving,NA
T148,T141,Lucas Bjerregaard,3,267,18,249,2008,total_driving,NA
150,T152,Chip McDaniel,2,268,59,209,2008,total_driving,NA
T151,T178,Max Homa,6,269,187,82,2008,total_driving,NA
T151,T112,Bill Haas,6,269,147,122,2008,total_driving,NA
T151,146,J.B. Holmes,3,269,224,45,2008,total_driving,NA
T154,129,Zack Sucher,6,270,24,246,2008,total_driving,NA
T154,T157,Roberto Castro,5,270,183,87,2008,total_driving,NA
156,151,Kevin Tway,6,271,27,244,2008,total_driving,NA
T157,T155,Kevin Chappell,6,272,43,229,2008,total_driving,NA
T157,T152,Dominic Bozzelli,7,272,38,234,2008,total_driving,NA
T159,T147,David Hearn,9,273,206,67,2008,total_driving,NA
T159,174,Jimmy Walker,4,273,92,181,2008,total_driving,NA
161,165,Sangmoon Bae,6,274,64,210,2008,total_driving,NA
162,167,Michael Gellerman,8,275,135,140,2008,total_driving,NA
163,T159,Kevin Kisner,7,277,227,50,2008,total_driving,NA
T164,T159,Justin Thomas,5,278,161,117,2008,total_driving,NA
T164,T187,Troy Merritt,7,278,182,96,2008,total_driving,NA
T164,T163,Freddie Jacobson,3,278,141,137,2008,total_driving,NA
167,T175,Talor Gooch,8,280,122,158,2008,total_driving,NA
168,T103,Andrew Putnam,6,283,181,102,2008,total_driving,NA
T169,T157,Si Woo Kim,8,284,99,185,2008,total_driving,NA
T169,T97,Charley Hoffman,7,284,87,197,2008,total_driving,NA
T169,169,Seamus Power,5,284,83,201,2008,total_driving,NA
172,T133,John Huh,5,285,166,119,2008,total_driving,NA
T173,T172,Jason Day,3,286,80,206,2008,total_driving,NA
T173,T172,Chris Kirk,3,286,199,87,2008,total_driving,NA
T173,T175,Rafael Campos,9,286,67,219,2008,total_driving,NA
176,T159,Nate Lashley,8,287,204,83,2008,total_driving,NA
177,177,Brandt Snedeker,4,288,155,133,2008,total_driving,NA
178,T178,Peter Uihlein,6,289,38,251,2008,total_driving,NA
179,150,Kevin Na,7,290,203,87,2008,total_driving,NA
180,T170,Ben Taylor,10,291,134,157,2008,total_driving,NA
181,162,Anirban Lahiri,8,292,118,174,2008,total_driving,NA
182,T208,Roger Sloan,8,293,158,135,2008,total_driving,NA
T183,182,Johnson Wagner,5,294,207,87,2008,total_driving,NA
T183,T183,Robert Garrigus,5,294,52,242,2008,total_driving,NA
T183,T187,Wes Roach,7,294,151,143,2008,total_driving,NA
186,181,Zach Johnson,7,299,216,83,2008,total_driving,NA
187,191,Mikumu Horikawa,3,303,237,66,2008,total_driving,NA
T188,194,Will Gordon,4,304,64,240,2008,total_driving,NA
T188,210,Rory Sabbatini,7,304,219,85,2008,total_driving,NA
T188,T183,Dylan Frittelli,9,304,193,111,2008,total_driving,NA
191,185,Nelson Ledesma,10,305,57,248,2008,total_driving,NA
192,192,Marc Leishman,5,306,90,216,2008,total_driving,NA
193,166,Joseph Bramlett,7,307,94,213,2008,total_driving,NA
194,195,Joaquin Niemann,8,308,164,144,2008,total_driving,NA
T195,T196,Graeme McDowell,5,311,236,75,2008,total_driving,NA
T195,T201,Bronson Burgoon,8,311,130,181,2008,total_driving,NA
197,T187,Brian Gay,9,312,162,150,2008,total_driving,NA
198,193,Rhein Gibson,9,313,90,223,2008,total_driving,NA
199,T196,Tom Hoge,8,314,185,129,2008,total_driving,NA
200,200,Mark Anderson,7,319,132,187,2008,total_driving,NA
201,204,Smylie Kaufman,3,320,64,256,2008,total_driving,NA
T202,199,Zac Blair,10,322,225,97,2008,total_driving,NA
T202,214,Francesco Molinari,3,322,125,197,2008,total_driving,NA
T204,T170,John Senden,5,324,120,204,2008,total_driving,NA
T204,180,Ben Martin,6,324,223,101,2008,total_driving,NA
T206,T205,James Hahn,6,325,163,162,2008,total_driving,NA
T206,186,Aaron Baddeley,6,325,198,127,2008,total_driving,NA
208,T211,J.J. Spaun,9,330,118,212,2008,total_driving,NA
T209,203,Robert Streb,9,332,141,191,2008,total_driving,NA
T209,T208,Robert Allenby,3,332,164,168,2008,total_driving,NA
211,T211,Martin Trainer,8,339,94,245,2008,total_driving,NA
212,T205,"Ted Potter, Jr.",7,340,151,189,2008,total_driving,NA
213,T201,Chris Stroud,6,341,194,147,2008,total_driving,NA
T214,T205,Rob Oppenheim,10,342,200,142,2008,total_driving,NA
T214,198,Matt Every,7,342,122,220,2008,total_driving,NA
T214,213,Morgan Hoffmann,4,342,143,199,2008,total_driving,NA
217,215,Roberto Díaz,2,345,110,235,2008,total_driving,NA
218,216,Stewart Cink,4,350,112,238,2008,total_driving,NA
219,217,C.T. Pan,5,353,189,164,2008,total_driving,NA
220,T218,Patton Kizzire,9,354,158,196,2008,total_driving,NA
221,222,Hudson Swafford,4,356,183,173,2008,total_driving,NA
222,T218,George McNeill,6,359,145,214,2008,total_driving,NA
223,220,Patrick Reed,4,363,239,124,2008,total_driving,NA
224,221,Jamie Lovemark,4,365,114,251,2008,total_driving,NA
225,224,Luke Donald,2,378,232,146,2008,total_driving,NA
226,226,Bo Van Pelt,7,387,155,232,2008,total_driving,NA
227,225,Davis Love III,3,400,172,228,2008,total_driving,NA
228,228,Arjun Atwal,5,404,173,231,2008,total_driving,NA
T229,231,Daniel Chopra,3,411,157,254,2008,total_driving,NA
T229,227,Kevin Stadler,6,411,217,194,2008,total_driving,NA
231,229,John Rollins,4,414,209,205,2008,total_driving,NA
232,230,Parker McLachlin,4,421,201,220,2008,total_driving,NA
233,232,Peter Malnati,9,422,197,225,2008,total_driving,NA
234,233,Michael Kim,8,435,211,224,2008,total_driving,NA
235,235,Tommy Gainey,4,442,209,233,2008,total_driving,NA
236,234,D.A. Points,4,446,226,220,2008,total_driving,NA
237,236,Ricky Barnes,6,451,214,237,2008,total_driving,NA
238,237,Brendon de Jonge,3,462,205,257,2008,total_driving,NA
239,238,Shugo Imahira,2,490,235,255,2008,total_driving,NA
1,1,Andrew Novak,2,35,17,18,2009,total_driving,NA
2,3,Viktor Hovland,4,63,16,47,2009,total_driving,NA
3,4,Chase Koepka,2,72,34,38,2009,total_driving,NA
4,5,John Oda,2,74,70,4,2009,total_driving,NA
5,6,D.J. Trahan,7,91,47,44,2009,total_driving,NA
6,8,Gary Woodland,4,98,94,4,2009,total_driving,NA
7,9,Branden Grace,4,99,21,78,2009,total_driving,NA
T8,10,Patrick Cantlay,3,103,86,17,2009,total_driving,NA
T8,7,Doc Redman,10,103,77,26,2009,total_driving,NA
10,2,Ryan Moore,5,105,94,11,2009,total_driving,NA
11,13,Scottie Scheffler,8,126,15,111,2009,total_driving,NA
12,T19,Kyoung-Hoon Lee,10,128,106,22,2009,total_driving,NA
13,14,Martin Laird,8,129,42,87,2009,total_driving,NA
14,11,Kevin Streelman,9,130,62,68,2009,total_driving,NA
15,25,Jhonattan Vegas,6,132,24,108,2009,total_driving,NA
T16,15,Nick Taylor,8,133,109,24,2009,total_driving,NA
T16,T23,Brendan Steele,8,133,63,70,2009,total_driving,NA
18,12,Harris English,7,135,36,99,2009,total_driving,NA
T19,T27,Harry Higgs,10,140,79,61,2009,total_driving,NA
T19,T27,Sung Kang,7,140,53,87,2009,total_driving,NA
T21,22,Emiliano Grillo,7,142,110,32,2009,total_driving,NA
T21,18,Bubba Watson,4,142,1,141,2009,total_driving,NA
23,T19,Bryson DeChambeau,3,144,13,131,2009,total_driving,NA
24,T52,Matthew Wolff,5,145,40,105,2009,total_driving,NA
25,29,Joel Dahmen,8,149,100,49,2009,total_driving,NA
26,16,Jason Kokrak,5,153,8,145,2009,total_driving,NA
27,17,Josh Teater,6,156,83,73,2009,total_driving,NA
28,T23,Cameron Champ,7,157,2,155,2009,total_driving,NA
29,33,Ryan Palmer,5,160,146,14,2009,total_driving,NA
30,T35,Adam Hadwin,5,164,121,43,2009,total_driving,NA
31,26,Sungjae Im,8,165,50,115,2009,total_driving,NA
32,31,Henrik Norlander,10,168,132,36,2009,total_driving,NA
T33,38,Boo Weekley,5,169,147,22,2009,total_driving,NA
T33,T35,Harold Varner III,7,169,18,151,2009,total_driving,NA
35,37,Lanto Griffin,10,170,40,130,2009,total_driving,NA
36,T19,Lucas Glover,7,174,98,76,2009,total_driving,NA
37,34,Scott Brown,9,175,151,24,2009,total_driving,NA
38,T44,Sebastián Muñoz,10,176,60,116,2009,total_driving,NA
T39,40,Daniel Berger,6,177,56,121,2009,total_driving,NA
T39,42,Keegan Bradley,7,177,71,106,2009,total_driving,NA
41,39,Chesson Hadley,7,179,106,73,2009,total_driving,NA
42,43,Webb Simpson,3,182,170,12,2009,total_driving,NA
43,48,Danny Lee,7,185,9,176,2009,total_driving,NA
44,T50,Pat Perez,6,186,130,56,2009,total_driving,NA
45,T52,Matthew NeSmith,9,188,154,34,2009,total_driving,NA
46,T99,Sepp Straka,10,191,92,99,2009,total_driving,NA
T47,T90,Isaiah Salinda,3,192,14,178,2009,total_driving,NA
T47,T56,John Merrick,4,192,135,57,2009,total_driving,NA
T49,T50,Jim Furyk,3,193,192,1,2009,total_driving,NA
T49,55,Chad Campbell,4,193,178,15,2009,total_driving,NA
T49,T44,Wyndham Clark,7,193,32,161,2009,total_driving,NA
52,32,Alex Noren,4,195,108,87,2009,total_driving,NA
53,NA,Rickie Fowler,2,196,194,2,2009,total_driving,NA
T54,T56,Tony Finau,5,198,12,186,2009,total_driving,NA
T54,T62,Phil Mickelson,5,198,31,167,2009,total_driving,NA
T54,T62,Aaron Wise,7,198,51,147,2009,total_driving,NA
T54,T69,Chase Seiffert,9,198,127,71,2009,total_driving,NA
T58,T73,Abraham Ancer,8,199,113,86,2009,total_driving,NA
T58,61,Adam Schenk,10,199,33,166,2009,total_driving,NA
T58,T64,Scott Harrington,9,199,34,165,2009,total_driving,NA
T61,T52,Brian Harman,8,200,143,57,2009,total_driving,NA
T61,47,Jason Dufner,7,200,140,60,2009,total_driving,NA
T61,59,Cameron Smith,6,200,77,123,2009,total_driving,NA
T64,46,Kramer Hickok,9,201,124,77,2009,total_driving,NA
T64,60,Matt Jones,8,201,49,152,2009,total_driving,NA
66,30,Robby Shelton,10,202,88,114,2009,total_driving,NA
T67,83,Grayson Murray,6,203,4,199,2009,total_driving,NA
T67,T73,Russell Knox,8,203,138,65,2009,total_driving,NA
69,41,Denny McCarthy,8,204,101,103,2009,total_driving,NA
70,T80,Sam Ryder,10,209,53,156,2009,total_driving,NA
71,58,Brice Garnett,8,214,150,64,2009,total_driving,NA
72,66,Michael Thompson,7,215,175,40,2009,total_driving,NA
73,76,Collin Morikawa,6,216,168,48,2009,total_driving,NA
T74,T69,Derek Ernst,4,217,80,137,2009,total_driving,NA
T74,T67,Adam Long,10,217,189,28,2009,total_driving,NA
T74,96,Andrew Landry,9,217,171,46,2009,total_driving,NA
77,T84,Akshay Bhatia,5,218,7,211,2009,total_driving,NA
78,T69,Rod Pampling,3,220,28,192,2009,total_driving,NA
79,136,Nick Watney,7,222,73,149,2009,total_driving,NA
T80,T84,Hideki Matsuyama,6,223,115,108,2009,total_driving,NA
T80,115,Doug Ghim,7,223,116,107,2009,total_driving,NA
T80,T90,Kristoffer Ventura,9,223,44,179,2009,total_driving,NA
T83,T73,Byeong Hun An,8,225,10,215,2009,total_driving,NA
T83,T90,Chandler Phillips,2,225,57,168,2009,total_driving,NA
T83,T69,Brian Stuard,10,225,215,10,2009,total_driving,NA
T83,T97,Alex Cejka,5,225,175,50,2009,total_driving,NA
T83,T80,Ryan Armour,9,225,217,8,2009,total_driving,NA
T88,T90,Graham DeLaet,5,226,36,190,2009,total_driving,NA
T88,T77,Tim Wilkinson,6,226,189,37,2009,total_driving,NA
T88,T86,Brandon Wu,2,226,188,38,2009,total_driving,NA
T91,T88,Hank Lebioda,9,228,104,124,2009,total_driving,NA
T91,79,Charles Howell III,9,228,69,159,2009,total_driving,NA
93,T67,Tyler McCumber,9,229,11,218,2009,total_driving,NA
94,T90,Fabián Gómez,9,230,167,63,2009,total_driving,NA
95,T90,Brendon Todd,11,231,228,3,2009,total_driving,NA
T96,49,Cameron Percy,8,233,61,172,2009,total_driving,NA
T96,T99,Adam Scott,4,233,46,187,2009,total_driving,NA
T96,T80,Luke List,9,233,80,153,2009,total_driving,NA
T96,T86,Russell Henley,8,233,179,54,2009,total_driving,NA
T96,T130,Mackenzie Hughes,8,233,101,132,2009,total_driving,NA
101,T109,J.T. Poston,9,234,175,59,2009,total_driving,NA
102,T64,Vince Covello,8,235,73,162,2009,total_driving,NA
103,T99,Xinjun Zhang,10,236,116,120,2009,total_driving,NA
104,105,K.J. Choi,3,237,233,4,2009,total_driving,NA
T105,107,Tim Herron,4,238,220,18,2009,total_driving,NA
T105,T109,Corey Conners,7,238,186,52,2009,total_driving,NA
T107,108,Keith Mitchell,7,239,135,104,2009,total_driving,NA
T107,T130,Cameron Davis,8,239,22,217,2009,total_driving,NA
T107,T99,Richy Werenski,4,239,45,194,2009,total_driving,NA
T107,T88,Vaughn Taylor,8,239,212,27,2009,total_driving,NA
111,168,Chris Baker,9,240,168,72,2009,total_driving,NA
T112,T112,Jim Herman,8,241,221,20,2009,total_driving,NA
T112,T127,Scott Piercy,8,241,105,136,2009,total_driving,NA
T114,T120,J.J. Henry,5,242,173,69,2009,total_driving,NA
T114,T103,Tyler Duncan,10,242,221,21,2009,total_driving,NA
116,T112,Davis Riley,2,243,83,160,2009,total_driving,NA
T117,T125,Bo Hoag,10,244,127,117,2009,total_driving,NA
T117,T116,Chez Reavie,9,244,228,16,2009,total_driving,NA
119,T116,Matt Kuchar,4,245,238,7,2009,total_driving,NA
T120,223,Paul Casey,4,247,160,87,2009,total_driving,NA
T120,T116,Satoshi Kodaira,6,247,234,13,2009,total_driving,NA
T120,T127,Shawn Stefani,6,247,73,174,2009,total_driving,NA
123,106,Carlos Ortiz,8,248,67,181,2009,total_driving,NA
124,T122,Ben Crane,6,249,207,42,2009,total_driving,NA
125,T130,Tom Lewis,3,252,5,247,2009,total_driving,NA
126,T139,Michael Gligic,9,253,73,180,2009,total_driving,NA
T127,T139,Scott Stallings,8,254,47,207,2009,total_driving,NA
T127,T137,Kyle Stanley,8,254,213,41,2009,total_driving,NA
T129,T137,Henrik Stenson,2,255,202,53,2009,total_driving,NA
T129,T125,Austin Cook,8,255,127,128,2009,total_driving,NA
T131,T120,Beau Hossler,8,256,29,227,2009,total_driving,NA
T131,T122,Patrick Rodgers,10,256,26,230,2009,total_driving,NA
T131,T143,Sebastian Cappelen,8,256,30,226,2009,total_driving,NA
T131,T133,Kurt Kitayama,2,256,3,253,2009,total_driving,NA
T131,T77,Vincent Whaley,7,256,103,153,2009,total_driving,NA
T131,T141,Ryan Brehm,10,256,6,250,2009,total_driving,NA
137,T122,Mark Hubbard,10,257,149,108,2009,total_driving,NA
T138,T163,Brandon Hagy,8,258,22,236,2009,total_driving,NA
T138,T109,Billy Horschel,6,258,196,62,2009,total_driving,NA
T140,T147,Sam Burns,6,259,20,239,2009,total_driving,NA
T140,T133,David Lingmerth,5,259,230,29,2009,total_driving,NA
T142,T187,Bud Cauley,6,262,125,137,2009,total_driving,NA
T142,T143,Cameron Tringale,7,262,55,207,2009,total_driving,NA
144,T143,Rikuya Hoshino,2,264,138,126,2009,total_driving,NA
145,T155,Jonathan Byrd,5,265,72,193,2009,total_driving,NA
T146,T116,Maverick McNealy,9,266,89,177,2009,total_driving,NA
T146,T147,Xander Schauffele,3,266,231,35,2009,total_driving,NA
T148,154,Whee Kim,2,267,180,87,2009,total_driving,NA
T148,T141,Lucas Bjerregaard,3,267,18,249,2009,total_driving,NA
150,T152,Chip McDaniel,2,268,59,209,2009,total_driving,NA
T151,T178,Max Homa,6,269,187,82,2009,total_driving,NA
T151,T112,Bill Haas,6,269,147,122,2009,total_driving,NA
T151,146,J.B. Holmes,3,269,224,45,2009,total_driving,NA
T154,129,Zack Sucher,6,270,24,246,2009,total_driving,NA
T154,T157,Roberto Castro,5,270,183,87,2009,total_driving,NA
156,151,Kevin Tway,6,271,27,244,2009,total_driving,NA
T157,T155,Kevin Chappell,6,272,43,229,2009,total_driving,NA
T157,T152,Dominic Bozzelli,7,272,38,234,2009,total_driving,NA
T159,T147,David Hearn,9,273,206,67,2009,total_driving,NA
T159,174,Jimmy Walker,4,273,92,181,2009,total_driving,NA
161,165,Sangmoon Bae,6,274,64,210,2009,total_driving,NA
162,167,Michael Gellerman,8,275,135,140,2009,total_driving,NA
163,T159,Kevin Kisner,7,277,227,50,2009,total_driving,NA
T164,T159,Justin Thomas,5,278,161,117,2009,total_driving,NA
T164,T187,Troy Merritt,7,278,182,96,2009,total_driving,NA
T164,T163,Freddie Jacobson,3,278,141,137,2009,total_driving,NA
167,T175,Talor Gooch,8,280,122,158,2009,total_driving,NA
168,T103,Andrew Putnam,6,283,181,102,2009,total_driving,NA
T169,T157,Si Woo Kim,8,284,99,185,2009,total_driving,NA
T169,T97,Charley Hoffman,7,284,87,197,2009,total_driving,NA
T169,169,Seamus Power,5,284,83,201,2009,total_driving,NA
172,T133,John Huh,5,285,166,119,2009,total_driving,NA
T173,T172,Jason Day,3,286,80,206,2009,total_driving,NA
T173,T172,Chris Kirk,3,286,199,87,2009,total_driving,NA
T173,T175,Rafael Campos,9,286,67,219,2009,total_driving,NA
176,T159,Nate Lashley,8,287,204,83,2009,total_driving,NA
177,177,Brandt Snedeker,4,288,155,133,2009,total_driving,NA
178,T178,Peter Uihlein,6,289,38,251,2009,total_driving,NA
179,150,Kevin Na,7,290,203,87,2009,total_driving,NA
180,T170,Ben Taylor,10,291,134,157,2009,total_driving,NA
181,162,Anirban Lahiri,8,292,118,174,2009,total_driving,NA
182,T208,Roger Sloan,8,293,158,135,2009,total_driving,NA
T183,182,Johnson Wagner,5,294,207,87,2009,total_driving,NA
T183,T183,Robert Garrigus,5,294,52,242,2009,total_driving,NA
T183,T187,Wes Roach,7,294,151,143,2009,total_driving,NA
186,181,Zach Johnson,7,299,216,83,2009,total_driving,NA
187,191,Mikumu Horikawa,3,303,237,66,2009,total_driving,NA
T188,194,Will Gordon,4,304,64,240,2009,total_driving,NA
T188,210,Rory Sabbatini,7,304,219,85,2009,total_driving,NA
T188,T183,Dylan Frittelli,9,304,193,111,2009,total_driving,NA
191,185,Nelson Ledesma,10,305,57,248,2009,total_driving,NA
192,192,Marc Leishman,5,306,90,216,2009,total_driving,NA
193,166,Joseph Bramlett,7,307,94,213,2009,total_driving,NA
194,195,Joaquin Niemann,8,308,164,144,2009,total_driving,NA
T195,T196,Graeme McDowell,5,311,236,75,2009,total_driving,NA
T195,T201,Bronson Burgoon,8,311,130,181,2009,total_driving,NA
197,T187,Brian Gay,9,312,162,150,2009,total_driving,NA
198,193,Rhein Gibson,9,313,90,223,2009,total_driving,NA
199,T196,Tom Hoge,8,314,185,129,2009,total_driving,NA
200,200,Mark Anderson,7,319,132,187,2009,total_driving,NA
201,204,Smylie Kaufman,3,320,64,256,2009,total_driving,NA
T202,199,Zac Blair,10,322,225,97,2009,total_driving,NA
T202,214,Francesco Molinari,3,322,125,197,2009,total_driving,NA
T204,T170,John Senden,5,324,120,204,2009,total_driving,NA
T204,180,Ben Martin,6,324,223,101,2009,total_driving,NA
T206,T205,James Hahn,6,325,163,162,2009,total_driving,NA
T206,186,Aaron Baddeley,6,325,198,127,2009,total_driving,NA
208,T211,J.J. Spaun,9,330,118,212,2009,total_driving,NA
T209,203,Robert Streb,9,332,141,191,2009,total_driving,NA
T209,T208,Robert Allenby,3,332,164,168,2009,total_driving,NA
211,T211,Martin Trainer,8,339,94,245,2009,total_driving,NA
212,T205,"Ted Potter, Jr.",7,340,151,189,2009,total_driving,NA
213,T201,Chris Stroud,6,341,194,147,2009,total_driving,NA
T214,T205,Rob Oppenheim,10,342,200,142,2009,total_driving,NA
T214,198,Matt Every,7,342,122,220,2009,total_driving,NA
T214,213,Morgan Hoffmann,4,342,143,199,2009,total_driving,NA
217,215,Roberto Díaz,2,345,110,235,2009,total_driving,NA
218,216,Stewart Cink,4,350,112,238,2009,total_driving,NA
219,217,C.T. Pan,5,353,189,164,2009,total_driving,NA
220,T218,Patton Kizzire,9,354,158,196,2009,total_driving,NA
221,222,Hudson Swafford,4,356,183,173,2009,total_driving,NA
222,T218,George McNeill,6,359,145,214,2009,total_driving,NA
223,220,Patrick Reed,4,363,239,124,2009,total_driving,NA
224,221,Jamie Lovemark,4,365,114,251,2009,total_driving,NA
225,224,Luke Donald,2,378,232,146,2009,total_driving,NA
226,226,Bo Van Pelt,7,387,155,232,2009,total_driving,NA
227,225,Davis Love III,3,400,172,228,2009,total_driving,NA
228,228,Arjun Atwal,5,404,173,231,2009,total_driving,NA
T229,231,Daniel Chopra,3,411,157,254,2009,total_driving,NA
T229,227,Kevin Stadler,6,411,217,194,2009,total_driving,NA
231,229,John Rollins,4,414,209,205,2009,total_driving,NA
232,230,Parker McLachlin,4,421,201,220,2009,total_driving,NA
233,232,Peter Malnati,9,422,197,225,2009,total_driving,NA
234,233,Michael Kim,8,435,211,224,2009,total_driving,NA
235,235,Tommy Gainey,4,442,209,233,2009,total_driving,NA
236,234,D.A. Points,4,446,226,220,2009,total_driving,NA
237,236,Ricky Barnes,6,451,214,237,2009,total_driving,NA
238,237,Brendon de Jonge,3,462,205,257,2009,total_driving,NA
239,238,Shugo Imahira,2,490,235,255,2009,total_driving,NA
1,1,Andrew Novak,2,35,17,18,2010,total_driving,NA
2,3,Viktor Hovland,4,63,16,47,2010,total_driving,NA
3,4,Chase Koepka,2,72,34,38,2010,total_driving,NA
4,5,John Oda,2,74,70,4,2010,total_driving,NA
5,6,D.J. Trahan,7,91,47,44,2010,total_driving,NA
6,8,Gary Woodland,4,98,94,4,2010,total_driving,NA
7,9,Branden Grace,4,99,21,78,2010,total_driving,NA
T8,10,Patrick Cantlay,3,103,86,17,2010,total_driving,NA
T8,7,Doc Redman,10,103,77,26,2010,total_driving,NA
10,2,Ryan Moore,5,105,94,11,2010,total_driving,NA
11,13,Scottie Scheffler,8,126,15,111,2010,total_driving,NA
12,T19,Kyoung-Hoon Lee,10,128,106,22,2010,total_driving,NA
13,14,Martin Laird,8,129,42,87,2010,total_driving,NA
14,11,Kevin Streelman,9,130,62,68,2010,total_driving,NA
15,25,Jhonattan Vegas,6,132,24,108,2010,total_driving,NA
T16,15,Nick Taylor,8,133,109,24,2010,total_driving,NA
T16,T23,Brendan Steele,8,133,63,70,2010,total_driving,NA
18,12,Harris English,7,135,36,99,2010,total_driving,NA
T19,T27,Harry Higgs,10,140,79,61,2010,total_driving,NA
T19,T27,Sung Kang,7,140,53,87,2010,total_driving,NA
T21,22,Emiliano Grillo,7,142,110,32,2010,total_driving,NA
T21,18,Bubba Watson,4,142,1,141,2010,total_driving,NA
23,T19,Bryson DeChambeau,3,144,13,131,2010,total_driving,NA
24,T52,Matthew Wolff,5,145,40,105,2010,total_driving,NA
25,29,Joel Dahmen,8,149,100,49,2010,total_driving,NA
26,16,Jason Kokrak,5,153,8,145,2010,total_driving,NA
27,17,Josh Teater,6,156,83,73,2010,total_driving,NA
28,T23,Cameron Champ,7,157,2,155,2010,total_driving,NA
29,33,Ryan Palmer,5,160,146,14,2010,total_driving,NA
30,T35,Adam Hadwin,5,164,121,43,2010,total_driving,NA
31,26,Sungjae Im,8,165,50,115,2010,total_driving,NA
32,31,Henrik Norlander,10,168,132,36,2010,total_driving,NA
T33,38,Boo Weekley,5,169,147,22,2010,total_driving,NA
T33,T35,Harold Varner III,7,169,18,151,2010,total_driving,NA
35,37,Lanto Griffin,10,170,40,130,2010,total_driving,NA
36,T19,Lucas Glover,7,174,98,76,2010,total_driving,NA
37,34,Scott Brown,9,175,151,24,2010,total_driving,NA
38,T44,Sebastián Muñoz,10,176,60,116,2010,total_driving,NA
T39,40,Daniel Berger,6,177,56,121,2010,total_driving,NA
T39,42,Keegan Bradley,7,177,71,106,2010,total_driving,NA
41,39,Chesson Hadley,7,179,106,73,2010,total_driving,NA
42,43,Webb Simpson,3,182,170,12,2010,total_driving,NA
43,48,Danny Lee,7,185,9,176,2010,total_driving,NA
44,T50,Pat Perez,6,186,130,56,2010,total_driving,NA
45,T52,Matthew NeSmith,9,188,154,34,2010,total_driving,NA
46,T99,Sepp Straka,10,191,92,99,2010,total_driving,NA
T47,T90,Isaiah Salinda,3,192,14,178,2010,total_driving,NA
T47,T56,John Merrick,4,192,135,57,2010,total_driving,NA
T49,T50,Jim Furyk,3,193,192,1,2010,total_driving,NA
T49,55,Chad Campbell,4,193,178,15,2010,total_driving,NA
T49,T44,Wyndham Clark,7,193,32,161,2010,total_driving,NA
52,32,Alex Noren,4,195,108,87,2010,total_driving,NA
53,NA,Rickie Fowler,2,196,194,2,2010,total_driving,NA
T54,T56,Tony Finau,5,198,12,186,2010,total_driving,NA
T54,T62,Phil Mickelson,5,198,31,167,2010,total_driving,NA
T54,T62,Aaron Wise,7,198,51,147,2010,total_driving,NA
T54,T69,Chase Seiffert,9,198,127,71,2010,total_driving,NA
T58,T73,Abraham Ancer,8,199,113,86,2010,total_driving,NA
T58,61,Adam Schenk,10,199,33,166,2010,total_driving,NA
T58,T64,Scott Harrington,9,199,34,165,2010,total_driving,NA
T61,T52,Brian Harman,8,200,143,57,2010,total_driving,NA
T61,47,Jason Dufner,7,200,140,60,2010,total_driving,NA
T61,59,Cameron Smith,6,200,77,123,2010,total_driving,NA
T64,46,Kramer Hickok,9,201,124,77,2010,total_driving,NA
T64,60,Matt Jones,8,201,49,152,2010,total_driving,NA
66,30,Robby Shelton,10,202,88,114,2010,total_driving,NA
T67,83,Grayson Murray,6,203,4,199,2010,total_driving,NA
T67,T73,Russell Knox,8,203,138,65,2010,total_driving,NA
69,41,Denny McCarthy,8,204,101,103,2010,total_driving,NA
70,T80,Sam Ryder,10,209,53,156,2010,total_driving,NA
71,58,Brice Garnett,8,214,150,64,2010,total_driving,NA
72,66,Michael Thompson,7,215,175,40,2010,total_driving,NA
73,76,Collin Morikawa,6,216,168,48,2010,total_driving,NA
T74,T69,Derek Ernst,4,217,80,137,2010,total_driving,NA
T74,T67,Adam Long,10,217,189,28,2010,total_driving,NA
T74,96,Andrew Landry,9,217,171,46,2010,total_driving,NA
77,T84,Akshay Bhatia,5,218,7,211,2010,total_driving,NA
78,T69,Rod Pampling,3,220,28,192,2010,total_driving,NA
79,136,Nick Watney,7,222,73,149,2010,total_driving,NA
T80,T84,Hideki Matsuyama,6,223,115,108,2010,total_driving,NA
T80,115,Doug Ghim,7,223,116,107,2010,total_driving,NA
T80,T90,Kristoffer Ventura,9,223,44,179,2010,total_driving,NA
T83,T73,Byeong Hun An,8,225,10,215,2010,total_driving,NA
T83,T90,Chandler Phillips,2,225,57,168,2010,total_driving,NA
T83,T69,Brian Stuard,10,225,215,10,2010,total_driving,NA
T83,T97,Alex Cejka,5,225,175,50,2010,total_driving,NA
T83,T80,Ryan Armour,9,225,217,8,2010,total_driving,NA
T88,T90,Graham DeLaet,5,226,36,190,2010,total_driving,NA
T88,T77,Tim Wilkinson,6,226,189,37,2010,total_driving,NA
T88,T86,Brandon Wu,2,226,188,38,2010,total_driving,NA
T91,T88,Hank Lebioda,9,228,104,124,2010,total_driving,NA
T91,79,Charles Howell III,9,228,69,159,2010,total_driving,NA
93,T67,Tyler McCumber,9,229,11,218,2010,total_driving,NA
94,T90,Fabián Gómez,9,230,167,63,2010,total_driving,NA
95,T90,Brendon Todd,11,231,228,3,2010,total_driving,NA
T96,49,Cameron Percy,8,233,61,172,2010,total_driving,NA
T96,T99,Adam Scott,4,233,46,187,2010,total_driving,NA
T96,T80,Luke List,9,233,80,153,2010,total_driving,NA
T96,T86,Russell Henley,8,233,179,54,2010,total_driving,NA
T96,T130,Mackenzie Hughes,8,233,101,132,2010,total_driving,NA
101,T109,J.T. Poston,9,234,175,59,2010,total_driving,NA
102,T64,Vince Covello,8,235,73,162,2010,total_driving,NA
103,T99,Xinjun Zhang,10,236,116,120,2010,total_driving,NA
104,105,K.J. Choi,3,237,233,4,2010,total_driving,NA
T105,107,Tim Herron,4,238,220,18,2010,total_driving,NA
T105,T109,Corey Conners,7,238,186,52,2010,total_driving,NA
T107,108,Keith Mitchell,7,239,135,104,2010,total_driving,NA
T107,T130,Cameron Davis,8,239,22,217,2010,total_driving,NA
T107,T99,Richy Werenski,4,239,45,194,2010,total_driving,NA
T107,T88,Vaughn Taylor,8,239,212,27,2010,total_driving,NA
111,168,Chris Baker,9,240,168,72,2010,total_driving,NA
T112,T112,Jim Herman,8,241,221,20,2010,total_driving,NA
T112,T127,Scott Piercy,8,241,105,136,2010,total_driving,NA
T114,T120,J.J. Henry,5,242,173,69,2010,total_driving,NA
T114,T103,Tyler Duncan,10,242,221,21,2010,total_driving,NA
116,T112,Davis Riley,2,243,83,160,2010,total_driving,NA
T117,T125,Bo Hoag,10,244,127,117,2010,total_driving,NA
T117,T116,Chez Reavie,9,244,228,16,2010,total_driving,NA
119,T116,Matt Kuchar,4,245,238,7,2010,total_driving,NA
T120,223,Paul Casey,4,247,160,87,2010,total_driving,NA
T120,T116,Satoshi Kodaira,6,247,234,13,2010,total_driving,NA
T120,T127,Shawn Stefani,6,247,73,174,2010,total_driving,NA
123,106,Carlos Ortiz,8,248,67,181,2010,total_driving,NA
124,T122,Ben Crane,6,249,207,42,2010,total_driving,NA
125,T130,Tom Lewis,3,252,5,247,2010,total_driving,NA
126,T139,Michael Gligic,9,253,73,180,2010,total_driving,NA
T127,T139,Scott Stallings,8,254,47,207,2010,total_driving,NA
T127,T137,Kyle Stanley,8,254,213,41,2010,total_driving,NA
T129,T137,Henrik Stenson,2,255,202,53,2010,total_driving,NA
T129,T125,Austin Cook,8,255,127,128,2010,total_driving,NA
T131,T120,Beau Hossler,8,256,29,227,2010,total_driving,NA
T131,T122,Patrick Rodgers,10,256,26,230,2010,total_driving,NA
T131,T143,Sebastian Cappelen,8,256,30,226,2010,total_driving,NA
T131,T133,Kurt Kitayama,2,256,3,253,2010,total_driving,NA
T131,T77,Vincent Whaley,7,256,103,153,2010,total_driving,NA
T131,T141,Ryan Brehm,10,256,6,250,2010,total_driving,NA
137,T122,Mark Hubbard,10,257,149,108,2010,total_driving,NA
T138,T163,Brandon Hagy,8,258,22,236,2010,total_driving,NA
T138,T109,Billy Horschel,6,258,196,62,2010,total_driving,NA
T140,T147,Sam Burns,6,259,20,239,2010,total_driving,NA
T140,T133,David Lingmerth,5,259,230,29,2010,total_driving,NA
T142,T187,Bud Cauley,6,262,125,137,2010,total_driving,NA
T142,T143,Cameron Tringale,7,262,55,207,2010,total_driving,NA
144,T143,Rikuya Hoshino,2,264,138,126,2010,total_driving,NA
145,T155,Jonathan Byrd,5,265,72,193,2010,total_driving,NA
T146,T116,Maverick McNealy,9,266,89,177,2010,total_driving,NA
T146,T147,Xander Schauffele,3,266,231,35,2010,total_driving,NA
T148,154,Whee Kim,2,267,180,87,2010,total_driving,NA
T148,T141,Lucas Bjerregaard,3,267,18,249,2010,total_driving,NA
150,T152,Chip McDaniel,2,268,59,209,2010,total_driving,NA
T151,T178,Max Homa,6,269,187,82,2010,total_driving,NA
T151,T112,Bill Haas,6,269,147,122,2010,total_driving,NA
T151,146,J.B. Holmes,3,269,224,45,2010,total_driving,NA
T154,129,Zack Sucher,6,270,24,246,2010,total_driving,NA
T154,T157,Roberto Castro,5,270,183,87,2010,total_driving,NA
156,151,Kevin Tway,6,271,27,244,2010,total_driving,NA
T157,T155,Kevin Chappell,6,272,43,229,2010,total_driving,NA
T157,T152,Dominic Bozzelli,7,272,38,234,2010,total_driving,NA
T159,T147,David Hearn,9,273,206,67,2010,total_driving,NA
T159,174,Jimmy Walker,4,273,92,181,2010,total_driving,NA
161,165,Sangmoon Bae,6,274,64,210,2010,total_driving,NA
162,167,Michael Gellerman,8,275,135,140,2010,total_driving,NA
163,T159,Kevin Kisner,7,277,227,50,2010,total_driving,NA
T164,T159,Justin Thomas,5,278,161,117,2010,total_driving,NA
T164,T187,Troy Merritt,7,278,182,96,2010,total_driving,NA
T164,T163,Freddie Jacobson,3,278,141,137,2010,total_driving,NA
167,T175,Talor Gooch,8,280,122,158,2010,total_driving,NA
168,T103,Andrew Putnam,6,283,181,102,2010,total_driving,NA
T169,T157,Si Woo Kim,8,284,99,185,2010,total_driving,NA
T169,T97,Charley Hoffman,7,284,87,197,2010,total_driving,NA
T169,169,Seamus Power,5,284,83,201,2010,total_driving,NA
172,T133,John Huh,5,285,166,119,2010,total_driving,NA
T173,T172,Jason Day,3,286,80,206,2010,total_driving,NA
T173,T172,Chris Kirk,3,286,199,87,2010,total_driving,NA
T173,T175,Rafael Campos,9,286,67,219,2010,total_driving,NA
176,T159,Nate Lashley,8,287,204,83,2010,total_driving,NA
177,177,Brandt Snedeker,4,288,155,133,2010,total_driving,NA
178,T178,Peter Uihlein,6,289,38,251,2010,total_driving,NA
179,150,Kevin Na,7,290,203,87,2010,total_driving,NA
180,T170,Ben Taylor,10,291,134,157,2010,total_driving,NA
181,162,Anirban Lahiri,8,292,118,174,2010,total_driving,NA
182,T208,Roger Sloan,8,293,158,135,2010,total_driving,NA
T183,182,Johnson Wagner,5,294,207,87,2010,total_driving,NA
T183,T183,Robert Garrigus,5,294,52,242,2010,total_driving,NA
T183,T187,Wes Roach,7,294,151,143,2010,total_driving,NA
186,181,Zach Johnson,7,299,216,83,2010,total_driving,NA
187,191,Mikumu Horikawa,3,303,237,66,2010,total_driving,NA
T188,194,Will Gordon,4,304,64,240,2010,total_driving,NA
T188,210,Rory Sabbatini,7,304,219,85,2010,total_driving,NA
T188,T183,Dylan Frittelli,9,304,193,111,2010,total_driving,NA
191,185,Nelson Ledesma,10,305,57,248,2010,total_driving,NA
192,192,Marc Leishman,5,306,90,216,2010,total_driving,NA
193,166,Joseph Bramlett,7,307,94,213,2010,total_driving,NA
194,195,Joaquin Niemann,8,308,164,144,2010,total_driving,NA
T195,T196,Graeme McDowell,5,311,236,75,2010,total_driving,NA
T195,T201,Bronson Burgoon,8,311,130,181,2010,total_driving,NA
197,T187,Brian Gay,9,312,162,150,2010,total_driving,NA
198,193,Rhein Gibson,9,313,90,223,2010,total_driving,NA
199,T196,Tom Hoge,8,314,185,129,2010,total_driving,NA
200,200,Mark Anderson,7,319,132,187,2010,total_driving,NA
201,204,Smylie Kaufman,3,320,64,256,2010,total_driving,NA
T202,199,Zac Blair,10,322,225,97,2010,total_driving,NA
T202,214,Francesco Molinari,3,322,125,197,2010,total_driving,NA
T204,T170,John Senden,5,324,120,204,2010,total_driving,NA
T204,180,Ben Martin,6,324,223,101,2010,total_driving,NA
T206,T205,James Hahn,6,325,163,162,2010,total_driving,NA
T206,186,Aaron Baddeley,6,325,198,127,2010,total_driving,NA
208,T211,J.J. Spaun,9,330,118,212,2010,total_driving,NA
T209,203,Robert Streb,9,332,141,191,2010,total_driving,NA
T209,T208,Robert Allenby,3,332,164,168,2010,total_driving,NA
211,T211,Martin Trainer,8,339,94,245,2010,total_driving,NA
212,T205,"Ted Potter, Jr.",7,340,151,189,2010,total_driving,NA
213,T201,Chris Stroud,6,341,194,147,2010,total_driving,NA
T214,T205,Rob Oppenheim,10,342,200,142,2010,total_driving,NA
T214,198,Matt Every,7,342,122,220,2010,total_driving,NA
T214,213,Morgan Hoffmann,4,342,143,199,2010,total_driving,NA
217,215,Roberto Díaz,2,345,110,235,2010,total_driving,NA
218,216,Stewart Cink,4,350,112,238,2010,total_driving,NA
219,217,C.T. Pan,5,353,189,164,2010,total_driving,NA
220,T218,Patton Kizzire,9,354,158,196,2010,total_driving,NA
221,222,Hudson Swafford,4,356,183,173,2010,total_driving,NA
222,T218,George McNeill,6,359,145,214,2010,total_driving,NA
223,220,Patrick Reed,4,363,239,124,2010,total_driving,NA
224,221,Jamie Lovemark,4,365,114,251,2010,total_driving,NA
225,224,Luke Donald,2,378,232,146,2010,total_driving,NA
226,226,Bo Van Pelt,7,387,155,232,2010,total_driving,NA
227,225,Davis Love III,3,400,172,228,2010,total_driving,NA
228,228,Arjun Atwal,5,404,173,231,2010,total_driving,NA
T229,231,Daniel Chopra,3,411,157,254,2010,total_driving,NA
T229,227,Kevin Stadler,6,411,217,194,2010,total_driving,NA
231,229,John Rollins,4,414,209,205,2010,total_driving,NA
232,230,Parker McLachlin,4,421,201,220,2010,total_driving,NA
233,232,Peter Malnati,9,422,197,225,2010,total_driving,NA
234,233,Michael Kim,8,435,211,224,2010,total_driving,NA
235,235,Tommy Gainey,4,442,209,233,2010,total_driving,NA
236,234,D.A. Points,4,446,226,220,2010,total_driving,NA
237,236,Ricky Barnes,6,451,214,237,2010,total_driving,NA
238,237,Brendon de Jonge,3,462,205,257,2010,total_driving,NA
239,238,Shugo Imahira,2,490,235,255,2010,total_driving,NA
1,1,Andrew Novak,2,35,17,18,2011,total_driving,NA
2,3,Viktor Hovland,4,63,16,47,2011,total_driving,NA
3,4,Chase Koepka,2,72,34,38,2011,total_driving,NA
4,5,John Oda,2,74,70,4,2011,total_driving,NA
5,6,D.J. Trahan,7,91,47,44,2011,total_driving,NA
6,8,Gary Woodland,4,98,94,4,2011,total_driving,NA
7,9,Branden Grace,4,99,21,78,2011,total_driving,NA
T8,10,Patrick Cantlay,3,103,86,17,2011,total_driving,NA
T8,7,Doc Redman,10,103,77,26,2011,total_driving,NA
10,2,Ryan Moore,5,105,94,11,2011,total_driving,NA
11,13,Scottie Scheffler,8,126,15,111,2011,total_driving,NA
12,T19,Kyoung-Hoon Lee,10,128,106,22,2011,total_driving,NA
13,14,Martin Laird,8,129,42,87,2011,total_driving,NA
14,11,Kevin Streelman,9,130,62,68,2011,total_driving,NA
15,25,Jhonattan Vegas,6,132,24,108,2011,total_driving,NA
T16,15,Nick Taylor,8,133,109,24,2011,total_driving,NA
T16,T23,Brendan Steele,8,133,63,70,2011,total_driving,NA
18,12,Harris English,7,135,36,99,2011,total_driving,NA
T19,T27,Harry Higgs,10,140,79,61,2011,total_driving,NA
T19,T27,Sung Kang,7,140,53,87,2011,total_driving,NA
T21,22,Emiliano Grillo,7,142,110,32,2011,total_driving,NA
T21,18,Bubba Watson,4,142,1,141,2011,total_driving,NA
23,T19,Bryson DeChambeau,3,144,13,131,2011,total_driving,NA
24,T52,Matthew Wolff,5,145,40,105,2011,total_driving,NA
25,29,Joel Dahmen,8,149,100,49,2011,total_driving,NA
26,16,Jason Kokrak,5,153,8,145,2011,total_driving,NA
27,17,Josh Teater,6,156,83,73,2011,total_driving,NA
28,T23,Cameron Champ,7,157,2,155,2011,total_driving,NA
29,33,Ryan Palmer,5,160,146,14,2011,total_driving,NA
30,T35,Adam Hadwin,5,164,121,43,2011,total_driving,NA
31,26,Sungjae Im,8,165,50,115,2011,total_driving,NA
32,31,Henrik Norlander,10,168,132,36,2011,total_driving,NA
T33,38,Boo Weekley,5,169,147,22,2011,total_driving,NA
T33,T35,Harold Varner III,7,169,18,151,2011,total_driving,NA
35,37,Lanto Griffin,10,170,40,130,2011,total_driving,NA
36,T19,Lucas Glover,7,174,98,76,2011,total_driving,NA
37,34,Scott Brown,9,175,151,24,2011,total_driving,NA
38,T44,Sebastián Muñoz,10,176,60,116,2011,total_driving,NA
T39,40,Daniel Berger,6,177,56,121,2011,total_driving,NA
T39,42,Keegan Bradley,7,177,71,106,2011,total_driving,NA
41,39,Chesson Hadley,7,179,106,73,2011,total_driving,NA
42,43,Webb Simpson,3,182,170,12,2011,total_driving,NA
43,48,Danny Lee,7,185,9,176,2011,total_driving,NA
44,T50,Pat Perez,6,186,130,56,2011,total_driving,NA
45,T52,Matthew NeSmith,9,188,154,34,2011,total_driving,NA
46,T99,Sepp Straka,10,191,92,99,2011,total_driving,NA
T47,T90,Isaiah Salinda,3,192,14,178,2011,total_driving,NA
T47,T56,John Merrick,4,192,135,57,2011,total_driving,NA
T49,T50,Jim Furyk,3,193,192,1,2011,total_driving,NA
T49,55,Chad Campbell,4,193,178,15,2011,total_driving,NA
T49,T44,Wyndham Clark,7,193,32,161,2011,total_driving,NA
52,32,Alex Noren,4,195,108,87,2011,total_driving,NA
53,NA,Rickie Fowler,2,196,194,2,2011,total_driving,NA
T54,T56,Tony Finau,5,198,12,186,2011,total_driving,NA
T54,T62,Phil Mickelson,5,198,31,167,2011,total_driving,NA
T54,T62,Aaron Wise,7,198,51,147,2011,total_driving,NA
T54,T69,Chase Seiffert,9,198,127,71,2011,total_driving,NA
T58,T73,Abraham Ancer,8,199,113,86,2011,total_driving,NA
T58,61,Adam Schenk,10,199,33,166,2011,total_driving,NA
T58,T64,Scott Harrington,9,199,34,165,2011,total_driving,NA
T61,T52,Brian Harman,8,200,143,57,2011,total_driving,NA
T61,47,Jason Dufner,7,200,140,60,2011,total_driving,NA
T61,59,Cameron Smith,6,200,77,123,2011,total_driving,NA
T64,46,Kramer Hickok,9,201,124,77,2011,total_driving,NA
T64,60,Matt Jones,8,201,49,152,2011,total_driving,NA
66,30,Robby Shelton,10,202,88,114,2011,total_driving,NA
T67,83,Grayson Murray,6,203,4,199,2011,total_driving,NA
T67,T73,Russell Knox,8,203,138,65,2011,total_driving,NA
69,41,Denny McCarthy,8,204,101,103,2011,total_driving,NA
70,T80,Sam Ryder,10,209,53,156,2011,total_driving,NA
71,58,Brice Garnett,8,214,150,64,2011,total_driving,NA
72,66,Michael Thompson,7,215,175,40,2011,total_driving,NA
73,76,Collin Morikawa,6,216,168,48,2011,total_driving,NA
T74,T69,Derek Ernst,4,217,80,137,2011,total_driving,NA
T74,T67,Adam Long,10,217,189,28,2011,total_driving,NA
T74,96,Andrew Landry,9,217,171,46,2011,total_driving,NA
77,T84,Akshay Bhatia,5,218,7,211,2011,total_driving,NA
78,T69,Rod Pampling,3,220,28,192,2011,total_driving,NA
79,136,Nick Watney,7,222,73,149,2011,total_driving,NA
T80,T84,Hideki Matsuyama,6,223,115,108,2011,total_driving,NA
T80,115,Doug Ghim,7,223,116,107,2011,total_driving,NA
T80,T90,Kristoffer Ventura,9,223,44,179,2011,total_driving,NA
T83,T73,Byeong Hun An,8,225,10,215,2011,total_driving,NA
T83,T90,Chandler Phillips,2,225,57,168,2011,total_driving,NA
T83,T69,Brian Stuard,10,225,215,10,2011,total_driving,NA
T83,T97,Alex Cejka,5,225,175,50,2011,total_driving,NA
T83,T80,Ryan Armour,9,225,217,8,2011,total_driving,NA
T88,T90,Graham DeLaet,5,226,36,190,2011,total_driving,NA
T88,T77,Tim Wilkinson,6,226,189,37,2011,total_driving,NA
T88,T86,Brandon Wu,2,226,188,38,2011,total_driving,NA
T91,T88,Hank Lebioda,9,228,104,124,2011,total_driving,NA
T91,79,Charles Howell III,9,228,69,159,2011,total_driving,NA
93,T67,Tyler McCumber,9,229,11,218,2011,total_driving,NA
94,T90,Fabián Gómez,9,230,167,63,2011,total_driving,NA
95,T90,Brendon Todd,11,231,228,3,2011,total_driving,NA
T96,49,Cameron Percy,8,233,61,172,2011,total_driving,NA
T96,T99,Adam Scott,4,233,46,187,2011,total_driving,NA
T96,T80,Luke List,9,233,80,153,2011,total_driving,NA
T96,T86,Russell Henley,8,233,179,54,2011,total_driving,NA
T96,T130,Mackenzie Hughes,8,233,101,132,2011,total_driving,NA
101,T109,J.T. Poston,9,234,175,59,2011,total_driving,NA
102,T64,Vince Covello,8,235,73,162,2011,total_driving,NA
103,T99,Xinjun Zhang,10,236,116,120,2011,total_driving,NA
104,105,K.J. Choi,3,237,233,4,2011,total_driving,NA
T105,107,Tim Herron,4,238,220,18,2011,total_driving,NA
T105,T109,Corey Conners,7,238,186,52,2011,total_driving,NA
T107,108,Keith Mitchell,7,239,135,104,2011,total_driving,NA
T107,T130,Cameron Davis,8,239,22,217,2011,total_driving,NA
T107,T99,Richy Werenski,4,239,45,194,2011,total_driving,NA
T107,T88,Vaughn Taylor,8,239,212,27,2011,total_driving,NA
111,168,Chris Baker,9,240,168,72,2011,total_driving,NA
T112,T112,Jim Herman,8,241,221,20,2011,total_driving,NA
T112,T127,Scott Piercy,8,241,105,136,2011,total_driving,NA
T114,T120,J.J. Henry,5,242,173,69,2011,total_driving,NA
T114,T103,Tyler Duncan,10,242,221,21,2011,total_driving,NA
116,T112,Davis Riley,2,243,83,160,2011,total_driving,NA
T117,T125,Bo Hoag,10,244,127,117,2011,total_driving,NA
T117,T116,Chez Reavie,9,244,228,16,2011,total_driving,NA
119,T116,Matt Kuchar,4,245,238,7,2011,total_driving,NA
T120,223,Paul Casey,4,247,160,87,2011,total_driving,NA
T120,T116,Satoshi Kodaira,6,247,234,13,2011,total_driving,NA
T120,T127,Shawn Stefani,6,247,73,174,2011,total_driving,NA
123,106,Carlos Ortiz,8,248,67,181,2011,total_driving,NA
124,T122,Ben Crane,6,249,207,42,2011,total_driving,NA
125,T130,Tom Lewis,3,252,5,247,2011,total_driving,NA
126,T139,Michael Gligic,9,253,73,180,2011,total_driving,NA
T127,T139,Scott Stallings,8,254,47,207,2011,total_driving,NA
T127,T137,Kyle Stanley,8,254,213,41,2011,total_driving,NA
T129,T137,Henrik Stenson,2,255,202,53,2011,total_driving,NA
T129,T125,Austin Cook,8,255,127,128,2011,total_driving,NA
T131,T120,Beau Hossler,8,256,29,227,2011,total_driving,NA
T131,T122,Patrick Rodgers,10,256,26,230,2011,total_driving,NA
T131,T143,Sebastian Cappelen,8,256,30,226,2011,total_driving,NA
T131,T133,Kurt Kitayama,2,256,3,253,2011,total_driving,NA
T131,T77,Vincent Whaley,7,256,103,153,2011,total_driving,NA
T131,T141,Ryan Brehm,10,256,6,250,2011,total_driving,NA
137,T122,Mark Hubbard,10,257,149,108,2011,total_driving,NA
T138,T163,Brandon Hagy,8,258,22,236,2011,total_driving,NA
T138,T109,Billy Horschel,6,258,196,62,2011,total_driving,NA
T140,T147,Sam Burns,6,259,20,239,2011,total_driving,NA
T140,T133,David Lingmerth,5,259,230,29,2011,total_driving,NA
T142,T187,Bud Cauley,6,262,125,137,2011,total_driving,NA
T142,T143,Cameron Tringale,7,262,55,207,2011,total_driving,NA
144,T143,Rikuya Hoshino,2,264,138,126,2011,total_driving,NA
145,T155,Jonathan Byrd,5,265,72,193,2011,total_driving,NA
T146,T116,Maverick McNealy,9,266,89,177,2011,total_driving,NA
T146,T147,Xander Schauffele,3,266,231,35,2011,total_driving,NA
T148,154,Whee Kim,2,267,180,87,2011,total_driving,NA
T148,T141,Lucas Bjerregaard,3,267,18,249,2011,total_driving,NA
150,T152,Chip McDaniel,2,268,59,209,2011,total_driving,NA
T151,T178,Max Homa,6,269,187,82,2011,total_driving,NA
T151,T112,Bill Haas,6,269,147,122,2011,total_driving,NA
T151,146,J.B. Holmes,3,269,224,45,2011,total_driving,NA
T154,129,Zack Sucher,6,270,24,246,2011,total_driving,NA
T154,T157,Roberto Castro,5,270,183,87,2011,total_driving,NA
156,151,Kevin Tway,6,271,27,244,2011,total_driving,NA
T157,T155,Kevin Chappell,6,272,43,229,2011,total_driving,NA
T157,T152,Dominic Bozzelli,7,272,38,234,2011,total_driving,NA
T159,T147,David Hearn,9,273,206,67,2011,total_driving,NA
T159,174,Jimmy Walker,4,273,92,181,2011,total_driving,NA
161,165,Sangmoon Bae,6,274,64,210,2011,total_driving,NA
162,167,Michael Gellerman,8,275,135,140,2011,total_driving,NA
163,T159,Kevin Kisner,7,277,227,50,2011,total_driving,NA
T164,T159,Justin Thomas,5,278,161,117,2011,total_driving,NA
T164,T187,Troy Merritt,7,278,182,96,2011,total_driving,NA
T164,T163,Freddie Jacobson,3,278,141,137,2011,total_driving,NA
167,T175,Talor Gooch,8,280,122,158,2011,total_driving,NA
168,T103,Andrew Putnam,6,283,181,102,2011,total_driving,NA
T169,T157,Si Woo Kim,8,284,99,185,2011,total_driving,NA
T169,T97,Charley Hoffman,7,284,87,197,2011,total_driving,NA
T169,169,Seamus Power,5,284,83,201,2011,total_driving,NA
172,T133,John Huh,5,285,166,119,2011,total_driving,NA
T173,T172,Jason Day,3,286,80,206,2011,total_driving,NA
T173,T172,Chris Kirk,3,286,199,87,2011,total_driving,NA
T173,T175,Rafael Campos,9,286,67,219,2011,total_driving,NA
176,T159,Nate Lashley,8,287,204,83,2011,total_driving,NA
177,177,Brandt Snedeker,4,288,155,133,2011,total_driving,NA
178,T178,Peter Uihlein,6,289,38,251,2011,total_driving,NA
179,150,Kevin Na,7,290,203,87,2011,total_driving,NA
180,T170,Ben Taylor,10,291,134,157,2011,total_driving,NA
181,162,Anirban Lahiri,8,292,118,174,2011,total_driving,NA
182,T208,Roger Sloan,8,293,158,135,2011,total_driving,NA
T183,182,Johnson Wagner,5,294,207,87,2011,total_driving,NA
T183,T183,Robert Garrigus,5,294,52,242,2011,total_driving,NA
T183,T187,Wes Roach,7,294,151,143,2011,total_driving,NA
186,181,Zach Johnson,7,299,216,83,2011,total_driving,NA
187,191,Mikumu Horikawa,3,303,237,66,2011,total_driving,NA
T188,194,Will Gordon,4,304,64,240,2011,total_driving,NA
T188,210,Rory Sabbatini,7,304,219,85,2011,total_driving,NA
T188,T183,Dylan Frittelli,9,304,193,111,2011,total_driving,NA
191,185,Nelson Ledesma,10,305,57,248,2011,total_driving,NA
192,192,Marc Leishman,5,306,90,216,2011,total_driving,NA
193,166,Joseph Bramlett,7,307,94,213,2011,total_driving,NA
194,195,Joaquin Niemann,8,308,164,144,2011,total_driving,NA
T195,T196,Graeme McDowell,5,311,236,75,2011,total_driving,NA
T195,T201,Bronson Burgoon,8,311,130,181,2011,total_driving,NA
197,T187,Brian Gay,9,312,162,150,2011,total_driving,NA
198,193,Rhein Gibson,9,313,90,223,2011,total_driving,NA
199,T196,Tom Hoge,8,314,185,129,2011,total_driving,NA
200,200,Mark Anderson,7,319,132,187,2011,total_driving,NA
201,204,Smylie Kaufman,3,320,64,256,2011,total_driving,NA
T202,199,Zac Blair,10,322,225,97,2011,total_driving,NA
T202,214,Francesco Molinari,3,322,125,197,2011,total_driving,NA
T204,T170,John Senden,5,324,120,204,2011,total_driving,NA
T204,180,Ben Martin,6,324,223,101,2011,total_driving,NA
T206,T205,James Hahn,6,325,163,162,2011,total_driving,NA
T206,186,Aaron Baddeley,6,325,198,127,2011,total_driving,NA
208,T211,J.J. Spaun,9,330,118,212,2011,total_driving,NA
T209,203,Robert Streb,9,332,141,191,2011,total_driving,NA
T209,T208,Robert Allenby,3,332,164,168,2011,total_driving,NA
211,T211,Martin Trainer,8,339,94,245,2011,total_driving,NA
212,T205,"Ted Potter, Jr.",7,340,151,189,2011,total_driving,NA
213,T201,Chris Stroud,6,341,194,147,2011,total_driving,NA
T214,T205,Rob Oppenheim,10,342,200,142,2011,total_driving,NA
T214,198,Matt Every,7,342,122,220,2011,total_driving,NA
T214,213,Morgan Hoffmann,4,342,143,199,2011,total_driving,NA
217,215,Roberto Díaz,2,345,110,235,2011,total_driving,NA
218,216,Stewart Cink,4,350,112,238,2011,total_driving,NA
219,217,C.T. Pan,5,353,189,164,2011,total_driving,NA
220,T218,Patton Kizzire,9,354,158,196,2011,total_driving,NA
221,222,Hudson Swafford,4,356,183,173,2011,total_driving,NA
222,T218,George McNeill,6,359,145,214,2011,total_driving,NA
223,220,Patrick Reed,4,363,239,124,2011,total_driving,NA
224,221,Jamie Lovemark,4,365,114,251,2011,total_driving,NA
225,224,Luke Donald,2,378,232,146,2011,total_driving,NA
226,226,Bo Van Pelt,7,387,155,232,2011,total_driving,NA
227,225,Davis Love III,3,400,172,228,2011,total_driving,NA
228,228,Arjun Atwal,5,404,173,231,2011,total_driving,NA
T229,231,Daniel Chopra,3,411,157,254,2011,total_driving,NA
T229,227,Kevin Stadler,6,411,217,194,2011,total_driving,NA
231,229,John Rollins,4,414,209,205,2011,total_driving,NA
232,230,Parker McLachlin,4,421,201,220,2011,total_driving,NA
233,232,Peter Malnati,9,422,197,225,2011,total_driving,NA
234,233,Michael Kim,8,435,211,224,2011,total_driving,NA
235,235,Tommy Gainey,4,442,209,233,2011,total_driving,NA
236,234,D.A. Points,4,446,226,220,2011,total_driving,NA
237,236,Ricky Barnes,6,451,214,237,2011,total_driving,NA
238,237,Brendon de Jonge,3,462,205,257,2011,total_driving,NA
239,238,Shugo Imahira,2,490,235,255,2011,total_driving,NA
1,1,Andrew Novak,2,35,17,18,2012,total_driving,NA
2,3,Viktor Hovland,4,63,16,47,2012,total_driving,NA
3,4,Chase Koepka,2,72,34,38,2012,total_driving,NA
4,5,John Oda,2,74,70,4,2012,total_driving,NA
5,6,D.J. Trahan,7,91,47,44,2012,total_driving,NA
6,8,Gary Woodland,4,98,94,4,2012,total_driving,NA
7,9,Branden Grace,4,99,21,78,2012,total_driving,NA
T8,10,Patrick Cantlay,3,103,86,17,2012,total_driving,NA
T8,7,Doc Redman,10,103,77,26,2012,total_driving,NA
10,2,Ryan Moore,5,105,94,11,2012,total_driving,NA
11,13,Scottie Scheffler,8,126,15,111,2012,total_driving,NA
12,T19,Kyoung-Hoon Lee,10,128,106,22,2012,total_driving,NA
13,14,Martin Laird,8,129,42,87,2012,total_driving,NA
14,11,Kevin Streelman,9,130,62,68,2012,total_driving,NA
15,25,Jhonattan Vegas,6,132,24,108,2012,total_driving,NA
T16,15,Nick Taylor,8,133,109,24,2012,total_driving,NA
T16,T23,Brendan Steele,8,133,63,70,2012,total_driving,NA
18,12,Harris English,7,135,36,99,2012,total_driving,NA
T19,T27,Harry Higgs,10,140,79,61,2012,total_driving,NA
T19,T27,Sung Kang,7,140,53,87,2012,total_driving,NA
T21,22,Emiliano Grillo,7,142,110,32,2012,total_driving,NA
T21,18,Bubba Watson,4,142,1,141,2012,total_driving,NA
23,T19,Bryson DeChambeau,3,144,13,131,2012,total_driving,NA
24,T52,Matthew Wolff,5,145,40,105,2012,total_driving,NA
25,29,Joel Dahmen,8,149,100,49,2012,total_driving,NA
26,16,Jason Kokrak,5,153,8,145,2012,total_driving,NA
27,17,Josh Teater,6,156,83,73,2012,total_driving,NA
28,T23,Cameron Champ,7,157,2,155,2012,total_driving,NA
29,33,Ryan Palmer,5,160,146,14,2012,total_driving,NA
30,T35,Adam Hadwin,5,164,121,43,2012,total_driving,NA
31,26,Sungjae Im,8,165,50,115,2012,total_driving,NA
32,31,Henrik Norlander,10,168,132,36,2012,total_driving,NA
T33,38,Boo Weekley,5,169,147,22,2012,total_driving,NA
T33,T35,Harold Varner III,7,169,18,151,2012,total_driving,NA
35,37,Lanto Griffin,10,170,40,130,2012,total_driving,NA
36,T19,Lucas Glover,7,174,98,76,2012,total_driving,NA
37,34,Scott Brown,9,175,151,24,2012,total_driving,NA
38,T44,Sebastián Muñoz,10,176,60,116,2012,total_driving,NA
T39,40,Daniel Berger,6,177,56,121,2012,total_driving,NA
T39,42,Keegan Bradley,7,177,71,106,2012,total_driving,NA
41,39,Chesson Hadley,7,179,106,73,2012,total_driving,NA
42,43,Webb Simpson,3,182,170,12,2012,total_driving,NA
43,48,Danny Lee,7,185,9,176,2012,total_driving,NA
44,T50,Pat Perez,6,186,130,56,2012,total_driving,NA
45,T52,Matthew NeSmith,9,188,154,34,2012,total_driving,NA
46,T99,Sepp Straka,10,191,92,99,2012,total_driving,NA
T47,T90,Isaiah Salinda,3,192,14,178,2012,total_driving,NA
T47,T56,John Merrick,4,192,135,57,2012,total_driving,NA
T49,T50,Jim Furyk,3,193,192,1,2012,total_driving,NA
T49,55,Chad Campbell,4,193,178,15,2012,total_driving,NA
T49,T44,Wyndham Clark,7,193,32,161,2012,total_driving,NA
52,32,Alex Noren,4,195,108,87,2012,total_driving,NA
53,NA,Rickie Fowler,2,196,194,2,2012,total_driving,NA
T54,T56,Tony Finau,5,198,12,186,2012,total_driving,NA
T54,T62,Phil Mickelson,5,198,31,167,2012,total_driving,NA
T54,T62,Aaron Wise,7,198,51,147,2012,total_driving,NA
T54,T69,Chase Seiffert,9,198,127,71,2012,total_driving,NA
T58,T73,Abraham Ancer,8,199,113,86,2012,total_driving,NA
T58,61,Adam Schenk,10,199,33,166,2012,total_driving,NA
T58,T64,Scott Harrington,9,199,34,165,2012,total_driving,NA
T61,T52,Brian Harman,8,200,143,57,2012,total_driving,NA
T61,47,Jason Dufner,7,200,140,60,2012,total_driving,NA
T61,59,Cameron Smith,6,200,77,123,2012,total_driving,NA
T64,46,Kramer Hickok,9,201,124,77,2012,total_driving,NA
T64,60,Matt Jones,8,201,49,152,2012,total_driving,NA
66,30,Robby Shelton,10,202,88,114,2012,total_driving,NA
T67,83,Grayson Murray,6,203,4,199,2012,total_driving,NA
T67,T73,Russell Knox,8,203,138,65,2012,total_driving,NA
69,41,Denny McCarthy,8,204,101,103,2012,total_driving,NA
70,T80,Sam Ryder,10,209,53,156,2012,total_driving,NA
71,58,Brice Garnett,8,214,150,64,2012,total_driving,NA
72,66,Michael Thompson,7,215,175,40,2012,total_driving,NA
73,76,Collin Morikawa,6,216,168,48,2012,total_driving,NA
T74,T69,Derek Ernst,4,217,80,137,2012,total_driving,NA
T74,T67,Adam Long,10,217,189,28,2012,total_driving,NA
T74,96,Andrew Landry,9,217,171,46,2012,total_driving,NA
77,T84,Akshay Bhatia,5,218,7,211,2012,total_driving,NA
78,T69,Rod Pampling,3,220,28,192,2012,total_driving,NA
79,136,Nick Watney,7,222,73,149,2012,total_driving,NA
T80,T84,Hideki Matsuyama,6,223,115,108,2012,total_driving,NA
T80,115,Doug Ghim,7,223,116,107,2012,total_driving,NA
T80,T90,Kristoffer Ventura,9,223,44,179,2012,total_driving,NA
T83,T73,Byeong Hun An,8,225,10,215,2012,total_driving,NA
T83,T90,Chandler Phillips,2,225,57,168,2012,total_driving,NA
T83,T69,Brian Stuard,10,225,215,10,2012,total_driving,NA
T83,T97,Alex Cejka,5,225,175,50,2012,total_driving,NA
T83,T80,Ryan Armour,9,225,217,8,2012,total_driving,NA
T88,T90,Graham DeLaet,5,226,36,190,2012,total_driving,NA
T88,T77,Tim Wilkinson,6,226,189,37,2012,total_driving,NA
T88,T86,Brandon Wu,2,226,188,38,2012,total_driving,NA
T91,T88,Hank Lebioda,9,228,104,124,2012,total_driving,NA
T91,79,Charles Howell III,9,228,69,159,2012,total_driving,NA
93,T67,Tyler McCumber,9,229,11,218,2012,total_driving,NA
94,T90,Fabián Gómez,9,230,167,63,2012,total_driving,NA
95,T90,Brendon Todd,11,231,228,3,2012,total_driving,NA
T96,49,Cameron Percy,8,233,61,172,2012,total_driving,NA
T96,T99,Adam Scott,4,233,46,187,2012,total_driving,NA
T96,T80,Luke List,9,233,80,153,2012,total_driving,NA
T96,T86,Russell Henley,8,233,179,54,2012,total_driving,NA
T96,T130,Mackenzie Hughes,8,233,101,132,2012,total_driving,NA
101,T109,J.T. Poston,9,234,175,59,2012,total_driving,NA
102,T64,Vince Covello,8,235,73,162,2012,total_driving,NA
103,T99,Xinjun Zhang,10,236,116,120,2012,total_driving,NA
104,105,K.J. Choi,3,237,233,4,2012,total_driving,NA
T105,107,Tim Herron,4,238,220,18,2012,total_driving,NA
T105,T109,Corey Conners,7,238,186,52,2012,total_driving,NA
T107,108,Keith Mitchell,7,239,135,104,2012,total_driving,NA
T107,T130,Cameron Davis,8,239,22,217,2012,total_driving,NA
T107,T99,Richy Werenski,4,239,45,194,2012,total_driving,NA
T107,T88,Vaughn Taylor,8,239,212,27,2012,total_driving,NA
111,168,Chris Baker,9,240,168,72,2012,total_driving,NA
T112,T112,Jim Herman,8,241,221,20,2012,total_driving,NA
T112,T127,Scott Piercy,8,241,105,136,2012,total_driving,NA
T114,T120,J.J. Henry,5,242,173,69,2012,total_driving,NA
T114,T103,Tyler Duncan,10,242,221,21,2012,total_driving,NA
116,T112,Davis Riley,2,243,83,160,2012,total_driving,NA
T117,T125,Bo Hoag,10,244,127,117,2012,total_driving,NA
T117,T116,Chez Reavie,9,244,228,16,2012,total_driving,NA
119,T116,Matt Kuchar,4,245,238,7,2012,total_driving,NA
T120,223,Paul Casey,4,247,160,87,2012,total_driving,NA
T120,T116,Satoshi Kodaira,6,247,234,13,2012,total_driving,NA
T120,T127,Shawn Stefani,6,247,73,174,2012,total_driving,NA
123,106,Carlos Ortiz,8,248,67,181,2012,total_driving,NA
124,T122,Ben Crane,6,249,207,42,2012,total_driving,NA
125,T130,Tom Lewis,3,252,5,247,2012,total_driving,NA
126,T139,Michael Gligic,9,253,73,180,2012,total_driving,NA
T127,T139,Scott Stallings,8,254,47,207,2012,total_driving,NA
T127,T137,Kyle Stanley,8,254,213,41,2012,total_driving,NA
T129,T137,Henrik Stenson,2,255,202,53,2012,total_driving,NA
T129,T125,Austin Cook,8,255,127,128,2012,total_driving,NA
T131,T120,Beau Hossler,8,256,29,227,2012,total_driving,NA
T131,T122,Patrick Rodgers,10,256,26,230,2012,total_driving,NA
T131,T143,Sebastian Cappelen,8,256,30,226,2012,total_driving,NA
T131,T133,Kurt Kitayama,2,256,3,253,2012,total_driving,NA
T131,T77,Vincent Whaley,7,256,103,153,2012,total_driving,NA
T131,T141,Ryan Brehm,10,256,6,250,2012,total_driving,NA
137,T122,Mark Hubbard,10,257,149,108,2012,total_driving,NA
T138,T163,Brandon Hagy,8,258,22,236,2012,total_driving,NA
T138,T109,Billy Horschel,6,258,196,62,2012,total_driving,NA
T140,T147,Sam Burns,6,259,20,239,2012,total_driving,NA
T140,T133,David Lingmerth,5,259,230,29,2012,total_driving,NA
T142,T187,Bud Cauley,6,262,125,137,2012,total_driving,NA
T142,T143,Cameron Tringale,7,262,55,207,2012,total_driving,NA
144,T143,Rikuya Hoshino,2,264,138,126,2012,total_driving,NA
145,T155,Jonathan Byrd,5,265,72,193,2012,total_driving,NA
T146,T116,Maverick McNealy,9,266,89,177,2012,total_driving,NA
T146,T147,Xander Schauffele,3,266,231,35,2012,total_driving,NA
T148,154,Whee Kim,2,267,180,87,2012,total_driving,NA
T148,T141,Lucas Bjerregaard,3,267,18,249,2012,total_driving,NA
150,T152,Chip McDaniel,2,268,59,209,2012,total_driving,NA
T151,T178,Max Homa,6,269,187,82,2012,total_driving,NA
T151,T112,Bill Haas,6,269,147,122,2012,total_driving,NA
T151,146,J.B. Holmes,3,269,224,45,2012,total_driving,NA
T154,129,Zack Sucher,6,270,24,246,2012,total_driving,NA
T154,T157,Roberto Castro,5,270,183,87,2012,total_driving,NA
156,151,Kevin Tway,6,271,27,244,2012,total_driving,NA
T157,T155,Kevin Chappell,6,272,43,229,2012,total_driving,NA
T157,T152,Dominic Bozzelli,7,272,38,234,2012,total_driving,NA
T159,T147,David Hearn,9,273,206,67,2012,total_driving,NA
T159,174,Jimmy Walker,4,273,92,181,2012,total_driving,NA
161,165,Sangmoon Bae,6,274,64,210,2012,total_driving,NA
162,167,Michael Gellerman,8,275,135,140,2012,total_driving,NA
163,T159,Kevin Kisner,7,277,227,50,2012,total_driving,NA
T164,T159,Justin Thomas,5,278,161,117,2012,total_driving,NA
T164,T187,Troy Merritt,7,278,182,96,2012,total_driving,NA
T164,T163,Freddie Jacobson,3,278,141,137,2012,total_driving,NA
167,T175,Talor Gooch,8,280,122,158,2012,total_driving,NA
168,T103,Andrew Putnam,6,283,181,102,2012,total_driving,NA
T169,T157,Si Woo Kim,8,284,99,185,2012,total_driving,NA
T169,T97,Charley Hoffman,7,284,87,197,2012,total_driving,NA
T169,169,Seamus Power,5,284,83,201,2012,total_driving,NA
172,T133,John Huh,5,285,166,119,2012,total_driving,NA
T173,T172,Jason Day,3,286,80,206,2012,total_driving,NA
T173,T172,Chris Kirk,3,286,199,87,2012,total_driving,NA
T173,T175,Rafael Campos,9,286,67,219,2012,total_driving,NA
176,T159,Nate Lashley,8,287,204,83,2012,total_driving,NA
177,177,Brandt Snedeker,4,288,155,133,2012,total_driving,NA
178,T178,Peter Uihlein,6,289,38,251,2012,total_driving,NA
179,150,Kevin Na,7,290,203,87,2012,total_driving,NA
180,T170,Ben Taylor,10,291,134,157,2012,total_driving,NA
181,162,Anirban Lahiri,8,292,118,174,2012,total_driving,NA
182,T208,Roger Sloan,8,293,158,135,2012,total_driving,NA
T183,182,Johnson Wagner,5,294,207,87,2012,total_driving,NA
T183,T183,Robert Garrigus,5,294,52,242,2012,total_driving,NA
T183,T187,Wes Roach,7,294,151,143,2012,total_driving,NA
186,181,Zach Johnson,7,299,216,83,2012,total_driving,NA
187,191,Mikumu Horikawa,3,303,237,66,2012,total_driving,NA
T188,194,Will Gordon,4,304,64,240,2012,total_driving,NA
T188,210,Rory Sabbatini,7,304,219,85,2012,total_driving,NA
T188,T183,Dylan Frittelli,9,304,193,111,2012,total_driving,NA
191,185,Nelson Ledesma,10,305,57,248,2012,total_driving,NA
192,192,Marc Leishman,5,306,90,216,2012,total_driving,NA
193,166,Joseph Bramlett,7,307,94,213,2012,total_driving,NA
194,195,Joaquin Niemann,8,308,164,144,2012,total_driving,NA
T195,T196,Graeme McDowell,5,311,236,75,2012,total_driving,NA
T195,T201,Bronson Burgoon,8,311,130,181,2012,total_driving,NA
197,T187,Brian Gay,9,312,162,150,2012,total_driving,NA
198,193,Rhein Gibson,9,313,90,223,2012,total_driving,NA
199,T196,Tom Hoge,8,314,185,129,2012,total_driving,NA
200,200,Mark Anderson,7,319,132,187,2012,total_driving,NA
201,204,Smylie Kaufman,3,320,64,256,2012,total_driving,NA
T202,199,Zac Blair,10,322,225,97,2012,total_driving,NA
T202,214,Francesco Molinari,3,322,125,197,2012,total_driving,NA
T204,T170,John Senden,5,324,120,204,2012,total_driving,NA
T204,180,Ben Martin,6,324,223,101,2012,total_driving,NA
T206,T205,James Hahn,6,325,163,162,2012,total_driving,NA
T206,186,Aaron Baddeley,6,325,198,127,2012,total_driving,NA
208,T211,J.J. Spaun,9,330,118,212,2012,total_driving,NA
T209,203,Robert Streb,9,332,141,191,2012,total_driving,NA
T209,T208,Robert Allenby,3,332,164,168,2012,total_driving,NA
211,T211,Martin Trainer,8,339,94,245,2012,total_driving,NA
212,T205,"Ted Potter, Jr.",7,340,151,189,2012,total_driving,NA
213,T201,Chris Stroud,6,341,194,147,2012,total_driving,NA
T214,T205,Rob Oppenheim,10,342,200,142,2012,total_driving,NA
T214,198,Matt Every,7,342,122,220,2012,total_driving,NA
T214,213,Morgan Hoffmann,4,342,143,199,2012,total_driving,NA
217,215,Roberto Díaz,2,345,110,235,2012,total_driving,NA
218,216,Stewart Cink,4,350,112,238,2012,total_driving,NA
219,217,C.T. Pan,5,353,189,164,2012,total_driving,NA
220,T218,Patton Kizzire,9,354,158,196,2012,total_driving,NA
221,222,Hudson Swafford,4,356,183,173,2012,total_driving,NA
222,T218,George McNeill,6,359,145,214,2012,total_driving,NA
223,220,Patrick Reed,4,363,239,124,2012,total_driving,NA
224,221,Jamie Lovemark,4,365,114,251,2012,total_driving,NA
225,224,Luke Donald,2,378,232,146,2012,total_driving,NA
226,226,Bo Van Pelt,7,387,155,232,2012,total_driving,NA
227,225,Davis Love III,3,400,172,228,2012,total_driving,NA
228,228,Arjun Atwal,5,404,173,231,2012,total_driving,NA
T229,231,Daniel Chopra,3,411,157,254,2012,total_driving,NA
T229,227,Kevin Stadler,6,411,217,194,2012,total_driving,NA
231,229,John Rollins,4,414,209,205,2012,total_driving,NA
232,230,Parker McLachlin,4,421,201,220,2012,total_driving,NA
233,232,Peter Malnati,9,422,197,225,2012,total_driving,NA
234,233,Michael Kim,8,435,211,224,2012,total_driving,NA
235,235,Tommy Gainey,4,442,209,233,2012,total_driving,NA
236,234,D.A. Points,4,446,226,220,2012,total_driving,NA
237,236,Ricky Barnes,6,451,214,237,2012,total_driving,NA
238,237,Brendon de Jonge,3,462,205,257,2012,total_driving,NA
239,238,Shugo Imahira,2,490,235,255,2012,total_driving,NA
1,1,Andrew Novak,2,35,17,18,2013,total_driving,NA
2,3,Viktor Hovland,4,63,16,47,2013,total_driving,NA
3,4,Chase Koepka,2,72,34,38,2013,total_driving,NA
4,5,John Oda,2,74,70,4,2013,total_driving,NA
5,6,D.J. Trahan,7,91,47,44,2013,total_driving,NA
6,8,Gary Woodland,4,98,94,4,2013,total_driving,NA
7,9,Branden Grace,4,99,21,78,2013,total_driving,NA
T8,10,Patrick Cantlay,3,103,86,17,2013,total_driving,NA
T8,7,Doc Redman,10,103,77,26,2013,total_driving,NA
10,2,Ryan Moore,5,105,94,11,2013,total_driving,NA
11,13,Scottie Scheffler,8,126,15,111,2013,total_driving,NA
12,T19,Kyoung-Hoon Lee,10,128,106,22,2013,total_driving,NA
13,14,Martin Laird,8,129,42,87,2013,total_driving,NA
14,11,Kevin Streelman,9,130,62,68,2013,total_driving,NA
15,25,Jhonattan Vegas,6,132,24,108,2013,total_driving,NA
T16,15,Nick Taylor,8,133,109,24,2013,total_driving,NA
T16,T23,Brendan Steele,8,133,63,70,2013,total_driving,NA
18,12,Harris English,7,135,36,99,2013,total_driving,NA
T19,T27,Harry Higgs,10,140,79,61,2013,total_driving,NA
T19,T27,Sung Kang,7,140,53,87,2013,total_driving,NA
T21,22,Emiliano Grillo,7,142,110,32,2013,total_driving,NA
T21,18,Bubba Watson,4,142,1,141,2013,total_driving,NA
23,T19,Bryson DeChambeau,3,144,13,131,2013,total_driving,NA
24,T52,Matthew Wolff,5,145,40,105,2013,total_driving,NA
25,29,Joel Dahmen,8,149,100,49,2013,total_driving,NA
26,16,Jason Kokrak,5,153,8,145,2013,total_driving,NA
27,17,Josh Teater,6,156,83,73,2013,total_driving,NA
28,T23,Cameron Champ,7,157,2,155,2013,total_driving,NA
29,33,Ryan Palmer,5,160,146,14,2013,total_driving,NA
30,T35,Adam Hadwin,5,164,121,43,2013,total_driving,NA
31,26,Sungjae Im,8,165,50,115,2013,total_driving,NA
32,31,Henrik Norlander,10,168,132,36,2013,total_driving,NA
T33,38,Boo Weekley,5,169,147,22,2013,total_driving,NA
T33,T35,Harold Varner III,7,169,18,151,2013,total_driving,NA
35,37,Lanto Griffin,10,170,40,130,2013,total_driving,NA
36,T19,Lucas Glover,7,174,98,76,2013,total_driving,NA
37,34,Scott Brown,9,175,151,24,2013,total_driving,NA
38,T44,Sebastián Muñoz,10,176,60,116,2013,total_driving,NA
T39,40,Daniel Berger,6,177,56,121,2013,total_driving,NA
T39,42,Keegan Bradley,7,177,71,106,2013,total_driving,NA
41,39,Chesson Hadley,7,179,106,73,2013,total_driving,NA
42,43,Webb Simpson,3,182,170,12,2013,total_driving,NA
43,48,Danny Lee,7,185,9,176,2013,total_driving,NA
44,T50,Pat Perez,6,186,130,56,2013,total_driving,NA
45,T52,Matthew NeSmith,9,188,154,34,2013,total_driving,NA
46,T99,Sepp Straka,10,191,92,99,2013,total_driving,NA
T47,T90,Isaiah Salinda,3,192,14,178,2013,total_driving,NA
T47,T56,John Merrick,4,192,135,57,2013,total_driving,NA
T49,T50,Jim Furyk,3,193,192,1,2013,total_driving,NA
T49,55,Chad Campbell,4,193,178,15,2013,total_driving,NA
T49,T44,Wyndham Clark,7,193,32,161,2013,total_driving,NA
52,32,Alex Noren,4,195,108,87,2013,total_driving,NA
53,NA,Rickie Fowler,2,196,194,2,2013,total_driving,NA
T54,T56,Tony Finau,5,198,12,186,2013,total_driving,NA
T54,T62,Phil Mickelson,5,198,31,167,2013,total_driving,NA
T54,T62,Aaron Wise,7,198,51,147,2013,total_driving,NA
T54,T69,Chase Seiffert,9,198,127,71,2013,total_driving,NA
T58,T73,Abraham Ancer,8,199,113,86,2013,total_driving,NA
T58,61,Adam Schenk,10,199,33,166,2013,total_driving,NA
T58,T64,Scott Harrington,9,199,34,165,2013,total_driving,NA
T61,T52,Brian Harman,8,200,143,57,2013,total_driving,NA
T61,47,Jason Dufner,7,200,140,60,2013,total_driving,NA
T61,59,Cameron Smith,6,200,77,123,2013,total_driving,NA
T64,46,Kramer Hickok,9,201,124,77,2013,total_driving,NA
T64,60,Matt Jones,8,201,49,152,2013,total_driving,NA
66,30,Robby Shelton,10,202,88,114,2013,total_driving,NA
T67,83,Grayson Murray,6,203,4,199,2013,total_driving,NA
T67,T73,Russell Knox,8,203,138,65,2013,total_driving,NA
69,41,Denny McCarthy,8,204,101,103,2013,total_driving,NA
70,T80,Sam Ryder,10,209,53,156,2013,total_driving,NA
71,58,Brice Garnett,8,214,150,64,2013,total_driving,NA
72,66,Michael Thompson,7,215,175,40,2013,total_driving,NA
73,76,Collin Morikawa,6,216,168,48,2013,total_driving,NA
T74,T69,Derek Ernst,4,217,80,137,2013,total_driving,NA
T74,T67,Adam Long,10,217,189,28,2013,total_driving,NA
T74,96,Andrew Landry,9,217,171,46,2013,total_driving,NA
77,T84,Akshay Bhatia,5,218,7,211,2013,total_driving,NA
78,T69,Rod Pampling,3,220,28,192,2013,total_driving,NA
79,136,Nick Watney,7,222,73,149,2013,total_driving,NA
T80,T84,Hideki Matsuyama,6,223,115,108,2013,total_driving,NA
T80,115,Doug Ghim,7,223,116,107,2013,total_driving,NA
T80,T90,Kristoffer Ventura,9,223,44,179,2013,total_driving,NA
T83,T73,Byeong Hun An,8,225,10,215,2013,total_driving,NA
T83,T90,Chandler Phillips,2,225,57,168,2013,total_driving,NA
T83,T69,Brian Stuard,10,225,215,10,2013,total_driving,NA
T83,T97,Alex Cejka,5,225,175,50,2013,total_driving,NA
T83,T80,Ryan Armour,9,225,217,8,2013,total_driving,NA
T88,T90,Graham DeLaet,5,226,36,190,2013,total_driving,NA
T88,T77,Tim Wilkinson,6,226,189,37,2013,total_driving,NA
T88,T86,Brandon Wu,2,226,188,38,2013,total_driving,NA
T91,T88,Hank Lebioda,9,228,104,124,2013,total_driving,NA
T91,79,Charles Howell III,9,228,69,159,2013,total_driving,NA
93,T67,Tyler McCumber,9,229,11,218,2013,total_driving,NA
94,T90,Fabián Gómez,9,230,167,63,2013,total_driving,NA
95,T90,Brendon Todd,11,231,228,3,2013,total_driving,NA
T96,49,Cameron Percy,8,233,61,172,2013,total_driving,NA
T96,T99,Adam Scott,4,233,46,187,2013,total_driving,NA
T96,T80,Luke List,9,233,80,153,2013,total_driving,NA
T96,T86,Russell Henley,8,233,179,54,2013,total_driving,NA
T96,T130,Mackenzie Hughes,8,233,101,132,2013,total_driving,NA
101,T109,J.T. Poston,9,234,175,59,2013,total_driving,NA
102,T64,Vince Covello,8,235,73,162,2013,total_driving,NA
103,T99,Xinjun Zhang,10,236,116,120,2013,total_driving,NA
104,105,K.J. Choi,3,237,233,4,2013,total_driving,NA
T105,107,Tim Herron,4,238,220,18,2013,total_driving,NA
T105,T109,Corey Conners,7,238,186,52,2013,total_driving,NA
T107,108,Keith Mitchell,7,239,135,104,2013,total_driving,NA
T107,T130,Cameron Davis,8,239,22,217,2013,total_driving,NA
T107,T99,Richy Werenski,4,239,45,194,2013,total_driving,NA
T107,T88,Vaughn Taylor,8,239,212,27,2013,total_driving,NA
111,168,Chris Baker,9,240,168,72,2013,total_driving,NA
T112,T112,Jim Herman,8,241,221,20,2013,total_driving,NA
T112,T127,Scott Piercy,8,241,105,136,2013,total_driving,NA
T114,T120,J.J. Henry,5,242,173,69,2013,total_driving,NA
T114,T103,Tyler Duncan,10,242,221,21,2013,total_driving,NA
116,T112,Davis Riley,2,243,83,160,2013,total_driving,NA
T117,T125,Bo Hoag,10,244,127,117,2013,total_driving,NA
T117,T116,Chez Reavie,9,244,228,16,2013,total_driving,NA
119,T116,Matt Kuchar,4,245,238,7,2013,total_driving,NA
T120,223,Paul Casey,4,247,160,87,2013,total_driving,NA
T120,T116,Satoshi Kodaira,6,247,234,13,2013,total_driving,NA
T120,T127,Shawn Stefani,6,247,73,174,2013,total_driving,NA
123,106,Carlos Ortiz,8,248,67,181,2013,total_driving,NA
124,T122,Ben Crane,6,249,207,42,2013,total_driving,NA
125,T130,Tom Lewis,3,252,5,247,2013,total_driving,NA
126,T139,Michael Gligic,9,253,73,180,2013,total_driving,NA
T127,T139,Scott Stallings,8,254,47,207,2013,total_driving,NA
T127,T137,Kyle Stanley,8,254,213,41,2013,total_driving,NA
T129,T137,Henrik Stenson,2,255,202,53,2013,total_driving,NA
T129,T125,Austin Cook,8,255,127,128,2013,total_driving,NA
T131,T120,Beau Hossler,8,256,29,227,2013,total_driving,NA
T131,T122,Patrick Rodgers,10,256,26,230,2013,total_driving,NA
T131,T143,Sebastian Cappelen,8,256,30,226,2013,total_driving,NA
T131,T133,Kurt Kitayama,2,256,3,253,2013,total_driving,NA
T131,T77,Vincent Whaley,7,256,103,153,2013,total_driving,NA
T131,T141,Ryan Brehm,10,256,6,250,2013,total_driving,NA
137,T122,Mark Hubbard,10,257,149,108,2013,total_driving,NA
T138,T163,Brandon Hagy,8,258,22,236,2013,total_driving,NA
T138,T109,Billy Horschel,6,258,196,62,2013,total_driving,NA
T140,T147,Sam Burns,6,259,20,239,2013,total_driving,NA
T140,T133,David Lingmerth,5,259,230,29,2013,total_driving,NA
T142,T187,Bud Cauley,6,262,125,137,2013,total_driving,NA
T142,T143,Cameron Tringale,7,262,55,207,2013,total_driving,NA
144,T143,Rikuya Hoshino,2,264,138,126,2013,total_driving,NA
145,T155,Jonathan Byrd,5,265,72,193,2013,total_driving,NA
T146,T116,Maverick McNealy,9,266,89,177,2013,total_driving,NA
T146,T147,Xander Schauffele,3,266,231,35,2013,total_driving,NA
T148,154,Whee Kim,2,267,180,87,2013,total_driving,NA
T148,T141,Lucas Bjerregaard,3,267,18,249,2013,total_driving,NA
150,T152,Chip McDaniel,2,268,59,209,2013,total_driving,NA
T151,T178,Max Homa,6,269,187,82,2013,total_driving,NA
T151,T112,Bill Haas,6,269,147,122,2013,total_driving,NA
T151,146,J.B. Holmes,3,269,224,45,2013,total_driving,NA
T154,129,Zack Sucher,6,270,24,246,2013,total_driving,NA
T154,T157,Roberto Castro,5,270,183,87,2013,total_driving,NA
156,151,Kevin Tway,6,271,27,244,2013,total_driving,NA
T157,T155,Kevin Chappell,6,272,43,229,2013,total_driving,NA
T157,T152,Dominic Bozzelli,7,272,38,234,2013,total_driving,NA
T159,T147,David Hearn,9,273,206,67,2013,total_driving,NA
T159,174,Jimmy Walker,4,273,92,181,2013,total_driving,NA
161,165,Sangmoon Bae,6,274,64,210,2013,total_driving,NA
162,167,Michael Gellerman,8,275,135,140,2013,total_driving,NA
163,T159,Kevin Kisner,7,277,227,50,2013,total_driving,NA
T164,T159,Justin Thomas,5,278,161,117,2013,total_driving,NA
T164,T187,Troy Merritt,7,278,182,96,2013,total_driving,NA
T164,T163,Freddie Jacobson,3,278,141,137,2013,total_driving,NA
167,T175,Talor Gooch,8,280,122,158,2013,total_driving,NA
168,T103,Andrew Putnam,6,283,181,102,2013,total_driving,NA
T169,T157,Si Woo Kim,8,284,99,185,2013,total_driving,NA
T169,T97,Charley Hoffman,7,284,87,197,2013,total_driving,NA
T169,169,Seamus Power,5,284,83,201,2013,total_driving,NA
172,T133,John Huh,5,285,166,119,2013,total_driving,NA
T173,T172,Jason Day,3,286,80,206,2013,total_driving,NA
T173,T172,Chris Kirk,3,286,199,87,2013,total_driving,NA
T173,T175,Rafael Campos,9,286,67,219,2013,total_driving,NA
176,T159,Nate Lashley,8,287,204,83,2013,total_driving,NA
177,177,Brandt Snedeker,4,288,155,133,2013,total_driving,NA
178,T178,Peter Uihlein,6,289,38,251,2013,total_driving,NA
179,150,Kevin Na,7,290,203,87,2013,total_driving,NA
180,T170,Ben Taylor,10,291,134,157,2013,total_driving,NA
181,162,Anirban Lahiri,8,292,118,174,2013,total_driving,NA
182,T208,Roger Sloan,8,293,158,135,2013,total_driving,NA
T183,182,Johnson Wagner,5,294,207,87,2013,total_driving,NA
T183,T183,Robert Garrigus,5,294,52,242,2013,total_driving,NA
T183,T187,Wes Roach,7,294,151,143,2013,total_driving,NA
186,181,Zach Johnson,7,299,216,83,2013,total_driving,NA
187,191,Mikumu Horikawa,3,303,237,66,2013,total_driving,NA
T188,194,Will Gordon,4,304,64,240,2013,total_driving,NA
T188,210,Rory Sabbatini,7,304,219,85,2013,total_driving,NA
T188,T183,Dylan Frittelli,9,304,193,111,2013,total_driving,NA
191,185,Nelson Ledesma,10,305,57,248,2013,total_driving,NA
192,192,Marc Leishman,5,306,90,216,2013,total_driving,NA
193,166,Joseph Bramlett,7,307,94,213,2013,total_driving,NA
194,195,Joaquin Niemann,8,308,164,144,2013,total_driving,NA
T195,T196,Graeme McDowell,5,311,236,75,2013,total_driving,NA
T195,T201,Bronson Burgoon,8,311,130,181,2013,total_driving,NA
197,T187,Brian Gay,9,312,162,150,2013,total_driving,NA
198,193,Rhein Gibson,9,313,90,223,2013,total_driving,NA
199,T196,Tom Hoge,8,314,185,129,2013,total_driving,NA
200,200,Mark Anderson,7,319,132,187,2013,total_driving,NA
201,204,Smylie Kaufman,3,320,64,256,2013,total_driving,NA
T202,199,Zac Blair,10,322,225,97,2013,total_driving,NA
T202,214,Francesco Molinari,3,322,125,197,2013,total_driving,NA
T204,T170,John Senden,5,324,120,204,2013,total_driving,NA
T204,180,Ben Martin,6,324,223,101,2013,total_driving,NA
T206,T205,James Hahn,6,325,163,162,2013,total_driving,NA
T206,186,Aaron Baddeley,6,325,198,127,2013,total_driving,NA
208,T211,J.J. Spaun,9,330,118,212,2013,total_driving,NA
T209,203,Robert Streb,9,332,141,191,2013,total_driving,NA
T209,T208,Robert Allenby,3,332,164,168,2013,total_driving,NA
211,T211,Martin Trainer,8,339,94,245,2013,total_driving,NA
212,T205,"Ted Potter, Jr.",7,340,151,189,2013,total_driving,NA
213,T201,Chris Stroud,6,341,194,147,2013,total_driving,NA
T214,T205,Rob Oppenheim,10,342,200,142,2013,total_driving,NA
T214,198,Matt Every,7,342,122,220,2013,total_driving,NA
T214,213,Morgan Hoffmann,4,342,143,199,2013,total_driving,NA
217,215,Roberto Díaz,2,345,110,235,2013,total_driving,NA
218,216,Stewart Cink,4,350,112,238,2013,total_driving,NA
219,217,C.T. Pan,5,353,189,164,2013,total_driving,NA
220,T218,Patton Kizzire,9,354,158,196,2013,total_driving,NA
221,222,Hudson Swafford,4,356,183,173,2013,total_driving,NA
222,T218,George McNeill,6,359,145,214,2013,total_driving,NA
223,220,Patrick Reed,4,363,239,124,2013,total_driving,NA
224,221,Jamie Lovemark,4,365,114,251,2013,total_driving,NA
225,224,Luke Donald,2,378,232,146,2013,total_driving,NA
226,226,Bo Van Pelt,7,387,155,232,2013,total_driving,NA
227,225,Davis Love III,3,400,172,228,2013,total_driving,NA
228,228,Arjun Atwal,5,404,173,231,2013,total_driving,NA
T229,231,Daniel Chopra,3,411,157,254,2013,total_driving,NA
T229,227,Kevin Stadler,6,411,217,194,2013,total_driving,NA
231,229,John Rollins,4,414,209,205,2013,total_driving,NA
232,230,Parker McLachlin,4,421,201,220,2013,total_driving,NA
233,232,Peter Malnati,9,422,197,225,2013,total_driving,NA
234,233,Michael Kim,8,435,211,224,2013,total_driving,NA
235,235,Tommy Gainey,4,442,209,233,2013,total_driving,NA
236,234,D.A. Points,4,446,226,220,2013,total_driving,NA
237,236,Ricky Barnes,6,451,214,237,2013,total_driving,NA
238,237,Brendon de Jonge,3,462,205,257,2013,total_driving,NA
239,238,Shugo Imahira,2,490,235,255,2013,total_driving,NA
1,1,Andrew Novak,2,35,17,18,2014,total_driving,NA
2,3,Viktor Hovland,4,63,16,47,2014,total_driving,NA
3,4,Chase Koepka,2,72,34,38,2014,total_driving,NA
4,5,John Oda,2,74,70,4,2014,total_driving,NA
5,6,D.J. Trahan,7,91,47,44,2014,total_driving,NA
6,8,Gary Woodland,4,98,94,4,2014,total_driving,NA
7,9,Branden Grace,4,99,21,78,2014,total_driving,NA
T8,10,Patrick Cantlay,3,103,86,17,2014,total_driving,NA
T8,7,Doc Redman,10,103,77,26,2014,total_driving,NA
10,2,Ryan Moore,5,105,94,11,2014,total_driving,NA
11,13,Scottie Scheffler,8,126,15,111,2014,total_driving,NA
12,T19,Kyoung-Hoon Lee,10,128,106,22,2014,total_driving,NA
13,14,Martin Laird,8,129,42,87,2014,total_driving,NA
14,11,Kevin Streelman,9,130,62,68,2014,total_driving,NA
15,25,Jhonattan Vegas,6,132,24,108,2014,total_driving,NA
T16,15,Nick Taylor,8,133,109,24,2014,total_driving,NA
T16,T23,Brendan Steele,8,133,63,70,2014,total_driving,NA
18,12,Harris English,7,135,36,99,2014,total_driving,NA
T19,T27,Harry Higgs,10,140,79,61,2014,total_driving,NA
T19,T27,Sung Kang,7,140,53,87,2014,total_driving,NA
T21,22,Emiliano Grillo,7,142,110,32,2014,total_driving,NA
T21,18,Bubba Watson,4,142,1,141,2014,total_driving,NA
23,T19,Bryson DeChambeau,3,144,13,131,2014,total_driving,NA
24,T52,Matthew Wolff,5,145,40,105,2014,total_driving,NA
25,29,Joel Dahmen,8,149,100,49,2014,total_driving,NA
26,16,Jason Kokrak,5,153,8,145,2014,total_driving,NA
27,17,Josh Teater,6,156,83,73,2014,total_driving,NA
28,T23,Cameron Champ,7,157,2,155,2014,total_driving,NA
29,33,Ryan Palmer,5,160,146,14,2014,total_driving,NA
30,T35,Adam Hadwin,5,164,121,43,2014,total_driving,NA
31,26,Sungjae Im,8,165,50,115,2014,total_driving,NA
32,31,Henrik Norlander,10,168,132,36,2014,total_driving,NA
T33,38,Boo Weekley,5,169,147,22,2014,total_driving,NA
T33,T35,Harold Varner III,7,169,18,151,2014,total_driving,NA
35,37,Lanto Griffin,10,170,40,130,2014,total_driving,NA
36,T19,Lucas Glover,7,174,98,76,2014,total_driving,NA
37,34,Scott Brown,9,175,151,24,2014,total_driving,NA
38,T44,Sebastián Muñoz,10,176,60,116,2014,total_driving,NA
T39,40,Daniel Berger,6,177,56,121,2014,total_driving,NA
T39,42,Keegan Bradley,7,177,71,106,2014,total_driving,NA
41,39,Chesson Hadley,7,179,106,73,2014,total_driving,NA
42,43,Webb Simpson,3,182,170,12,2014,total_driving,NA
43,48,Danny Lee,7,185,9,176,2014,total_driving,NA
44,T50,Pat Perez,6,186,130,56,2014,total_driving,NA
45,T52,Matthew NeSmith,9,188,154,34,2014,total_driving,NA
46,T99,Sepp Straka,10,191,92,99,2014,total_driving,NA
T47,T90,Isaiah Salinda,3,192,14,178,2014,total_driving,NA
T47,T56,John Merrick,4,192,135,57,2014,total_driving,NA
T49,T50,Jim Furyk,3,193,192,1,2014,total_driving,NA
T49,55,Chad Campbell,4,193,178,15,2014,total_driving,NA
T49,T44,Wyndham Clark,7,193,32,161,2014,total_driving,NA
52,32,Alex Noren,4,195,108,87,2014,total_driving,NA
53,NA,Rickie Fowler,2,196,194,2,2014,total_driving,NA
T54,T56,Tony Finau,5,198,12,186,2014,total_driving,NA
T54,T62,Phil Mickelson,5,198,31,167,2014,total_driving,NA
T54,T62,Aaron Wise,7,198,51,147,2014,total_driving,NA
T54,T69,Chase Seiffert,9,198,127,71,2014,total_driving,NA
T58,T73,Abraham Ancer,8,199,113,86,2014,total_driving,NA
T58,61,Adam Schenk,10,199,33,166,2014,total_driving,NA
T58,T64,Scott Harrington,9,199,34,165,2014,total_driving,NA
T61,T52,Brian Harman,8,200,143,57,2014,total_driving,NA
T61,47,Jason Dufner,7,200,140,60,2014,total_driving,NA
T61,59,Cameron Smith,6,200,77,123,2014,total_driving,NA
T64,46,Kramer Hickok,9,201,124,77,2014,total_driving,NA
T64,60,Matt Jones,8,201,49,152,2014,total_driving,NA
66,30,Robby Shelton,10,202,88,114,2014,total_driving,NA
T67,83,Grayson Murray,6,203,4,199,2014,total_driving,NA
T67,T73,Russell Knox,8,203,138,65,2014,total_driving,NA
69,41,Denny McCarthy,8,204,101,103,2014,total_driving,NA
70,T80,Sam Ryder,10,209,53,156,2014,total_driving,NA
71,58,Brice Garnett,8,214,150,64,2014,total_driving,NA
72,66,Michael Thompson,7,215,175,40,2014,total_driving,NA
73,76,Collin Morikawa,6,216,168,48,2014,total_driving,NA
T74,T69,Derek Ernst,4,217,80,137,2014,total_driving,NA
T74,T67,Adam Long,10,217,189,28,2014,total_driving,NA
T74,96,Andrew Landry,9,217,171,46,2014,total_driving,NA
77,T84,Akshay Bhatia,5,218,7,211,2014,total_driving,NA
78,T69,Rod Pampling,3,220,28,192,2014,total_driving,NA
79,136,Nick Watney,7,222,73,149,2014,total_driving,NA
T80,T84,Hideki Matsuyama,6,223,115,108,2014,total_driving,NA
T80,115,Doug Ghim,7,223,116,107,2014,total_driving,NA
T80,T90,Kristoffer Ventura,9,223,44,179,2014,total_driving,NA
T83,T73,Byeong Hun An,8,225,10,215,2014,total_driving,NA
T83,T90,Chandler Phillips,2,225,57,168,2014,total_driving,NA
T83,T69,Brian Stuard,10,225,215,10,2014,total_driving,NA
T83,T97,Alex Cejka,5,225,175,50,2014,total_driving,NA
T83,T80,Ryan Armour,9,225,217,8,2014,total_driving,NA
T88,T90,Graham DeLaet,5,226,36,190,2014,total_driving,NA
T88,T77,Tim Wilkinson,6,226,189,37,2014,total_driving,NA
T88,T86,Brandon Wu,2,226,188,38,2014,total_driving,NA
T91,T88,Hank Lebioda,9,228,104,124,2014,total_driving,NA
T91,79,Charles Howell III,9,228,69,159,2014,total_driving,NA
93,T67,Tyler McCumber,9,229,11,218,2014,total_driving,NA
94,T90,Fabián Gómez,9,230,167,63,2014,total_driving,NA
95,T90,Brendon Todd,11,231,228,3,2014,total_driving,NA
T96,49,Cameron Percy,8,233,61,172,2014,total_driving,NA
T96,T99,Adam Scott,4,233,46,187,2014,total_driving,NA
T96,T80,Luke List,9,233,80,153,2014,total_driving,NA
T96,T86,Russell Henley,8,233,179,54,2014,total_driving,NA
T96,T130,Mackenzie Hughes,8,233,101,132,2014,total_driving,NA
101,T109,J.T. Poston,9,234,175,59,2014,total_driving,NA
102,T64,Vince Covello,8,235,73,162,2014,total_driving,NA
103,T99,Xinjun Zhang,10,236,116,120,2014,total_driving,NA
104,105,K.J. Choi,3,237,233,4,2014,total_driving,NA
T105,107,Tim Herron,4,238,220,18,2014,total_driving,NA
T105,T109,Corey Conners,7,238,186,52,2014,total_driving,NA
T107,108,Keith Mitchell,7,239,135,104,2014,total_driving,NA
T107,T130,Cameron Davis,8,239,22,217,2014,total_driving,NA
T107,T99,Richy Werenski,4,239,45,194,2014,total_driving,NA
T107,T88,Vaughn Taylor,8,239,212,27,2014,total_driving,NA
111,168,Chris Baker,9,240,168,72,2014,total_driving,NA
T112,T112,Jim Herman,8,241,221,20,2014,total_driving,NA
T112,T127,Scott Piercy,8,241,105,136,2014,total_driving,NA
T114,T120,J.J. Henry,5,242,173,69,2014,total_driving,NA
T114,T103,Tyler Duncan,10,242,221,21,2014,total_driving,NA
116,T112,Davis Riley,2,243,83,160,2014,total_driving,NA
T117,T125,Bo Hoag,10,244,127,117,2014,total_driving,NA
T117,T116,Chez Reavie,9,244,228,16,2014,total_driving,NA
119,T116,Matt Kuchar,4,245,238,7,2014,total_driving,NA
T120,223,Paul Casey,4,247,160,87,2014,total_driving,NA
T120,T116,Satoshi Kodaira,6,247,234,13,2014,total_driving,NA
T120,T127,Shawn Stefani,6,247,73,174,2014,total_driving,NA
123,106,Carlos Ortiz,8,248,67,181,2014,total_driving,NA
124,T122,Ben Crane,6,249,207,42,2014,total_driving,NA
125,T130,Tom Lewis,3,252,5,247,2014,total_driving,NA
126,T139,Michael Gligic,9,253,73,180,2014,total_driving,NA
T127,T139,Scott Stallings,8,254,47,207,2014,total_driving,NA
T127,T137,Kyle Stanley,8,254,213,41,2014,total_driving,NA
T129,T137,Henrik Stenson,2,255,202,53,2014,total_driving,NA
T129,T125,Austin Cook,8,255,127,128,2014,total_driving,NA
T131,T120,Beau Hossler,8,256,29,227,2014,total_driving,NA
T131,T122,Patrick Rodgers,10,256,26,230,2014,total_driving,NA
T131,T143,Sebastian Cappelen,8,256,30,226,2014,total_driving,NA
T131,T133,Kurt Kitayama,2,256,3,253,2014,total_driving,NA
T131,T77,Vincent Whaley,7,256,103,153,2014,total_driving,NA
T131,T141,Ryan Brehm,10,256,6,250,2014,total_driving,NA
137,T122,Mark Hubbard,10,257,149,108,2014,total_driving,NA
T138,T163,Brandon Hagy,8,258,22,236,2014,total_driving,NA
T138,T109,Billy Horschel,6,258,196,62,2014,total_driving,NA
T140,T147,Sam Burns,6,259,20,239,2014,total_driving,NA
T140,T133,David Lingmerth,5,259,230,29,2014,total_driving,NA
T142,T187,Bud Cauley,6,262,125,137,2014,total_driving,NA
T142,T143,Cameron Tringale,7,262,55,207,2014,total_driving,NA
144,T143,Rikuya Hoshino,2,264,138,126,2014,total_driving,NA
145,T155,Jonathan Byrd,5,265,72,193,2014,total_driving,NA
T146,T116,Maverick McNealy,9,266,89,177,2014,total_driving,NA
T146,T147,Xander Schauffele,3,266,231,35,2014,total_driving,NA
T148,154,Whee Kim,2,267,180,87,2014,total_driving,NA
T148,T141,Lucas Bjerregaard,3,267,18,249,2014,total_driving,NA
150,T152,Chip McDaniel,2,268,59,209,2014,total_driving,NA
T151,T178,Max Homa,6,269,187,82,2014,total_driving,NA
T151,T112,Bill Haas,6,269,147,122,2014,total_driving,NA
T151,146,J.B. Holmes,3,269,224,45,2014,total_driving,NA
T154,129,Zack Sucher,6,270,24,246,2014,total_driving,NA
T154,T157,Roberto Castro,5,270,183,87,2014,total_driving,NA
156,151,Kevin Tway,6,271,27,244,2014,total_driving,NA
T157,T155,Kevin Chappell,6,272,43,229,2014,total_driving,NA
T157,T152,Dominic Bozzelli,7,272,38,234,2014,total_driving,NA
T159,T147,David Hearn,9,273,206,67,2014,total_driving,NA
T159,174,Jimmy Walker,4,273,92,181,2014,total_driving,NA
161,165,Sangmoon Bae,6,274,64,210,2014,total_driving,NA
162,167,Michael Gellerman,8,275,135,140,2014,total_driving,NA
163,T159,Kevin Kisner,7,277,227,50,2014,total_driving,NA
T164,T159,Justin Thomas,5,278,161,117,2014,total_driving,NA
T164,T187,Troy Merritt,7,278,182,96,2014,total_driving,NA
T164,T163,Freddie Jacobson,3,278,141,137,2014,total_driving,NA
167,T175,Talor Gooch,8,280,122,158,2014,total_driving,NA
168,T103,Andrew Putnam,6,283,181,102,2014,total_driving,NA
T169,T157,Si Woo Kim,8,284,99,185,2014,total_driving,NA
T169,T97,Charley Hoffman,7,284,87,197,2014,total_driving,NA
T169,169,Seamus Power,5,284,83,201,2014,total_driving,NA
172,T133,John Huh,5,285,166,119,2014,total_driving,NA
T173,T172,Jason Day,3,286,80,206,2014,total_driving,NA
T173,T172,Chris Kirk,3,286,199,87,2014,total_driving,NA
T173,T175,Rafael Campos,9,286,67,219,2014,total_driving,NA
176,T159,Nate Lashley,8,287,204,83,2014,total_driving,NA
177,177,Brandt Snedeker,4,288,155,133,2014,total_driving,NA
178,T178,Peter Uihlein,6,289,38,251,2014,total_driving,NA
179,150,Kevin Na,7,290,203,87,2014,total_driving,NA
180,T170,Ben Taylor,10,291,134,157,2014,total_driving,NA
181,162,Anirban Lahiri,8,292,118,174,2014,total_driving,NA
182,T208,Roger Sloan,8,293,158,135,2014,total_driving,NA
T183,182,Johnson Wagner,5,294,207,87,2014,total_driving,NA
T183,T183,Robert Garrigus,5,294,52,242,2014,total_driving,NA
T183,T187,Wes Roach,7,294,151,143,2014,total_driving,NA
186,181,Zach Johnson,7,299,216,83,2014,total_driving,NA
187,191,Mikumu Horikawa,3,303,237,66,2014,total_driving,NA
T188,194,Will Gordon,4,304,64,240,2014,total_driving,NA
T188,210,Rory Sabbatini,7,304,219,85,2014,total_driving,NA
T188,T183,Dylan Frittelli,9,304,193,111,2014,total_driving,NA
191,185,Nelson Ledesma,10,305,57,248,2014,total_driving,NA
192,192,Marc Leishman,5,306,90,216,2014,total_driving,NA
193,166,Joseph Bramlett,7,307,94,213,2014,total_driving,NA
194,195,Joaquin Niemann,8,308,164,144,2014,total_driving,NA
T195,T196,Graeme McDowell,5,311,236,75,2014,total_driving,NA
T195,T201,Bronson Burgoon,8,311,130,181,2014,total_driving,NA
197,T187,Brian Gay,9,312,162,150,2014,total_driving,NA
198,193,Rhein Gibson,9,313,90,223,2014,total_driving,NA
199,T196,Tom Hoge,8,314,185,129,2014,total_driving,NA
200,200,Mark Anderson,7,319,132,187,2014,total_driving,NA
201,204,Smylie Kaufman,3,320,64,256,2014,total_driving,NA
T202,199,Zac Blair,10,322,225,97,2014,total_driving,NA
T202,214,Francesco Molinari,3,322,125,197,2014,total_driving,NA
T204,T170,John Senden,5,324,120,204,2014,total_driving,NA
T204,180,Ben Martin,6,324,223,101,2014,total_driving,NA
T206,T205,James Hahn,6,325,163,162,2014,total_driving,NA
T206,186,Aaron Baddeley,6,325,198,127,2014,total_driving,NA
208,T211,J.J. Spaun,9,330,118,212,2014,total_driving,NA
T209,203,Robert Streb,9,332,141,191,2014,total_driving,NA
T209,T208,Robert Allenby,3,332,164,168,2014,total_driving,NA
211,T211,Martin Trainer,8,339,94,245,2014,total_driving,NA
212,T205,"Ted Potter, Jr.",7,340,151,189,2014,total_driving,NA
213,T201,Chris Stroud,6,341,194,147,2014,total_driving,NA
T214,T205,Rob Oppenheim,10,342,200,142,2014,total_driving,NA
T214,198,Matt Every,7,342,122,220,2014,total_driving,NA
T214,213,Morgan Hoffmann,4,342,143,199,2014,total_driving,NA
217,215,Roberto Díaz,2,345,110,235,2014,total_driving,NA
218,216,Stewart Cink,4,350,112,238,2014,total_driving,NA
219,217,C.T. Pan,5,353,189,164,2014,total_driving,NA
220,T218,Patton Kizzire,9,354,158,196,2014,total_driving,NA
221,222,Hudson Swafford,4,356,183,173,2014,total_driving,NA
222,T218,George McNeill,6,359,145,214,2014,total_driving,NA
223,220,Patrick Reed,4,363,239,124,2014,total_driving,NA
224,221,Jamie Lovemark,4,365,114,251,2014,total_driving,NA
225,224,Luke Donald,2,378,232,146,2014,total_driving,NA
226,226,Bo Van Pelt,7,387,155,232,2014,total_driving,NA
227,225,Davis Love III,3,400,172,228,2014,total_driving,NA
228,228,Arjun Atwal,5,404,173,231,2014,total_driving,NA
T229,231,Daniel Chopra,3,411,157,254,2014,total_driving,NA
T229,227,Kevin Stadler,6,411,217,194,2014,total_driving,NA
231,229,John Rollins,4,414,209,205,2014,total_driving,NA
232,230,Parker McLachlin,4,421,201,220,2014,total_driving,NA
233,232,Peter Malnati,9,422,197,225,2014,total_driving,NA
234,233,Michael Kim,8,435,211,224,2014,total_driving,NA
235,235,Tommy Gainey,4,442,209,233,2014,total_driving,NA
236,234,D.A. Points,4,446,226,220,2014,total_driving,NA
237,236,Ricky Barnes,6,451,214,237,2014,total_driving,NA
238,237,Brendon de Jonge,3,462,205,257,2014,total_driving,NA
239,238,Shugo Imahira,2,490,235,255,2014,total_driving,NA
1,1,Andrew Novak,2,35,17,18,2015,total_driving,NA
2,3,Viktor Hovland,4,63,16,47,2015,total_driving,NA
3,4,Chase Koepka,2,72,34,38,2015,total_driving,NA
4,5,John Oda,2,74,70,4,2015,total_driving,NA
5,6,D.J. Trahan,7,91,47,44,2015,total_driving,NA
6,8,Gary Woodland,4,98,94,4,2015,total_driving,NA
7,9,Branden Grace,4,99,21,78,2015,total_driving,NA
T8,10,Patrick Cantlay,3,103,86,17,2015,total_driving,NA
T8,7,Doc Redman,10,103,77,26,2015,total_driving,NA
10,2,Ryan Moore,5,105,94,11,2015,total_driving,NA
11,13,Scottie Scheffler,8,126,15,111,2015,total_driving,NA
12,T19,Kyoung-Hoon Lee,10,128,106,22,2015,total_driving,NA
13,14,Martin Laird,8,129,42,87,2015,total_driving,NA
14,11,Kevin Streelman,9,130,62,68,2015,total_driving,NA
15,25,Jhonattan Vegas,6,132,24,108,2015,total_driving,NA
T16,15,Nick Taylor,8,133,109,24,2015,total_driving,NA
T16,T23,Brendan Steele,8,133,63,70,2015,total_driving,NA
18,12,Harris English,7,135,36,99,2015,total_driving,NA
T19,T27,Harry Higgs,10,140,79,61,2015,total_driving,NA
T19,T27,Sung Kang,7,140,53,87,2015,total_driving,NA
T21,22,Emiliano Grillo,7,142,110,32,2015,total_driving,NA
T21,18,Bubba Watson,4,142,1,141,2015,total_driving,NA
23,T19,Bryson DeChambeau,3,144,13,131,2015,total_driving,NA
24,T52,Matthew Wolff,5,145,40,105,2015,total_driving,NA
25,29,Joel Dahmen,8,149,100,49,2015,total_driving,NA
26,16,Jason Kokrak,5,153,8,145,2015,total_driving,NA
27,17,Josh Teater,6,156,83,73,2015,total_driving,NA
28,T23,Cameron Champ,7,157,2,155,2015,total_driving,NA
29,33,Ryan Palmer,5,160,146,14,2015,total_driving,NA
30,T35,Adam Hadwin,5,164,121,43,2015,total_driving,NA
31,26,Sungjae Im,8,165,50,115,2015,total_driving,NA
32,31,Henrik Norlander,10,168,132,36,2015,total_driving,NA
T33,38,Boo Weekley,5,169,147,22,2015,total_driving,NA
T33,T35,Harold Varner III,7,169,18,151,2015,total_driving,NA
35,37,Lanto Griffin,10,170,40,130,2015,total_driving,NA
36,T19,Lucas Glover,7,174,98,76,2015,total_driving,NA
37,34,Scott Brown,9,175,151,24,2015,total_driving,NA
38,T44,Sebastián Muñoz,10,176,60,116,2015,total_driving,NA
T39,40,Daniel Berger,6,177,56,121,2015,total_driving,NA
T39,42,Keegan Bradley,7,177,71,106,2015,total_driving,NA
41,39,Chesson Hadley,7,179,106,73,2015,total_driving,NA
42,43,Webb Simpson,3,182,170,12,2015,total_driving,NA
43,48,Danny Lee,7,185,9,176,2015,total_driving,NA
44,T50,Pat Perez,6,186,130,56,2015,total_driving,NA
45,T52,Matthew NeSmith,9,188,154,34,2015,total_driving,NA
46,T99,Sepp Straka,10,191,92,99,2015,total_driving,NA
T47,T90,Isaiah Salinda,3,192,14,178,2015,total_driving,NA
T47,T56,John Merrick,4,192,135,57,2015,total_driving,NA
T49,T50,Jim Furyk,3,193,192,1,2015,total_driving,NA
T49,55,Chad Campbell,4,193,178,15,2015,total_driving,NA
T49,T44,Wyndham Clark,7,193,32,161,2015,total_driving,NA
52,32,Alex Noren,4,195,108,87,2015,total_driving,NA
53,NA,Rickie Fowler,2,196,194,2,2015,total_driving,NA
T54,T56,Tony Finau,5,198,12,186,2015,total_driving,NA
T54,T62,Phil Mickelson,5,198,31,167,2015,total_driving,NA
T54,T62,Aaron Wise,7,198,51,147,2015,total_driving,NA
T54,T69,Chase Seiffert,9,198,127,71,2015,total_driving,NA
T58,T73,Abraham Ancer,8,199,113,86,2015,total_driving,NA
T58,61,Adam Schenk,10,199,33,166,2015,total_driving,NA
T58,T64,Scott Harrington,9,199,34,165,2015,total_driving,NA
T61,T52,Brian Harman,8,200,143,57,2015,total_driving,NA
T61,47,Jason Dufner,7,200,140,60,2015,total_driving,NA
T61,59,Cameron Smith,6,200,77,123,2015,total_driving,NA
T64,46,Kramer Hickok,9,201,124,77,2015,total_driving,NA
T64,60,Matt Jones,8,201,49,152,2015,total_driving,NA
66,30,Robby Shelton,10,202,88,114,2015,total_driving,NA
T67,83,Grayson Murray,6,203,4,199,2015,total_driving,NA
T67,T73,Russell Knox,8,203,138,65,2015,total_driving,NA
69,41,Denny McCarthy,8,204,101,103,2015,total_driving,NA
70,T80,Sam Ryder,10,209,53,156,2015,total_driving,NA
71,58,Brice Garnett,8,214,150,64,2015,total_driving,NA
72,66,Michael Thompson,7,215,175,40,2015,total_driving,NA
73,76,Collin Morikawa,6,216,168,48,2015,total_driving,NA
T74,T69,Derek Ernst,4,217,80,137,2015,total_driving,NA
T74,T67,Adam Long,10,217,189,28,2015,total_driving,NA
T74,96,Andrew Landry,9,217,171,46,2015,total_driving,NA
77,T84,Akshay Bhatia,5,218,7,211,2015,total_driving,NA
78,T69,Rod Pampling,3,220,28,192,2015,total_driving,NA
79,136,Nick Watney,7,222,73,149,2015,total_driving,NA
T80,T84,Hideki Matsuyama,6,223,115,108,2015,total_driving,NA
T80,115,Doug Ghim,7,223,116,107,2015,total_driving,NA
T80,T90,Kristoffer Ventura,9,223,44,179,2015,total_driving,NA
T83,T73,Byeong Hun An,8,225,10,215,2015,total_driving,NA
T83,T90,Chandler Phillips,2,225,57,168,2015,total_driving,NA
T83,T69,Brian Stuard,10,225,215,10,2015,total_driving,NA
T83,T97,Alex Cejka,5,225,175,50,2015,total_driving,NA
T83,T80,Ryan Armour,9,225,217,8,2015,total_driving,NA
T88,T90,Graham DeLaet,5,226,36,190,2015,total_driving,NA
T88,T77,Tim Wilkinson,6,226,189,37,2015,total_driving,NA
T88,T86,Brandon Wu,2,226,188,38,2015,total_driving,NA
T91,T88,Hank Lebioda,9,228,104,124,2015,total_driving,NA
T91,79,Charles Howell III,9,228,69,159,2015,total_driving,NA
93,T67,Tyler McCumber,9,229,11,218,2015,total_driving,NA
94,T90,Fabián Gómez,9,230,167,63,2015,total_driving,NA
95,T90,Brendon Todd,11,231,228,3,2015,total_driving,NA
T96,49,Cameron Percy,8,233,61,172,2015,total_driving,NA
T96,T99,Adam Scott,4,233,46,187,2015,total_driving,NA
T96,T80,Luke List,9,233,80,153,2015,total_driving,NA
T96,T86,Russell Henley,8,233,179,54,2015,total_driving,NA
T96,T130,Mackenzie Hughes,8,233,101,132,2015,total_driving,NA
101,T109,J.T. Poston,9,234,175,59,2015,total_driving,NA
102,T64,Vince Covello,8,235,73,162,2015,total_driving,NA
103,T99,Xinjun Zhang,10,236,116,120,2015,total_driving,NA
104,105,K.J. Choi,3,237,233,4,2015,total_driving,NA
T105,107,Tim Herron,4,238,220,18,2015,total_driving,NA
T105,T109,Corey Conners,7,238,186,52,2015,total_driving,NA
T107,108,Keith Mitchell,7,239,135,104,2015,total_driving,NA
T107,T130,Cameron Davis,8,239,22,217,2015,total_driving,NA
T107,T99,Richy Werenski,4,239,45,194,2015,total_driving,NA
T107,T88,Vaughn Taylor,8,239,212,27,2015,total_driving,NA
111,168,Chris Baker,9,240,168,72,2015,total_driving,NA
T112,T112,Jim Herman,8,241,221,20,2015,total_driving,NA
T112,T127,Scott Piercy,8,241,105,136,2015,total_driving,NA
T114,T120,J.J. Henry,5,242,173,69,2015,total_driving,NA
T114,T103,Tyler Duncan,10,242,221,21,2015,total_driving,NA
116,T112,Davis Riley,2,243,83,160,2015,total_driving,NA
T117,T125,Bo Hoag,10,244,127,117,2015,total_driving,NA
T117,T116,Chez Reavie,9,244,228,16,2015,total_driving,NA
119,T116,Matt Kuchar,4,245,238,7,2015,total_driving,NA
T120,223,Paul Casey,4,247,160,87,2015,total_driving,NA
T120,T116,Satoshi Kodaira,6,247,234,13,2015,total_driving,NA
T120,T127,Shawn Stefani,6,247,73,174,2015,total_driving,NA
123,106,Carlos Ortiz,8,248,67,181,2015,total_driving,NA
124,T122,Ben Crane,6,249,207,42,2015,total_driving,NA
125,T130,Tom Lewis,3,252,5,247,2015,total_driving,NA
126,T139,Michael Gligic,9,253,73,180,2015,total_driving,NA
T127,T139,Scott Stallings,8,254,47,207,2015,total_driving,NA
T127,T137,Kyle Stanley,8,254,213,41,2015,total_driving,NA
T129,T137,Henrik Stenson,2,255,202,53,2015,total_driving,NA
T129,T125,Austin Cook,8,255,127,128,2015,total_driving,NA
T131,T120,Beau Hossler,8,256,29,227,2015,total_driving,NA
T131,T122,Patrick Rodgers,10,256,26,230,2015,total_driving,NA
T131,T143,Sebastian Cappelen,8,256,30,226,2015,total_driving,NA
T131,T133,Kurt Kitayama,2,256,3,253,2015,total_driving,NA
T131,T77,Vincent Whaley,7,256,103,153,2015,total_driving,NA
T131,T141,Ryan Brehm,10,256,6,250,2015,total_driving,NA
137,T122,Mark Hubbard,10,257,149,108,2015,total_driving,NA
T138,T163,Brandon Hagy,8,258,22,236,2015,total_driving,NA
T138,T109,Billy Horschel,6,258,196,62,2015,total_driving,NA
T140,T147,Sam Burns,6,259,20,239,2015,total_driving,NA
T140,T133,David Lingmerth,5,259,230,29,2015,total_driving,NA
T142,T187,Bud Cauley,6,262,125,137,2015,total_driving,NA
T142,T143,Cameron Tringale,7,262,55,207,2015,total_driving,NA
144,T143,Rikuya Hoshino,2,264,138,126,2015,total_driving,NA
145,T155,Jonathan Byrd,5,265,72,193,2015,total_driving,NA
T146,T116,Maverick McNealy,9,266,89,177,2015,total_driving,NA
T146,T147,Xander Schauffele,3,266,231,35,2015,total_driving,NA
T148,154,Whee Kim,2,267,180,87,2015,total_driving,NA
T148,T141,Lucas Bjerregaard,3,267,18,249,2015,total_driving,NA
150,T152,Chip McDaniel,2,268,59,209,2015,total_driving,NA
T151,T178,Max Homa,6,269,187,82,2015,total_driving,NA
T151,T112,Bill Haas,6,269,147,122,2015,total_driving,NA
T151,146,J.B. Holmes,3,269,224,45,2015,total_driving,NA
T154,129,Zack Sucher,6,270,24,246,2015,total_driving,NA
T154,T157,Roberto Castro,5,270,183,87,2015,total_driving,NA
156,151,Kevin Tway,6,271,27,244,2015,total_driving,NA
T157,T155,Kevin Chappell,6,272,43,229,2015,total_driving,NA
T157,T152,Dominic Bozzelli,7,272,38,234,2015,total_driving,NA
T159,T147,David Hearn,9,273,206,67,2015,total_driving,NA
T159,174,Jimmy Walker,4,273,92,181,2015,total_driving,NA
161,165,Sangmoon Bae,6,274,64,210,2015,total_driving,NA
162,167,Michael Gellerman,8,275,135,140,2015,total_driving,NA
163,T159,Kevin Kisner,7,277,227,50,2015,total_driving,NA
T164,T159,Justin Thomas,5,278,161,117,2015,total_driving,NA
T164,T187,Troy Merritt,7,278,182,96,2015,total_driving,NA
T164,T163,Freddie Jacobson,3,278,141,137,2015,total_driving,NA
167,T175,Talor Gooch,8,280,122,158,2015,total_driving,NA
168,T103,Andrew Putnam,6,283,181,102,2015,total_driving,NA
T169,T157,Si Woo Kim,8,284,99,185,2015,total_driving,NA
T169,T97,Charley Hoffman,7,284,87,197,2015,total_driving,NA
T169,169,Seamus Power,5,284,83,201,2015,total_driving,NA
172,T133,John Huh,5,285,166,119,2015,total_driving,NA
T173,T172,Jason Day,3,286,80,206,2015,total_driving,NA
T173,T172,Chris Kirk,3,286,199,87,2015,total_driving,NA
T173,T175,Rafael Campos,9,286,67,219,2015,total_driving,NA
176,T159,Nate Lashley,8,287,204,83,2015,total_driving,NA
177,177,Brandt Snedeker,4,288,155,133,2015,total_driving,NA
178,T178,Peter Uihlein,6,289,38,251,2015,total_driving,NA
179,150,Kevin Na,7,290,203,87,2015,total_driving,NA
180,T170,Ben Taylor,10,291,134,157,2015,total_driving,NA
181,162,Anirban Lahiri,8,292,118,174,2015,total_driving,NA
182,T208,Roger Sloan,8,293,158,135,2015,total_driving,NA
T183,182,Johnson Wagner,5,294,207,87,2015,total_driving,NA
T183,T183,Robert Garrigus,5,294,52,242,2015,total_driving,NA
T183,T187,Wes Roach,7,294,151,143,2015,total_driving,NA
186,181,Zach Johnson,7,299,216,83,2015,total_driving,NA
187,191,Mikumu Horikawa,3,303,237,66,2015,total_driving,NA
T188,194,Will Gordon,4,304,64,240,2015,total_driving,NA
T188,210,Rory Sabbatini,7,304,219,85,2015,total_driving,NA
T188,T183,Dylan Frittelli,9,304,193,111,2015,total_driving,NA
191,185,Nelson Ledesma,10,305,57,248,2015,total_driving,NA
192,192,Marc Leishman,5,306,90,216,2015,total_driving,NA
193,166,Joseph Bramlett,7,307,94,213,2015,total_driving,NA
194,195,Joaquin Niemann,8,308,164,144,2015,total_driving,NA
T195,T196,Graeme McDowell,5,311,236,75,2015,total_driving,NA
T195,T201,Bronson Burgoon,8,311,130,181,2015,total_driving,NA
197,T187,Brian Gay,9,312,162,150,2015,total_driving,NA
198,193,Rhein Gibson,9,313,90,223,2015,total_driving,NA
199,T196,Tom Hoge,8,314,185,129,2015,total_driving,NA
200,200,Mark Anderson,7,319,132,187,2015,total_driving,NA
201,204,Smylie Kaufman,3,320,64,256,2015,total_driving,NA
T202,199,Zac Blair,10,322,225,97,2015,total_driving,NA
T202,214,Francesco Molinari,3,322,125,197,2015,total_driving,NA
T204,T170,John Senden,5,324,120,204,2015,total_driving,NA
T204,180,Ben Martin,6,324,223,101,2015,total_driving,NA
T206,T205,James Hahn,6,325,163,162,2015,total_driving,NA
T206,186,Aaron Baddeley,6,325,198,127,2015,total_driving,NA
208,T211,J.J. Spaun,9,330,118,212,2015,total_driving,NA
T209,203,Robert Streb,9,332,141,191,2015,total_driving,NA
T209,T208,Robert Allenby,3,332,164,168,2015,total_driving,NA
211,T211,Martin Trainer,8,339,94,245,2015,total_driving,NA
212,T205,"Ted Potter, Jr.",7,340,151,189,2015,total_driving,NA
213,T201,Chris Stroud,6,341,194,147,2015,total_driving,NA
T214,T205,Rob Oppenheim,10,342,200,142,2015,total_driving,NA
T214,198,Matt Every,7,342,122,220,2015,total_driving,NA
T214,213,Morgan Hoffmann,4,342,143,199,2015,total_driving,NA
217,215,Roberto Díaz,2,345,110,235,2015,total_driving,NA
218,216,Stewart Cink,4,350,112,238,2015,total_driving,NA
219,217,C.T. Pan,5,353,189,164,2015,total_driving,NA
220,T218,Patton Kizzire,9,354,158,196,2015,total_driving,NA
221,222,Hudson Swafford,4,356,183,173,2015,total_driving,NA
222,T218,George McNeill,6,359,145,214,2015,total_driving,NA
223,220,Patrick Reed,4,363,239,124,2015,total_driving,NA
224,221,Jamie Lovemark,4,365,114,251,2015,total_driving,NA
225,224,Luke Donald,2,378,232,146,2015,total_driving,NA
226,226,Bo Van Pelt,7,387,155,232,2015,total_driving,NA
227,225,Davis Love III,3,400,172,228,2015,total_driving,NA
228,228,Arjun Atwal,5,404,173,231,2015,total_driving,NA
T229,231,Daniel Chopra,3,411,157,254,2015,total_driving,NA
T229,227,Kevin Stadler,6,411,217,194,2015,total_driving,NA
231,229,John Rollins,4,414,209,205,2015,total_driving,NA
232,230,Parker McLachlin,4,421,201,220,2015,total_driving,NA
233,232,Peter Malnati,9,422,197,225,2015,total_driving,NA
234,233,Michael Kim,8,435,211,224,2015,total_driving,NA
235,235,Tommy Gainey,4,442,209,233,2015,total_driving,NA
236,234,D.A. Points,4,446,226,220,2015,total_driving,NA
237,236,Ricky Barnes,6,451,214,237,2015,total_driving,NA
238,237,Brendon de Jonge,3,462,205,257,2015,total_driving,NA
239,238,Shugo Imahira,2,490,235,255,2015,total_driving,NA
1,1,Andrew Novak,2,35,17,18,2016,total_driving,NA
2,3,Viktor Hovland,4,63,16,47,2016,total_driving,NA
3,4,Chase Koepka,2,72,34,38,2016,total_driving,NA
4,5,John Oda,2,74,70,4,2016,total_driving,NA
5,6,D.J. Trahan,7,91,47,44,2016,total_driving,NA
6,8,Gary Woodland,4,98,94,4,2016,total_driving,NA
7,9,Branden Grace,4,99,21,78,2016,total_driving,NA
T8,10,Patrick Cantlay,3,103,86,17,2016,total_driving,NA
T8,7,Doc Redman,10,103,77,26,2016,total_driving,NA
10,2,Ryan Moore,5,105,94,11,2016,total_driving,NA
11,13,Scottie Scheffler,8,126,15,111,2016,total_driving,NA
12,T19,Kyoung-Hoon Lee,10,128,106,22,2016,total_driving,NA
13,14,Martin Laird,8,129,42,87,2016,total_driving,NA
14,11,Kevin Streelman,9,130,62,68,2016,total_driving,NA
15,25,Jhonattan Vegas,6,132,24,108,2016,total_driving,NA
T16,15,Nick Taylor,8,133,109,24,2016,total_driving,NA
T16,T23,Brendan Steele,8,133,63,70,2016,total_driving,NA
18,12,Harris English,7,135,36,99,2016,total_driving,NA
T19,T27,Harry Higgs,10,140,79,61,2016,total_driving,NA
T19,T27,Sung Kang,7,140,53,87,2016,total_driving,NA
T21,22,Emiliano Grillo,7,142,110,32,2016,total_driving,NA
T21,18,Bubba Watson,4,142,1,141,2016,total_driving,NA
23,T19,Bryson DeChambeau,3,144,13,131,2016,total_driving,NA
24,T52,Matthew Wolff,5,145,40,105,2016,total_driving,NA
25,29,Joel Dahmen,8,149,100,49,2016,total_driving,NA
26,16,Jason Kokrak,5,153,8,145,2016,total_driving,NA
27,17,Josh Teater,6,156,83,73,2016,total_driving,NA
28,T23,Cameron Champ,7,157,2,155,2016,total_driving,NA
29,33,Ryan Palmer,5,160,146,14,2016,total_driving,NA
30,T35,Adam Hadwin,5,164,121,43,2016,total_driving,NA
31,26,Sungjae Im,8,165,50,115,2016,total_driving,NA
32,31,Henrik Norlander,10,168,132,36,2016,total_driving,NA
T33,38,Boo Weekley,5,169,147,22,2016,total_driving,NA
T33,T35,Harold Varner III,7,169,18,151,2016,total_driving,NA
35,37,Lanto Griffin,10,170,40,130,2016,total_driving,NA
36,T19,Lucas Glover,7,174,98,76,2016,total_driving,NA
37,34,Scott Brown,9,175,151,24,2016,total_driving,NA
38,T44,Sebastián Muñoz,10,176,60,116,2016,total_driving,NA
T39,40,Daniel Berger,6,177,56,121,2016,total_driving,NA
T39,42,Keegan Bradley,7,177,71,106,2016,total_driving,NA
41,39,Chesson Hadley,7,179,106,73,2016,total_driving,NA
42,43,Webb Simpson,3,182,170,12,2016,total_driving,NA
43,48,Danny Lee,7,185,9,176,2016,total_driving,NA
44,T50,Pat Perez,6,186,130,56,2016,total_driving,NA
45,T52,Matthew NeSmith,9,188,154,34,2016,total_driving,NA
46,T99,Sepp Straka,10,191,92,99,2016,total_driving,NA
T47,T90,Isaiah Salinda,3,192,14,178,2016,total_driving,NA
T47,T56,John Merrick,4,192,135,57,2016,total_driving,NA
T49,T50,Jim Furyk,3,193,192,1,2016,total_driving,NA
T49,55,Chad Campbell,4,193,178,15,2016,total_driving,NA
T49,T44,Wyndham Clark,7,193,32,161,2016,total_driving,NA
52,32,Alex Noren,4,195,108,87,2016,total_driving,NA
53,NA,Rickie Fowler,2,196,194,2,2016,total_driving,NA
T54,T56,Tony Finau,5,198,12,186,2016,total_driving,NA
T54,T62,Phil Mickelson,5,198,31,167,2016,total_driving,NA
T54,T62,Aaron Wise,7,198,51,147,2016,total_driving,NA
T54,T69,Chase Seiffert,9,198,127,71,2016,total_driving,NA
T58,T73,Abraham Ancer,8,199,113,86,2016,total_driving,NA
T58,61,Adam Schenk,10,199,33,166,2016,total_driving,NA
T58,T64,Scott Harrington,9,199,34,165,2016,total_driving,NA
T61,T52,Brian Harman,8,200,143,57,2016,total_driving,NA
T61,47,Jason Dufner,7,200,140,60,2016,total_driving,NA
T61,59,Cameron Smith,6,200,77,123,2016,total_driving,NA
T64,46,Kramer Hickok,9,201,124,77,2016,total_driving,NA
T64,60,Matt Jones,8,201,49,152,2016,total_driving,NA
66,30,Robby Shelton,10,202,88,114,2016,total_driving,NA
T67,83,Grayson Murray,6,203,4,199,2016,total_driving,NA
T67,T73,Russell Knox,8,203,138,65,2016,total_driving,NA
69,41,Denny McCarthy,8,204,101,103,2016,total_driving,NA
70,T80,Sam Ryder,10,209,53,156,2016,total_driving,NA
71,58,Brice Garnett,8,214,150,64,2016,total_driving,NA
72,66,Michael Thompson,7,215,175,40,2016,total_driving,NA
73,76,Collin Morikawa,6,216,168,48,2016,total_driving,NA
T74,T69,Derek Ernst,4,217,80,137,2016,total_driving,NA
T74,T67,Adam Long,10,217,189,28,2016,total_driving,NA
T74,96,Andrew Landry,9,217,171,46,2016,total_driving,NA
77,T84,Akshay Bhatia,5,218,7,211,2016,total_driving,NA
78,T69,Rod Pampling,3,220,28,192,2016,total_driving,NA
79,136,Nick Watney,7,222,73,149,2016,total_driving,NA
T80,T84,Hideki Matsuyama,6,223,115,108,2016,total_driving,NA
T80,115,Doug Ghim,7,223,116,107,2016,total_driving,NA
T80,T90,Kristoffer Ventura,9,223,44,179,2016,total_driving,NA
T83,T73,Byeong Hun An,8,225,10,215,2016,total_driving,NA
T83,T90,Chandler Phillips,2,225,57,168,2016,total_driving,NA
T83,T69,Brian Stuard,10,225,215,10,2016,total_driving,NA
T83,T97,Alex Cejka,5,225,175,50,2016,total_driving,NA
T83,T80,Ryan Armour,9,225,217,8,2016,total_driving,NA
T88,T90,Graham DeLaet,5,226,36,190,2016,total_driving,NA
T88,T77,Tim Wilkinson,6,226,189,37,2016,total_driving,NA
T88,T86,Brandon Wu,2,226,188,38,2016,total_driving,NA
T91,T88,Hank Lebioda,9,228,104,124,2016,total_driving,NA
T91,79,Charles Howell III,9,228,69,159,2016,total_driving,NA
93,T67,Tyler McCumber,9,229,11,218,2016,total_driving,NA
94,T90,Fabián Gómez,9,230,167,63,2016,total_driving,NA
95,T90,Brendon Todd,11,231,228,3,2016,total_driving,NA
T96,49,Cameron Percy,8,233,61,172,2016,total_driving,NA
T96,T99,Adam Scott,4,233,46,187,2016,total_driving,NA
T96,T80,Luke List,9,233,80,153,2016,total_driving,NA
T96,T86,Russell Henley,8,233,179,54,2016,total_driving,NA
T96,T130,Mackenzie Hughes,8,233,101,132,2016,total_driving,NA
101,T109,J.T. Poston,9,234,175,59,2016,total_driving,NA
102,T64,Vince Covello,8,235,73,162,2016,total_driving,NA
103,T99,Xinjun Zhang,10,236,116,120,2016,total_driving,NA
104,105,K.J. Choi,3,237,233,4,2016,total_driving,NA
T105,107,Tim Herron,4,238,220,18,2016,total_driving,NA
T105,T109,Corey Conners,7,238,186,52,2016,total_driving,NA
T107,108,Keith Mitchell,7,239,135,104,2016,total_driving,NA
T107,T130,Cameron Davis,8,239,22,217,2016,total_driving,NA
T107,T99,Richy Werenski,4,239,45,194,2016,total_driving,NA
T107,T88,Vaughn Taylor,8,239,212,27,2016,total_driving,NA
111,168,Chris Baker,9,240,168,72,2016,total_driving,NA
T112,T112,Jim Herman,8,241,221,20,2016,total_driving,NA
T112,T127,Scott Piercy,8,241,105,136,2016,total_driving,NA
T114,T120,J.J. Henry,5,242,173,69,2016,total_driving,NA
T114,T103,Tyler Duncan,10,242,221,21,2016,total_driving,NA
116,T112,Davis Riley,2,243,83,160,2016,total_driving,NA
T117,T125,Bo Hoag,10,244,127,117,2016,total_driving,NA
T117,T116,Chez Reavie,9,244,228,16,2016,total_driving,NA
119,T116,Matt Kuchar,4,245,238,7,2016,total_driving,NA
T120,223,Paul Casey,4,247,160,87,2016,total_driving,NA
T120,T116,Satoshi Kodaira,6,247,234,13,2016,total_driving,NA
T120,T127,Shawn Stefani,6,247,73,174,2016,total_driving,NA
123,106,Carlos Ortiz,8,248,67,181,2016,total_driving,NA
124,T122,Ben Crane,6,249,207,42,2016,total_driving,NA
125,T130,Tom Lewis,3,252,5,247,2016,total_driving,NA
126,T139,Michael Gligic,9,253,73,180,2016,total_driving,NA
T127,T139,Scott Stallings,8,254,47,207,2016,total_driving,NA
T127,T137,Kyle Stanley,8,254,213,41,2016,total_driving,NA
T129,T137,Henrik Stenson,2,255,202,53,2016,total_driving,NA
T129,T125,Austin Cook,8,255,127,128,2016,total_driving,NA
T131,T120,Beau Hossler,8,256,29,227,2016,total_driving,NA
T131,T122,Patrick Rodgers,10,256,26,230,2016,total_driving,NA
T131,T143,Sebastian Cappelen,8,256,30,226,2016,total_driving,NA
T131,T133,Kurt Kitayama,2,256,3,253,2016,total_driving,NA
T131,T77,Vincent Whaley,7,256,103,153,2016,total_driving,NA
T131,T141,Ryan Brehm,10,256,6,250,2016,total_driving,NA
137,T122,Mark Hubbard,10,257,149,108,2016,total_driving,NA
T138,T163,Brandon Hagy,8,258,22,236,2016,total_driving,NA
T138,T109,Billy Horschel,6,258,196,62,2016,total_driving,NA
T140,T147,Sam Burns,6,259,20,239,2016,total_driving,NA
T140,T133,David Lingmerth,5,259,230,29,2016,total_driving,NA
T142,T187,Bud Cauley,6,262,125,137,2016,total_driving,NA
T142,T143,Cameron Tringale,7,262,55,207,2016,total_driving,NA
144,T143,Rikuya Hoshino,2,264,138,126,2016,total_driving,NA
145,T155,Jonathan Byrd,5,265,72,193,2016,total_driving,NA
T146,T116,Maverick McNealy,9,266,89,177,2016,total_driving,NA
T146,T147,Xander Schauffele,3,266,231,35,2016,total_driving,NA
T148,154,Whee Kim,2,267,180,87,2016,total_driving,NA
T148,T141,Lucas Bjerregaard,3,267,18,249,2016,total_driving,NA
150,T152,Chip McDaniel,2,268,59,209,2016,total_driving,NA
T151,T178,Max Homa,6,269,187,82,2016,total_driving,NA
T151,T112,Bill Haas,6,269,147,122,2016,total_driving,NA
T151,146,J.B. Holmes,3,269,224,45,2016,total_driving,NA
T154,129,Zack Sucher,6,270,24,246,2016,total_driving,NA
T154,T157,Roberto Castro,5,270,183,87,2016,total_driving,NA
156,151,Kevin Tway,6,271,27,244,2016,total_driving,NA
T157,T155,Kevin Chappell,6,272,43,229,2016,total_driving,NA
T157,T152,Dominic Bozzelli,7,272,38,234,2016,total_driving,NA
T159,T147,David Hearn,9,273,206,67,2016,total_driving,NA
T159,174,Jimmy Walker,4,273,92,181,2016,total_driving,NA
161,165,Sangmoon Bae,6,274,64,210,2016,total_driving,NA
162,167,Michael Gellerman,8,275,135,140,2016,total_driving,NA
163,T159,Kevin Kisner,7,277,227,50,2016,total_driving,NA
T164,T159,Justin Thomas,5,278,161,117,2016,total_driving,NA
T164,T187,Troy Merritt,7,278,182,96,2016,total_driving,NA
T164,T163,Freddie Jacobson,3,278,141,137,2016,total_driving,NA
167,T175,Talor Gooch,8,280,122,158,2016,total_driving,NA
168,T103,Andrew Putnam,6,283,181,102,2016,total_driving,NA
T169,T157,Si Woo Kim,8,284,99,185,2016,total_driving,NA
T169,T97,Charley Hoffman,7,284,87,197,2016,total_driving,NA
T169,169,Seamus Power,5,284,83,201,2016,total_driving,NA
172,T133,John Huh,5,285,166,119,2016,total_driving,NA
T173,T172,Jason Day,3,286,80,206,2016,total_driving,NA
T173,T172,Chris Kirk,3,286,199,87,2016,total_driving,NA
T173,T175,Rafael Campos,9,286,67,219,2016,total_driving,NA
176,T159,Nate Lashley,8,287,204,83,2016,total_driving,NA
177,177,Brandt Snedeker,4,288,155,133,2016,total_driving,NA
178,T178,Peter Uihlein,6,289,38,251,2016,total_driving,NA
179,150,Kevin Na,7,290,203,87,2016,total_driving,NA
180,T170,Ben Taylor,10,291,134,157,2016,total_driving,NA
181,162,Anirban Lahiri,8,292,118,174,2016,total_driving,NA
182,T208,Roger Sloan,8,293,158,135,2016,total_driving,NA
T183,182,Johnson Wagner,5,294,207,87,2016,total_driving,NA
T183,T183,Robert Garrigus,5,294,52,242,2016,total_driving,NA
T183,T187,Wes Roach,7,294,151,143,2016,total_driving,NA
186,181,Zach Johnson,7,299,216,83,2016,total_driving,NA
187,191,Mikumu Horikawa,3,303,237,66,2016,total_driving,NA
T188,194,Will Gordon,4,304,64,240,2016,total_driving,NA
T188,210,Rory Sabbatini,7,304,219,85,2016,total_driving,NA
T188,T183,Dylan Frittelli,9,304,193,111,2016,total_driving,NA
191,185,Nelson Ledesma,10,305,57,248,2016,total_driving,NA
192,192,Marc Leishman,5,306,90,216,2016,total_driving,NA
193,166,Joseph Bramlett,7,307,94,213,2016,total_driving,NA
194,195,Joaquin Niemann,8,308,164,144,2016,total_driving,NA
T195,T196,Graeme McDowell,5,311,236,75,2016,total_driving,NA
T195,T201,Bronson Burgoon,8,311,130,181,2016,total_driving,NA
197,T187,Brian Gay,9,312,162,150,2016,total_driving,NA
198,193,Rhein Gibson,9,313,90,223,2016,total_driving,NA
199,T196,Tom Hoge,8,314,185,129,2016,total_driving,NA
200,200,Mark Anderson,7,319,132,187,2016,total_driving,NA
201,204,Smylie Kaufman,3,320,64,256,2016,total_driving,NA
T202,199,Zac Blair,10,322,225,97,2016,total_driving,NA
T202,214,Francesco Molinari,3,322,125,197,2016,total_driving,NA
T204,T170,John Senden,5,324,120,204,2016,total_driving,NA
T204,180,Ben Martin,6,324,223,101,2016,total_driving,NA
T206,T205,James Hahn,6,325,163,162,2016,total_driving,NA
T206,186,Aaron Baddeley,6,325,198,127,2016,total_driving,NA
208,T211,J.J. Spaun,9,330,118,212,2016,total_driving,NA
T209,203,Robert Streb,9,332,141,191,2016,total_driving,NA
T209,T208,Robert Allenby,3,332,164,168,2016,total_driving,NA
211,T211,Martin Trainer,8,339,94,245,2016,total_driving,NA
212,T205,"Ted Potter, Jr.",7,340,151,189,2016,total_driving,NA
213,T201,Chris Stroud,6,341,194,147,2016,total_driving,NA
T214,T205,Rob Oppenheim,10,342,200,142,2016,total_driving,NA
T214,198,Matt Every,7,342,122,220,2016,total_driving,NA
T214,213,Morgan Hoffmann,4,342,143,199,2016,total_driving,NA
217,215,Roberto Díaz,2,345,110,235,2016,total_driving,NA
218,216,Stewart Cink,4,350,112,238,2016,total_driving,NA
219,217,C.T. Pan,5,353,189,164,2016,total_driving,NA
220,T218,Patton Kizzire,9,354,158,196,2016,total_driving,NA
221,222,Hudson Swafford,4,356,183,173,2016,total_driving,NA
222,T218,George McNeill,6,359,145,214,2016,total_driving,NA
223,220,Patrick Reed,4,363,239,124,2016,total_driving,NA
224,221,Jamie Lovemark,4,365,114,251,2016,total_driving,NA
225,224,Luke Donald,2,378,232,146,2016,total_driving,NA
226,226,Bo Van Pelt,7,387,155,232,2016,total_driving,NA
227,225,Davis Love III,3,400,172,228,2016,total_driving,NA
228,228,Arjun Atwal,5,404,173,231,2016,total_driving,NA
T229,231,Daniel Chopra,3,411,157,254,2016,total_driving,NA
T229,227,Kevin Stadler,6,411,217,194,2016,total_driving,NA
231,229,John Rollins,4,414,209,205,2016,total_driving,NA
232,230,Parker McLachlin,4,421,201,220,2016,total_driving,NA
233,232,Peter Malnati,9,422,197,225,2016,total_driving,NA
234,233,Michael Kim,8,435,211,224,2016,total_driving,NA
235,235,Tommy Gainey,4,442,209,233,2016,total_driving,NA
236,234,D.A. Points,4,446,226,220,2016,total_driving,NA
237,236,Ricky Barnes,6,451,214,237,2016,total_driving,NA
238,237,Brendon de Jonge,3,462,205,257,2016,total_driving,NA
239,238,Shugo Imahira,2,490,235,255,2016,total_driving,NA
1,1,Andrew Novak,2,35,17,18,2017,total_driving,NA
2,3,Viktor Hovland,4,63,16,47,2017,total_driving,NA
3,4,Chase Koepka,2,72,34,38,2017,total_driving,NA
4,5,John Oda,2,74,70,4,2017,total_driving,NA
5,6,D.J. Trahan,7,91,47,44,2017,total_driving,NA
6,8,Gary Woodland,4,98,94,4,2017,total_driving,NA
7,9,Branden Grace,4,99,21,78,2017,total_driving,NA
T8,10,Patrick Cantlay,3,103,86,17,2017,total_driving,NA
T8,7,Doc Redman,10,103,77,26,2017,total_driving,NA
10,2,Ryan Moore,5,105,94,11,2017,total_driving,NA
11,13,Scottie Scheffler,8,126,15,111,2017,total_driving,NA
12,T19,Kyoung-Hoon Lee,10,128,106,22,2017,total_driving,NA
13,14,Martin Laird,8,129,42,87,2017,total_driving,NA
14,11,Kevin Streelman,9,130,62,68,2017,total_driving,NA
15,25,Jhonattan Vegas,6,132,24,108,2017,total_driving,NA
T16,15,Nick Taylor,8,133,109,24,2017,total_driving,NA
T16,T23,Brendan Steele,8,133,63,70,2017,total_driving,NA
18,12,Harris English,7,135,36,99,2017,total_driving,NA
T19,T27,Harry Higgs,10,140,79,61,2017,total_driving,NA
T19,T27,Sung Kang,7,140,53,87,2017,total_driving,NA
T21,22,Emiliano Grillo,7,142,110,32,2017,total_driving,NA
T21,18,Bubba Watson,4,142,1,141,2017,total_driving,NA
23,T19,Bryson DeChambeau,3,144,13,131,2017,total_driving,NA
24,T52,Matthew Wolff,5,145,40,105,2017,total_driving,NA
25,29,Joel Dahmen,8,149,100,49,2017,total_driving,NA
26,16,Jason Kokrak,5,153,8,145,2017,total_driving,NA
27,17,Josh Teater,6,156,83,73,2017,total_driving,NA
28,T23,Cameron Champ,7,157,2,155,2017,total_driving,NA
29,33,Ryan Palmer,5,160,146,14,2017,total_driving,NA
30,T35,Adam Hadwin,5,164,121,43,2017,total_driving,NA
31,26,Sungjae Im,8,165,50,115,2017,total_driving,NA
32,31,Henrik Norlander,10,168,132,36,2017,total_driving,NA
T33,38,Boo Weekley,5,169,147,22,2017,total_driving,NA
T33,T35,Harold Varner III,7,169,18,151,2017,total_driving,NA
35,37,Lanto Griffin,10,170,40,130,2017,total_driving,NA
36,T19,Lucas Glover,7,174,98,76,2017,total_driving,NA
37,34,Scott Brown,9,175,151,24,2017,total_driving,NA
38,T44,Sebastián Muñoz,10,176,60,116,2017,total_driving,NA
T39,40,Daniel Berger,6,177,56,121,2017,total_driving,NA
T39,42,Keegan Bradley,7,177,71,106,2017,total_driving,NA
41,39,Chesson Hadley,7,179,106,73,2017,total_driving,NA
42,43,Webb Simpson,3,182,170,12,2017,total_driving,NA
43,48,Danny Lee,7,185,9,176,2017,total_driving,NA
44,T50,Pat Perez,6,186,130,56,2017,total_driving,NA
45,T52,Matthew NeSmith,9,188,154,34,2017,total_driving,NA
46,T99,Sepp Straka,10,191,92,99,2017,total_driving,NA
T47,T90,Isaiah Salinda,3,192,14,178,2017,total_driving,NA
T47,T56,John Merrick,4,192,135,57,2017,total_driving,NA
T49,T50,Jim Furyk,3,193,192,1,2017,total_driving,NA
T49,55,Chad Campbell,4,193,178,15,2017,total_driving,NA
T49,T44,Wyndham Clark,7,193,32,161,2017,total_driving,NA
52,32,Alex Noren,4,195,108,87,2017,total_driving,NA
53,NA,Rickie Fowler,2,196,194,2,2017,total_driving,NA
T54,T56,Tony Finau,5,198,12,186,2017,total_driving,NA
T54,T62,Phil Mickelson,5,198,31,167,2017,total_driving,NA
T54,T62,Aaron Wise,7,198,51,147,2017,total_driving,NA
T54,T69,Chase Seiffert,9,198,127,71,2017,total_driving,NA
T58,T73,Abraham Ancer,8,199,113,86,2017,total_driving,NA
T58,61,Adam Schenk,10,199,33,166,2017,total_driving,NA
T58,T64,Scott Harrington,9,199,34,165,2017,total_driving,NA
T61,T52,Brian Harman,8,200,143,57,2017,total_driving,NA
T61,47,Jason Dufner,7,200,140,60,2017,total_driving,NA
T61,59,Cameron Smith,6,200,77,123,2017,total_driving,NA
T64,46,Kramer Hickok,9,201,124,77,2017,total_driving,NA
T64,60,Matt Jones,8,201,49,152,2017,total_driving,NA
66,30,Robby Shelton,10,202,88,114,2017,total_driving,NA
T67,83,Grayson Murray,6,203,4,199,2017,total_driving,NA
T67,T73,Russell Knox,8,203,138,65,2017,total_driving,NA
69,41,Denny McCarthy,8,204,101,103,2017,total_driving,NA
70,T80,Sam Ryder,10,209,53,156,2017,total_driving,NA
71,58,Brice Garnett,8,214,150,64,2017,total_driving,NA
72,66,Michael Thompson,7,215,175,40,2017,total_driving,NA
73,76,Collin Morikawa,6,216,168,48,2017,total_driving,NA
T74,T69,Derek Ernst,4,217,80,137,2017,total_driving,NA
T74,T67,Adam Long,10,217,189,28,2017,total_driving,NA
T74,96,Andrew Landry,9,217,171,46,2017,total_driving,NA
77,T84,Akshay Bhatia,5,218,7,211,2017,total_driving,NA
78,T69,Rod Pampling,3,220,28,192,2017,total_driving,NA
79,136,Nick Watney,7,222,73,149,2017,total_driving,NA
T80,T84,Hideki Matsuyama,6,223,115,108,2017,total_driving,NA
T80,115,Doug Ghim,7,223,116,107,2017,total_driving,NA
T80,T90,Kristoffer Ventura,9,223,44,179,2017,total_driving,NA
T83,T73,Byeong Hun An,8,225,10,215,2017,total_driving,NA
T83,T90,Chandler Phillips,2,225,57,168,2017,total_driving,NA
T83,T69,Brian Stuard,10,225,215,10,2017,total_driving,NA
T83,T97,Alex Cejka,5,225,175,50,2017,total_driving,NA
T83,T80,Ryan Armour,9,225,217,8,2017,total_driving,NA
T88,T90,Graham DeLaet,5,226,36,190,2017,total_driving,NA
T88,T77,Tim Wilkinson,6,226,189,37,2017,total_driving,NA
T88,T86,Brandon Wu,2,226,188,38,2017,total_driving,NA
T91,T88,Hank Lebioda,9,228,104,124,2017,total_driving,NA
T91,79,Charles Howell III,9,228,69,159,2017,total_driving,NA
93,T67,Tyler McCumber,9,229,11,218,2017,total_driving,NA
94,T90,Fabián Gómez,9,230,167,63,2017,total_driving,NA
95,T90,Brendon Todd,11,231,228,3,2017,total_driving,NA
T96,49,Cameron Percy,8,233,61,172,2017,total_driving,NA
T96,T99,Adam Scott,4,233,46,187,2017,total_driving,NA
T96,T80,Luke List,9,233,80,153,2017,total_driving,NA
T96,T86,Russell Henley,8,233,179,54,2017,total_driving,NA
T96,T130,Mackenzie Hughes,8,233,101,132,2017,total_driving,NA
101,T109,J.T. Poston,9,234,175,59,2017,total_driving,NA
102,T64,Vince Covello,8,235,73,162,2017,total_driving,NA
103,T99,Xinjun Zhang,10,236,116,120,2017,total_driving,NA
104,105,K.J. Choi,3,237,233,4,2017,total_driving,NA
T105,107,Tim Herron,4,238,220,18,2017,total_driving,NA
T105,T109,Corey Conners,7,238,186,52,2017,total_driving,NA
T107,108,Keith Mitchell,7,239,135,104,2017,total_driving,NA
T107,T130,Cameron Davis,8,239,22,217,2017,total_driving,NA
T107,T99,Richy Werenski,4,239,45,194,2017,total_driving,NA
T107,T88,Vaughn Taylor,8,239,212,27,2017,total_driving,NA
111,168,Chris Baker,9,240,168,72,2017,total_driving,NA
T112,T112,Jim Herman,8,241,221,20,2017,total_driving,NA
T112,T127,Scott Piercy,8,241,105,136,2017,total_driving,NA
T114,T120,J.J. Henry,5,242,173,69,2017,total_driving,NA
T114,T103,Tyler Duncan,10,242,221,21,2017,total_driving,NA
116,T112,Davis Riley,2,243,83,160,2017,total_driving,NA
T117,T125,Bo Hoag,10,244,127,117,2017,total_driving,NA
T117,T116,Chez Reavie,9,244,228,16,2017,total_driving,NA
119,T116,Matt Kuchar,4,245,238,7,2017,total_driving,NA
T120,223,Paul Casey,4,247,160,87,2017,total_driving,NA
T120,T116,Satoshi Kodaira,6,247,234,13,2017,total_driving,NA
T120,T127,Shawn Stefani,6,247,73,174,2017,total_driving,NA
123,106,Carlos Ortiz,8,248,67,181,2017,total_driving,NA
124,T122,Ben Crane,6,249,207,42,2017,total_driving,NA
125,T130,Tom Lewis,3,252,5,247,2017,total_driving,NA
126,T139,Michael Gligic,9,253,73,180,2017,total_driving,NA
T127,T139,Scott Stallings,8,254,47,207,2017,total_driving,NA
T127,T137,Kyle Stanley,8,254,213,41,2017,total_driving,NA
T129,T137,Henrik Stenson,2,255,202,53,2017,total_driving,NA
T129,T125,Austin Cook,8,255,127,128,2017,total_driving,NA
T131,T120,Beau Hossler,8,256,29,227,2017,total_driving,NA
T131,T122,Patrick Rodgers,10,256,26,230,2017,total_driving,NA
T131,T143,Sebastian Cappelen,8,256,30,226,2017,total_driving,NA
T131,T133,Kurt Kitayama,2,256,3,253,2017,total_driving,NA
T131,T77,Vincent Whaley,7,256,103,153,2017,total_driving,NA
T131,T141,Ryan Brehm,10,256,6,250,2017,total_driving,NA
137,T122,Mark Hubbard,10,257,149,108,2017,total_driving,NA
T138,T163,Brandon Hagy,8,258,22,236,2017,total_driving,NA
T138,T109,Billy Horschel,6,258,196,62,2017,total_driving,NA
T140,T147,Sam Burns,6,259,20,239,2017,total_driving,NA
T140,T133,David Lingmerth,5,259,230,29,2017,total_driving,NA
T142,T187,Bud Cauley,6,262,125,137,2017,total_driving,NA
T142,T143,Cameron Tringale,7,262,55,207,2017,total_driving,NA
144,T143,Rikuya Hoshino,2,264,138,126,2017,total_driving,NA
145,T155,Jonathan Byrd,5,265,72,193,2017,total_driving,NA
T146,T116,Maverick McNealy,9,266,89,177,2017,total_driving,NA
T146,T147,Xander Schauffele,3,266,231,35,2017,total_driving,NA
T148,154,Whee Kim,2,267,180,87,2017,total_driving,NA
T148,T141,Lucas Bjerregaard,3,267,18,249,2017,total_driving,NA
150,T152,Chip McDaniel,2,268,59,209,2017,total_driving,NA
T151,T178,Max Homa,6,269,187,82,2017,total_driving,NA
T151,T112,Bill Haas,6,269,147,122,2017,total_driving,NA
T151,146,J.B. Holmes,3,269,224,45,2017,total_driving,NA
T154,129,Zack Sucher,6,270,24,246,2017,total_driving,NA
T154,T157,Roberto Castro,5,270,183,87,2017,total_driving,NA
156,151,Kevin Tway,6,271,27,244,2017,total_driving,NA
T157,T155,Kevin Chappell,6,272,43,229,2017,total_driving,NA
T157,T152,Dominic Bozzelli,7,272,38,234,2017,total_driving,NA
T159,T147,David Hearn,9,273,206,67,2017,total_driving,NA
T159,174,Jimmy Walker,4,273,92,181,2017,total_driving,NA
161,165,Sangmoon Bae,6,274,64,210,2017,total_driving,NA
162,167,Michael Gellerman,8,275,135,140,2017,total_driving,NA
163,T159,Kevin Kisner,7,277,227,50,2017,total_driving,NA
T164,T159,Justin Thomas,5,278,161,117,2017,total_driving,NA
T164,T187,Troy Merritt,7,278,182,96,2017,total_driving,NA
T164,T163,Freddie Jacobson,3,278,141,137,2017,total_driving,NA
167,T175,Talor Gooch,8,280,122,158,2017,total_driving,NA
168,T103,Andrew Putnam,6,283,181,102,2017,total_driving,NA
T169,T157,Si Woo Kim,8,284,99,185,2017,total_driving,NA
T169,T97,Charley Hoffman,7,284,87,197,2017,total_driving,NA
T169,169,Seamus Power,5,284,83,201,2017,total_driving,NA
172,T133,John Huh,5,285,166,119,2017,total_driving,NA
T173,T172,Jason Day,3,286,80,206,2017,total_driving,NA
T173,T172,Chris Kirk,3,286,199,87,2017,total_driving,NA
T173,T175,Rafael Campos,9,286,67,219,2017,total_driving,NA
176,T159,Nate Lashley,8,287,204,83,2017,total_driving,NA
177,177,Brandt Snedeker,4,288,155,133,2017,total_driving,NA
178,T178,Peter Uihlein,6,289,38,251,2017,total_driving,NA
179,150,Kevin Na,7,290,203,87,2017,total_driving,NA
180,T170,Ben Taylor,10,291,134,157,2017,total_driving,NA
181,162,Anirban Lahiri,8,292,118,174,2017,total_driving,NA
182,T208,Roger Sloan,8,293,158,135,2017,total_driving,NA
T183,182,Johnson Wagner,5,294,207,87,2017,total_driving,NA
T183,T183,Robert Garrigus,5,294,52,242,2017,total_driving,NA
T183,T187,Wes Roach,7,294,151,143,2017,total_driving,NA
186,181,Zach Johnson,7,299,216,83,2017,total_driving,NA
187,191,Mikumu Horikawa,3,303,237,66,2017,total_driving,NA
T188,194,Will Gordon,4,304,64,240,2017,total_driving,NA
T188,210,Rory Sabbatini,7,304,219,85,2017,total_driving,NA
T188,T183,Dylan Frittelli,9,304,193,111,2017,total_driving,NA
191,185,Nelson Ledesma,10,305,57,248,2017,total_driving,NA
192,192,Marc Leishman,5,306,90,216,2017,total_driving,NA
193,166,Joseph Bramlett,7,307,94,213,2017,total_driving,NA
194,195,Joaquin Niemann,8,308,164,144,2017,total_driving,NA
T195,T196,Graeme McDowell,5,311,236,75,2017,total_driving,NA
T195,T201,Bronson Burgoon,8,311,130,181,2017,total_driving,NA
197,T187,Brian Gay,9,312,162,150,2017,total_driving,NA
198,193,Rhein Gibson,9,313,90,223,2017,total_driving,NA
199,T196,Tom Hoge,8,314,185,129,2017,total_driving,NA
200,200,Mark Anderson,7,319,132,187,2017,total_driving,NA
201,204,Smylie Kaufman,3,320,64,256,2017,total_driving,NA
T202,199,Zac Blair,10,322,225,97,2017,total_driving,NA
T202,214,Francesco Molinari,3,322,125,197,2017,total_driving,NA
T204,T170,John Senden,5,324,120,204,2017,total_driving,NA
T204,180,Ben Martin,6,324,223,101,2017,total_driving,NA
T206,T205,James Hahn,6,325,163,162,2017,total_driving,NA
T206,186,Aaron Baddeley,6,325,198,127,2017,total_driving,NA
208,T211,J.J. Spaun,9,330,118,212,2017,total_driving,NA
T209,203,Robert Streb,9,332,141,191,2017,total_driving,NA
T209,T208,Robert Allenby,3,332,164,168,2017,total_driving,NA
211,T211,Martin Trainer,8,339,94,245,2017,total_driving,NA
212,T205,"Ted Potter, Jr.",7,340,151,189,2017,total_driving,NA
213,T201,Chris Stroud,6,341,194,147,2017,total_driving,NA
T214,T205,Rob Oppenheim,10,342,200,142,2017,total_driving,NA
T214,198,Matt Every,7,342,122,220,2017,total_driving,NA
T214,213,Morgan Hoffmann,4,342,143,199,2017,total_driving,NA
217,215,Roberto Díaz,2,345,110,235,2017,total_driving,NA
218,216,Stewart Cink,4,350,112,238,2017,total_driving,NA
219,217,C.T. Pan,5,353,189,164,2017,total_driving,NA
220,T218,Patton Kizzire,9,354,158,196,2017,total_driving,NA
221,222,Hudson Swafford,4,356,183,173,2017,total_driving,NA
222,T218,George McNeill,6,359,145,214,2017,total_driving,NA
223,220,Patrick Reed,4,363,239,124,2017,total_driving,NA
224,221,Jamie Lovemark,4,365,114,251,2017,total_driving,NA
225,224,Luke Donald,2,378,232,146,2017,total_driving,NA
226,226,Bo Van Pelt,7,387,155,232,2017,total_driving,NA
227,225,Davis Love III,3,400,172,228,2017,total_driving,NA
228,228,Arjun Atwal,5,404,173,231,2017,total_driving,NA
T229,231,Daniel Chopra,3,411,157,254,2017,total_driving,NA
T229,227,Kevin Stadler,6,411,217,194,2017,total_driving,NA
231,229,John Rollins,4,414,209,205,2017,total_driving,NA
232,230,Parker McLachlin,4,421,201,220,2017,total_driving,NA
233,232,Peter Malnati,9,422,197,225,2017,total_driving,NA
234,233,Michael Kim,8,435,211,224,2017,total_driving,NA
235,235,Tommy Gainey,4,442,209,233,2017,total_driving,NA
236,234,D.A. Points,4,446,226,220,2017,total_driving,NA
237,236,Ricky Barnes,6,451,214,237,2017,total_driving,NA
238,237,Brendon de Jonge,3,462,205,257,2017,total_driving,NA
239,238,Shugo Imahira,2,490,235,255,2017,total_driving,NA
1,1,Andrew Novak,2,35,17,18,2018,total_driving,NA
2,3,Viktor Hovland,4,63,16,47,2018,total_driving,NA
3,4,Chase Koepka,2,72,34,38,2018,total_driving,NA
4,5,John Oda,2,74,70,4,2018,total_driving,NA
5,6,D.J. Trahan,7,91,47,44,2018,total_driving,NA
6,8,Gary Woodland,4,98,94,4,2018,total_driving,NA
7,9,Branden Grace,4,99,21,78,2018,total_driving,NA
T8,10,Patrick Cantlay,3,103,86,17,2018,total_driving,NA
T8,7,Doc Redman,10,103,77,26,2018,total_driving,NA
10,2,Ryan Moore,5,105,94,11,2018,total_driving,NA
11,13,Scottie Scheffler,8,126,15,111,2018,total_driving,NA
12,T19,Kyoung-Hoon Lee,10,128,106,22,2018,total_driving,NA
13,14,Martin Laird,8,129,42,87,2018,total_driving,NA
14,11,Kevin Streelman,9,130,62,68,2018,total_driving,NA
15,25,Jhonattan Vegas,6,132,24,108,2018,total_driving,NA
T16,15,Nick Taylor,8,133,109,24,2018,total_driving,NA
T16,T23,Brendan Steele,8,133,63,70,2018,total_driving,NA
18,12,Harris English,7,135,36,99,2018,total_driving,NA
T19,T27,Harry Higgs,10,140,79,61,2018,total_driving,NA
T19,T27,Sung Kang,7,140,53,87,2018,total_driving,NA
T21,22,Emiliano Grillo,7,142,110,32,2018,total_driving,NA
T21,18,Bubba Watson,4,142,1,141,2018,total_driving,NA
23,T19,Bryson DeChambeau,3,144,13,131,2018,total_driving,NA
24,T52,Matthew Wolff,5,145,40,105,2018,total_driving,NA
25,29,Joel Dahmen,8,149,100,49,2018,total_driving,NA
26,16,Jason Kokrak,5,153,8,145,2018,total_driving,NA
27,17,Josh Teater,6,156,83,73,2018,total_driving,NA
28,T23,Cameron Champ,7,157,2,155,2018,total_driving,NA
29,33,Ryan Palmer,5,160,146,14,2018,total_driving,NA
30,T35,Adam Hadwin,5,164,121,43,2018,total_driving,NA
31,26,Sungjae Im,8,165,50,115,2018,total_driving,NA
32,31,Henrik Norlander,10,168,132,36,2018,total_driving,NA
T33,38,Boo Weekley,5,169,147,22,2018,total_driving,NA
T33,T35,Harold Varner III,7,169,18,151,2018,total_driving,NA
35,37,Lanto Griffin,10,170,40,130,2018,total_driving,NA
36,T19,Lucas Glover,7,174,98,76,2018,total_driving,NA
37,34,Scott Brown,9,175,151,24,2018,total_driving,NA
38,T44,Sebastián Muñoz,10,176,60,116,2018,total_driving,NA
T39,40,Daniel Berger,6,177,56,121,2018,total_driving,NA
T39,42,Keegan Bradley,7,177,71,106,2018,total_driving,NA
41,39,Chesson Hadley,7,179,106,73,2018,total_driving,NA
42,43,Webb Simpson,3,182,170,12,2018,total_driving,NA
43,48,Danny Lee,7,185,9,176,2018,total_driving,NA
44,T50,Pat Perez,6,186,130,56,2018,total_driving,NA
45,T52,Matthew NeSmith,9,188,154,34,2018,total_driving,NA
46,T99,Sepp Straka,10,191,92,99,2018,total_driving,NA
T47,T90,Isaiah Salinda,3,192,14,178,2018,total_driving,NA
T47,T56,John Merrick,4,192,135,57,2018,total_driving,NA
T49,T50,Jim Furyk,3,193,192,1,2018,total_driving,NA
T49,55,Chad Campbell,4,193,178,15,2018,total_driving,NA
T49,T44,Wyndham Clark,7,193,32,161,2018,total_driving,NA
52,32,Alex Noren,4,195,108,87,2018,total_driving,NA
53,NA,Rickie Fowler,2,196,194,2,2018,total_driving,NA
T54,T56,Tony Finau,5,198,12,186,2018,total_driving,NA
T54,T62,Phil Mickelson,5,198,31,167,2018,total_driving,NA
T54,T62,Aaron Wise,7,198,51,147,2018,total_driving,NA
T54,T69,Chase Seiffert,9,198,127,71,2018,total_driving,NA
T58,T73,Abraham Ancer,8,199,113,86,2018,total_driving,NA
T58,61,Adam Schenk,10,199,33,166,2018,total_driving,NA
T58,T64,Scott Harrington,9,199,34,165,2018,total_driving,NA
T61,T52,Brian Harman,8,200,143,57,2018,total_driving,NA
T61,47,Jason Dufner,7,200,140,60,2018,total_driving,NA
T61,59,Cameron Smith,6,200,77,123,2018,total_driving,NA
T64,46,Kramer Hickok,9,201,124,77,2018,total_driving,NA
T64,60,Matt Jones,8,201,49,152,2018,total_driving,NA
66,30,Robby Shelton,10,202,88,114,2018,total_driving,NA
T67,83,Grayson Murray,6,203,4,199,2018,total_driving,NA
T67,T73,Russell Knox,8,203,138,65,2018,total_driving,NA
69,41,Denny McCarthy,8,204,101,103,2018,total_driving,NA
70,T80,Sam Ryder,10,209,53,156,2018,total_driving,NA
71,58,Brice Garnett,8,214,150,64,2018,total_driving,NA
72,66,Michael Thompson,7,215,175,40,2018,total_driving,NA
73,76,Collin Morikawa,6,216,168,48,2018,total_driving,NA
T74,T69,Derek Ernst,4,217,80,137,2018,total_driving,NA
T74,T67,Adam Long,10,217,189,28,2018,total_driving,NA
T74,96,Andrew Landry,9,217,171,46,2018,total_driving,NA
77,T84,Akshay Bhatia,5,218,7,211,2018,total_driving,NA
78,T69,Rod Pampling,3,220,28,192,2018,total_driving,NA
79,136,Nick Watney,7,222,73,149,2018,total_driving,NA
T80,T84,Hideki Matsuyama,6,223,115,108,2018,total_driving,NA
T80,115,Doug Ghim,7,223,116,107,2018,total_driving,NA
T80,T90,Kristoffer Ventura,9,223,44,179,2018,total_driving,NA
T83,T73,Byeong Hun An,8,225,10,215,2018,total_driving,NA
T83,T90,Chandler Phillips,2,225,57,168,2018,total_driving,NA
T83,T69,Brian Stuard,10,225,215,10,2018,total_driving,NA
T83,T97,Alex Cejka,5,225,175,50,2018,total_driving,NA
T83,T80,Ryan Armour,9,225,217,8,2018,total_driving,NA
T88,T90,Graham DeLaet,5,226,36,190,2018,total_driving,NA
T88,T77,Tim Wilkinson,6,226,189,37,2018,total_driving,NA
T88,T86,Brandon Wu,2,226,188,38,2018,total_driving,NA
T91,T88,Hank Lebioda,9,228,104,124,2018,total_driving,NA
T91,79,Charles Howell III,9,228,69,159,2018,total_driving,NA
93,T67,Tyler McCumber,9,229,11,218,2018,total_driving,NA
94,T90,Fabián Gómez,9,230,167,63,2018,total_driving,NA
95,T90,Brendon Todd,11,231,228,3,2018,total_driving,NA
T96,49,Cameron Percy,8,233,61,172,2018,total_driving,NA
T96,T99,Adam Scott,4,233,46,187,2018,total_driving,NA
T96,T80,Luke List,9,233,80,153,2018,total_driving,NA
T96,T86,Russell Henley,8,233,179,54,2018,total_driving,NA
T96,T130,Mackenzie Hughes,8,233,101,132,2018,total_driving,NA
101,T109,J.T. Poston,9,234,175,59,2018,total_driving,NA
102,T64,Vince Covello,8,235,73,162,2018,total_driving,NA
103,T99,Xinjun Zhang,10,236,116,120,2018,total_driving,NA
104,105,K.J. Choi,3,237,233,4,2018,total_driving,NA
T105,107,Tim Herron,4,238,220,18,2018,total_driving,NA
T105,T109,Corey Conners,7,238,186,52,2018,total_driving,NA
T107,108,Keith Mitchell,7,239,135,104,2018,total_driving,NA
T107,T130,Cameron Davis,8,239,22,217,2018,total_driving,NA
T107,T99,Richy Werenski,4,239,45,194,2018,total_driving,NA
T107,T88,Vaughn Taylor,8,239,212,27,2018,total_driving,NA
111,168,Chris Baker,9,240,168,72,2018,total_driving,NA
T112,T112,Jim Herman,8,241,221,20,2018,total_driving,NA
T112,T127,Scott Piercy,8,241,105,136,2018,total_driving,NA
T114,T120,J.J. Henry,5,242,173,69,2018,total_driving,NA
T114,T103,Tyler Duncan,10,242,221,21,2018,total_driving,NA
116,T112,Davis Riley,2,243,83,160,2018,total_driving,NA
T117,T125,Bo Hoag,10,244,127,117,2018,total_driving,NA
T117,T116,Chez Reavie,9,244,228,16,2018,total_driving,NA
119,T116,Matt Kuchar,4,245,238,7,2018,total_driving,NA
T120,223,Paul Casey,4,247,160,87,2018,total_driving,NA
T120,T116,Satoshi Kodaira,6,247,234,13,2018,total_driving,NA
T120,T127,Shawn Stefani,6,247,73,174,2018,total_driving,NA
123,106,Carlos Ortiz,8,248,67,181,2018,total_driving,NA
124,T122,Ben Crane,6,249,207,42,2018,total_driving,NA
125,T130,Tom Lewis,3,252,5,247,2018,total_driving,NA
126,T139,Michael Gligic,9,253,73,180,2018,total_driving,NA
T127,T139,Scott Stallings,8,254,47,207,2018,total_driving,NA
T127,T137,Kyle Stanley,8,254,213,41,2018,total_driving,NA
T129,T137,Henrik Stenson,2,255,202,53,2018,total_driving,NA
T129,T125,Austin Cook,8,255,127,128,2018,total_driving,NA
T131,T120,Beau Hossler,8,256,29,227,2018,total_driving,NA
T131,T122,Patrick Rodgers,10,256,26,230,2018,total_driving,NA
T131,T143,Sebastian Cappelen,8,256,30,226,2018,total_driving,NA
T131,T133,Kurt Kitayama,2,256,3,253,2018,total_driving,NA
T131,T77,Vincent Whaley,7,256,103,153,2018,total_driving,NA
T131,T141,Ryan Brehm,10,256,6,250,2018,total_driving,NA
137,T122,Mark Hubbard,10,257,149,108,2018,total_driving,NA
T138,T163,Brandon Hagy,8,258,22,236,2018,total_driving,NA
T138,T109,Billy Horschel,6,258,196,62,2018,total_driving,NA
T140,T147,Sam Burns,6,259,20,239,2018,total_driving,NA
T140,T133,David Lingmerth,5,259,230,29,2018,total_driving,NA
T142,T187,Bud Cauley,6,262,125,137,2018,total_driving,NA
T142,T143,Cameron Tringale,7,262,55,207,2018,total_driving,NA
144,T143,Rikuya Hoshino,2,264,138,126,2018,total_driving,NA
145,T155,Jonathan Byrd,5,265,72,193,2018,total_driving,NA
T146,T116,Maverick McNealy,9,266,89,177,2018,total_driving,NA
T146,T147,Xander Schauffele,3,266,231,35,2018,total_driving,NA
T148,154,Whee Kim,2,267,180,87,2018,total_driving,NA
T148,T141,Lucas Bjerregaard,3,267,18,249,2018,total_driving,NA
150,T152,Chip McDaniel,2,268,59,209,2018,total_driving,NA
T151,T178,Max Homa,6,269,187,82,2018,total_driving,NA
T151,T112,Bill Haas,6,269,147,122,2018,total_driving,NA
T151,146,J.B. Holmes,3,269,224,45,2018,total_driving,NA
T154,129,Zack Sucher,6,270,24,246,2018,total_driving,NA
T154,T157,Roberto Castro,5,270,183,87,2018,total_driving,NA
156,151,Kevin Tway,6,271,27,244,2018,total_driving,NA
T157,T155,Kevin Chappell,6,272,43,229,2018,total_driving,NA
T157,T152,Dominic Bozzelli,7,272,38,234,2018,total_driving,NA
T159,T147,David Hearn,9,273,206,67,2018,total_driving,NA
T159,174,Jimmy Walker,4,273,92,181,2018,total_driving,NA
161,165,Sangmoon Bae,6,274,64,210,2018,total_driving,NA
162,167,Michael Gellerman,8,275,135,140,2018,total_driving,NA
163,T159,Kevin Kisner,7,277,227,50,2018,total_driving,NA
T164,T159,Justin Thomas,5,278,161,117,2018,total_driving,NA
T164,T187,Troy Merritt,7,278,182,96,2018,total_driving,NA
T164,T163,Freddie Jacobson,3,278,141,137,2018,total_driving,NA
167,T175,Talor Gooch,8,280,122,158,2018,total_driving,NA
168,T103,Andrew Putnam,6,283,181,102,2018,total_driving,NA
T169,T157,Si Woo Kim,8,284,99,185,2018,total_driving,NA
T169,T97,Charley Hoffman,7,284,87,197,2018,total_driving,NA
T169,169,Seamus Power,5,284,83,201,2018,total_driving,NA
172,T133,John Huh,5,285,166,119,2018,total_driving,NA
T173,T172,Jason Day,3,286,80,206,2018,total_driving,NA
T173,T172,Chris Kirk,3,286,199,87,2018,total_driving,NA
T173,T175,Rafael Campos,9,286,67,219,2018,total_driving,NA
176,T159,Nate Lashley,8,287,204,83,2018,total_driving,NA
177,177,Brandt Snedeker,4,288,155,133,2018,total_driving,NA
178,T178,Peter Uihlein,6,289,38,251,2018,total_driving,NA
179,150,Kevin Na,7,290,203,87,2018,total_driving,NA
180,T170,Ben Taylor,10,291,134,157,2018,total_driving,NA
181,162,Anirban Lahiri,8,292,118,174,2018,total_driving,NA
182,T208,Roger Sloan,8,293,158,135,2018,total_driving,NA
T183,182,Johnson Wagner,5,294,207,87,2018,total_driving,NA
T183,T183,Robert Garrigus,5,294,52,242,2018,total_driving,NA
T183,T187,Wes Roach,7,294,151,143,2018,total_driving,NA
186,181,Zach Johnson,7,299,216,83,2018,total_driving,NA
187,191,Mikumu Horikawa,3,303,237,66,2018,total_driving,NA
T188,194,Will Gordon,4,304,64,240,2018,total_driving,NA
T188,210,Rory Sabbatini,7,304,219,85,2018,total_driving,NA
T188,T183,Dylan Frittelli,9,304,193,111,2018,total_driving,NA
191,185,Nelson Ledesma,10,305,57,248,2018,total_driving,NA
192,192,Marc Leishman,5,306,90,216,2018,total_driving,NA
193,166,Joseph Bramlett,7,307,94,213,2018,total_driving,NA
194,195,Joaquin Niemann,8,308,164,144,2018,total_driving,NA
T195,T196,Graeme McDowell,5,311,236,75,2018,total_driving,NA
T195,T201,Bronson Burgoon,8,311,130,181,2018,total_driving,NA
197,T187,Brian Gay,9,312,162,150,2018,total_driving,NA
198,193,Rhein Gibson,9,313,90,223,2018,total_driving,NA
199,T196,Tom Hoge,8,314,185,129,2018,total_driving,NA
200,200,Mark Anderson,7,319,132,187,2018,total_driving,NA
201,204,Smylie Kaufman,3,320,64,256,2018,total_driving,NA
T202,199,Zac Blair,10,322,225,97,2018,total_driving,NA
T202,214,Francesco Molinari,3,322,125,197,2018,total_driving,NA
T204,T170,John Senden,5,324,120,204,2018,total_driving,NA
T204,180,Ben Martin,6,324,223,101,2018,total_driving,NA
T206,T205,James Hahn,6,325,163,162,2018,total_driving,NA
T206,186,Aaron Baddeley,6,325,198,127,2018,total_driving,NA
208,T211,J.J. Spaun,9,330,118,212,2018,total_driving,NA
T209,203,Robert Streb,9,332,141,191,2018,total_driving,NA
T209,T208,Robert Allenby,3,332,164,168,2018,total_driving,NA
211,T211,Martin Trainer,8,339,94,245,2018,total_driving,NA
212,T205,"Ted Potter, Jr.",7,340,151,189,2018,total_driving,NA
213,T201,Chris Stroud,6,341,194,147,2018,total_driving,NA
T214,T205,Rob Oppenheim,10,342,200,142,2018,total_driving,NA
T214,198,Matt Every,7,342,122,220,2018,total_driving,NA
T214,213,Morgan Hoffmann,4,342,143,199,2018,total_driving,NA
217,215,Roberto Díaz,2,345,110,235,2018,total_driving,NA
218,216,Stewart Cink,4,350,112,238,2018,total_driving,NA
219,217,C.T. Pan,5,353,189,164,2018,total_driving,NA
220,T218,Patton Kizzire,9,354,158,196,2018,total_driving,NA
221,222,Hudson Swafford,4,356,183,173,2018,total_driving,NA
222,T218,George McNeill,6,359,145,214,2018,total_driving,NA
223,220,Patrick Reed,4,363,239,124,2018,total_driving,NA
224,221,Jamie Lovemark,4,365,114,251,2018,total_driving,NA
225,224,Luke Donald,2,378,232,146,2018,total_driving,NA
226,226,Bo Van Pelt,7,387,155,232,2018,total_driving,NA
227,225,Davis Love III,3,400,172,228,2018,total_driving,NA
228,228,Arjun Atwal,5,404,173,231,2018,total_driving,NA
T229,231,Daniel Chopra,3,411,157,254,2018,total_driving,NA
T229,227,Kevin Stadler,6,411,217,194,2018,total_driving,NA
231,229,John Rollins,4,414,209,205,2018,total_driving,NA
232,230,Parker McLachlin,4,421,201,220,2018,total_driving,NA
233,232,Peter Malnati,9,422,197,225,2018,total_driving,NA
234,233,Michael Kim,8,435,211,224,2018,total_driving,NA
235,235,Tommy Gainey,4,442,209,233,2018,total_driving,NA
236,234,D.A. Points,4,446,226,220,2018,total_driving,NA
237,236,Ricky Barnes,6,451,214,237,2018,total_driving,NA
238,237,Brendon de Jonge,3,462,205,257,2018,total_driving,NA
239,238,Shugo Imahira,2,490,235,255,2018,total_driving,NA
1,1,Andrew Novak,2,35,17,18,2019,total_driving,NA
2,3,Viktor Hovland,4,63,16,47,2019,total_driving,NA
3,4,Chase Koepka,2,72,34,38,2019,total_driving,NA
4,5,John Oda,2,74,70,4,2019,total_driving,NA
5,6,D.J. Trahan,7,91,47,44,2019,total_driving,NA
6,8,Gary Woodland,4,98,94,4,2019,total_driving,NA
7,9,Branden Grace,4,99,21,78,2019,total_driving,NA
T8,10,Patrick Cantlay,3,103,86,17,2019,total_driving,NA
T8,7,Doc Redman,10,103,77,26,2019,total_driving,NA
10,2,Ryan Moore,5,105,94,11,2019,total_driving,NA
11,13,Scottie Scheffler,8,126,15,111,2019,total_driving,NA
12,T19,Kyoung-Hoon Lee,10,128,106,22,2019,total_driving,NA
13,14,Martin Laird,8,129,42,87,2019,total_driving,NA
14,11,Kevin Streelman,9,130,62,68,2019,total_driving,NA
15,25,Jhonattan Vegas,6,132,24,108,2019,total_driving,NA
T16,15,Nick Taylor,8,133,109,24,2019,total_driving,NA
T16,T23,Brendan Steele,8,133,63,70,2019,total_driving,NA
18,12,Harris English,7,135,36,99,2019,total_driving,NA
T19,T27,Harry Higgs,10,140,79,61,2019,total_driving,NA
T19,T27,Sung Kang,7,140,53,87,2019,total_driving,NA
T21,22,Emiliano Grillo,7,142,110,32,2019,total_driving,NA
T21,18,Bubba Watson,4,142,1,141,2019,total_driving,NA
23,T19,Bryson DeChambeau,3,144,13,131,2019,total_driving,NA
24,T52,Matthew Wolff,5,145,40,105,2019,total_driving,NA
25,29,Joel Dahmen,8,149,100,49,2019,total_driving,NA
26,16,Jason Kokrak,5,153,8,145,2019,total_driving,NA
27,17,Josh Teater,6,156,83,73,2019,total_driving,NA
28,T23,Cameron Champ,7,157,2,155,2019,total_driving,NA
29,33,Ryan Palmer,5,160,146,14,2019,total_driving,NA
30,T35,Adam Hadwin,5,164,121,43,2019,total_driving,NA
31,26,Sungjae Im,8,165,50,115,2019,total_driving,NA
32,31,Henrik Norlander,10,168,132,36,2019,total_driving,NA
T33,38,Boo Weekley,5,169,147,22,2019,total_driving,NA
T33,T35,Harold Varner III,7,169,18,151,2019,total_driving,NA
35,37,Lanto Griffin,10,170,40,130,2019,total_driving,NA
36,T19,Lucas Glover,7,174,98,76,2019,total_driving,NA
37,34,Scott Brown,9,175,151,24,2019,total_driving,NA
38,T44,Sebastián Muñoz,10,176,60,116,2019,total_driving,NA
T39,40,Daniel Berger,6,177,56,121,2019,total_driving,NA
T39,42,Keegan Bradley,7,177,71,106,2019,total_driving,NA
41,39,Chesson Hadley,7,179,106,73,2019,total_driving,NA
42,43,Webb Simpson,3,182,170,12,2019,total_driving,NA
43,48,Danny Lee,7,185,9,176,2019,total_driving,NA
44,T50,Pat Perez,6,186,130,56,2019,total_driving,NA
45,T52,Matthew NeSmith,9,188,154,34,2019,total_driving,NA
46,T99,Sepp Straka,10,191,92,99,2019,total_driving,NA
T47,T90,Isaiah Salinda,3,192,14,178,2019,total_driving,NA
T47,T56,John Merrick,4,192,135,57,2019,total_driving,NA
T49,T50,Jim Furyk,3,193,192,1,2019,total_driving,NA
T49,55,Chad Campbell,4,193,178,15,2019,total_driving,NA
T49,T44,Wyndham Clark,7,193,32,161,2019,total_driving,NA
52,32,Alex Noren,4,195,108,87,2019,total_driving,NA
53,NA,Rickie Fowler,2,196,194,2,2019,total_driving,NA
T54,T56,Tony Finau,5,198,12,186,2019,total_driving,NA
T54,T62,Phil Mickelson,5,198,31,167,2019,total_driving,NA
T54,T62,Aaron Wise,7,198,51,147,2019,total_driving,NA
T54,T69,Chase Seiffert,9,198,127,71,2019,total_driving,NA
T58,T73,Abraham Ancer,8,199,113,86,2019,total_driving,NA
T58,61,Adam Schenk,10,199,33,166,2019,total_driving,NA
T58,T64,Scott Harrington,9,199,34,165,2019,total_driving,NA
T61,T52,Brian Harman,8,200,143,57,2019,total_driving,NA
T61,47,Jason Dufner,7,200,140,60,2019,total_driving,NA
T61,59,Cameron Smith,6,200,77,123,2019,total_driving,NA
T64,46,Kramer Hickok,9,201,124,77,2019,total_driving,NA
T64,60,Matt Jones,8,201,49,152,2019,total_driving,NA
66,30,Robby Shelton,10,202,88,114,2019,total_driving,NA
T67,83,Grayson Murray,6,203,4,199,2019,total_driving,NA
T67,T73,Russell Knox,8,203,138,65,2019,total_driving,NA
69,41,Denny McCarthy,8,204,101,103,2019,total_driving,NA
70,T80,Sam Ryder,10,209,53,156,2019,total_driving,NA
71,58,Brice Garnett,8,214,150,64,2019,total_driving,NA
72,66,Michael Thompson,7,215,175,40,2019,total_driving,NA
73,76,Collin Morikawa,6,216,168,48,2019,total_driving,NA
T74,T69,Derek Ernst,4,217,80,137,2019,total_driving,NA
T74,T67,Adam Long,10,217,189,28,2019,total_driving,NA
T74,96,Andrew Landry,9,217,171,46,2019,total_driving,NA
77,T84,Akshay Bhatia,5,218,7,211,2019,total_driving,NA
78,T69,Rod Pampling,3,220,28,192,2019,total_driving,NA
79,136,Nick Watney,7,222,73,149,2019,total_driving,NA
T80,T84,Hideki Matsuyama,6,223,115,108,2019,total_driving,NA
T80,115,Doug Ghim,7,223,116,107,2019,total_driving,NA
T80,T90,Kristoffer Ventura,9,223,44,179,2019,total_driving,NA
T83,T73,Byeong Hun An,8,225,10,215,2019,total_driving,NA
T83,T90,Chandler Phillips,2,225,57,168,2019,total_driving,NA
T83,T69,Brian Stuard,10,225,215,10,2019,total_driving,NA
T83,T97,Alex Cejka,5,225,175,50,2019,total_driving,NA
T83,T80,Ryan Armour,9,225,217,8,2019,total_driving,NA
T88,T90,Graham DeLaet,5,226,36,190,2019,total_driving,NA
T88,T77,Tim Wilkinson,6,226,189,37,2019,total_driving,NA
T88,T86,Brandon Wu,2,226,188,38,2019,total_driving,NA
T91,T88,Hank Lebioda,9,228,104,124,2019,total_driving,NA
T91,79,Charles Howell III,9,228,69,159,2019,total_driving,NA
93,T67,Tyler McCumber,9,229,11,218,2019,total_driving,NA
94,T90,Fabián Gómez,9,230,167,63,2019,total_driving,NA
95,T90,Brendon Todd,11,231,228,3,2019,total_driving,NA
T96,49,Cameron Percy,8,233,61,172,2019,total_driving,NA
T96,T99,Adam Scott,4,233,46,187,2019,total_driving,NA
T96,T80,Luke List,9,233,80,153,2019,total_driving,NA
T96,T86,Russell Henley,8,233,179,54,2019,total_driving,NA
T96,T130,Mackenzie Hughes,8,233,101,132,2019,total_driving,NA
101,T109,J.T. Poston,9,234,175,59,2019,total_driving,NA
102,T64,Vince Covello,8,235,73,162,2019,total_driving,NA
103,T99,Xinjun Zhang,10,236,116,120,2019,total_driving,NA
104,105,K.J. Choi,3,237,233,4,2019,total_driving,NA
T105,107,Tim Herron,4,238,220,18,2019,total_driving,NA
T105,T109,Corey Conners,7,238,186,52,2019,total_driving,NA
T107,108,Keith Mitchell,7,239,135,104,2019,total_driving,NA
T107,T130,Cameron Davis,8,239,22,217,2019,total_driving,NA
T107,T99,Richy Werenski,4,239,45,194,2019,total_driving,NA
T107,T88,Vaughn Taylor,8,239,212,27,2019,total_driving,NA
111,168,Chris Baker,9,240,168,72,2019,total_driving,NA
T112,T112,Jim Herman,8,241,221,20,2019,total_driving,NA
T112,T127,Scott Piercy,8,241,105,136,2019,total_driving,NA
T114,T120,J.J. Henry,5,242,173,69,2019,total_driving,NA
T114,T103,Tyler Duncan,10,242,221,21,2019,total_driving,NA
116,T112,Davis Riley,2,243,83,160,2019,total_driving,NA
T117,T125,Bo Hoag,10,244,127,117,2019,total_driving,NA
T117,T116,Chez Reavie,9,244,228,16,2019,total_driving,NA
119,T116,Matt Kuchar,4,245,238,7,2019,total_driving,NA
T120,223,Paul Casey,4,247,160,87,2019,total_driving,NA
T120,T116,Satoshi Kodaira,6,247,234,13,2019,total_driving,NA
T120,T127,Shawn Stefani,6,247,73,174,2019,total_driving,NA
123,106,Carlos Ortiz,8,248,67,181,2019,total_driving,NA
124,T122,Ben Crane,6,249,207,42,2019,total_driving,NA
125,T130,Tom Lewis,3,252,5,247,2019,total_driving,NA
126,T139,Michael Gligic,9,253,73,180,2019,total_driving,NA
T127,T139,Scott Stallings,8,254,47,207,2019,total_driving,NA
T127,T137,Kyle Stanley,8,254,213,41,2019,total_driving,NA
T129,T137,Henrik Stenson,2,255,202,53,2019,total_driving,NA
T129,T125,Austin Cook,8,255,127,128,2019,total_driving,NA
T131,T120,Beau Hossler,8,256,29,227,2019,total_driving,NA
T131,T122,Patrick Rodgers,10,256,26,230,2019,total_driving,NA
T131,T143,Sebastian Cappelen,8,256,30,226,2019,total_driving,NA
T131,T133,Kurt Kitayama,2,256,3,253,2019,total_driving,NA
T131,T77,Vincent Whaley,7,256,103,153,2019,total_driving,NA
T131,T141,Ryan Brehm,10,256,6,250,2019,total_driving,NA
137,T122,Mark Hubbard,10,257,149,108,2019,total_driving,NA
T138,T163,Brandon Hagy,8,258,22,236,2019,total_driving,NA
T138,T109,Billy Horschel,6,258,196,62,2019,total_driving,NA
T140,T147,Sam Burns,6,259,20,239,2019,total_driving,NA
T140,T133,David Lingmerth,5,259,230,29,2019,total_driving,NA
T142,T187,Bud Cauley,6,262,125,137,2019,total_driving,NA
T142,T143,Cameron Tringale,7,262,55,207,2019,total_driving,NA
144,T143,Rikuya Hoshino,2,264,138,126,2019,total_driving,NA
145,T155,Jonathan Byrd,5,265,72,193,2019,total_driving,NA
T146,T116,Maverick McNealy,9,266,89,177,2019,total_driving,NA
T146,T147,Xander Schauffele,3,266,231,35,2019,total_driving,NA
T148,154,Whee Kim,2,267,180,87,2019,total_driving,NA
T148,T141,Lucas Bjerregaard,3,267,18,249,2019,total_driving,NA
150,T152,Chip McDaniel,2,268,59,209,2019,total_driving,NA
T151,T178,Max Homa,6,269,187,82,2019,total_driving,NA
T151,T112,Bill Haas,6,269,147,122,2019,total_driving,NA
T151,146,J.B. Holmes,3,269,224,45,2019,total_driving,NA
T154,129,Zack Sucher,6,270,24,246,2019,total_driving,NA
T154,T157,Roberto Castro,5,270,183,87,2019,total_driving,NA
156,151,Kevin Tway,6,271,27,244,2019,total_driving,NA
T157,T155,Kevin Chappell,6,272,43,229,2019,total_driving,NA
T157,T152,Dominic Bozzelli,7,272,38,234,2019,total_driving,NA
T159,T147,David Hearn,9,273,206,67,2019,total_driving,NA
T159,174,Jimmy Walker,4,273,92,181,2019,total_driving,NA
161,165,Sangmoon Bae,6,274,64,210,2019,total_driving,NA
162,167,Michael Gellerman,8,275,135,140,2019,total_driving,NA
163,T159,Kevin Kisner,7,277,227,50,2019,total_driving,NA
T164,T159,Justin Thomas,5,278,161,117,2019,total_driving,NA
T164,T187,Troy Merritt,7,278,182,96,2019,total_driving,NA
T164,T163,Freddie Jacobson,3,278,141,137,2019,total_driving,NA
167,T175,Talor Gooch,8,280,122,158,2019,total_driving,NA
168,T103,Andrew Putnam,6,283,181,102,2019,total_driving,NA
T169,T157,Si Woo Kim,8,284,99,185,2019,total_driving,NA
T169,T97,Charley Hoffman,7,284,87,197,2019,total_driving,NA
T169,169,Seamus Power,5,284,83,201,2019,total_driving,NA
172,T133,John Huh,5,285,166,119,2019,total_driving,NA
T173,T172,Jason Day,3,286,80,206,2019,total_driving,NA
T173,T172,Chris Kirk,3,286,199,87,2019,total_driving,NA
T173,T175,Rafael Campos,9,286,67,219,2019,total_driving,NA
176,T159,Nate Lashley,8,287,204,83,2019,total_driving,NA
177,177,Brandt Snedeker,4,288,155,133,2019,total_driving,NA
178,T178,Peter Uihlein,6,289,38,251,2019,total_driving,NA
179,150,Kevin Na,7,290,203,87,2019,total_driving,NA
180,T170,Ben Taylor,10,291,134,157,2019,total_driving,NA
181,162,Anirban Lahiri,8,292,118,174,2019,total_driving,NA
182,T208,Roger Sloan,8,293,158,135,2019,total_driving,NA
T183,182,Johnson Wagner,5,294,207,87,2019,total_driving,NA
T183,T183,Robert Garrigus,5,294,52,242,2019,total_driving,NA
T183,T187,Wes Roach,7,294,151,143,2019,total_driving,NA
186,181,Zach Johnson,7,299,216,83,2019,total_driving,NA
187,191,Mikumu Horikawa,3,303,237,66,2019,total_driving,NA
T188,194,Will Gordon,4,304,64,240,2019,total_driving,NA
T188,210,Rory Sabbatini,7,304,219,85,2019,total_driving,NA
T188,T183,Dylan Frittelli,9,304,193,111,2019,total_driving,NA
191,185,Nelson Ledesma,10,305,57,248,2019,total_driving,NA
192,192,Marc Leishman,5,306,90,216,2019,total_driving,NA
193,166,Joseph Bramlett,7,307,94,213,2019,total_driving,NA
194,195,Joaquin Niemann,8,308,164,144,2019,total_driving,NA
T195,T196,Graeme McDowell,5,311,236,75,2019,total_driving,NA
T195,T201,Bronson Burgoon,8,311,130,181,2019,total_driving,NA
197,T187,Brian Gay,9,312,162,150,2019,total_driving,NA
198,193,Rhein Gibson,9,313,90,223,2019,total_driving,NA
199,T196,Tom Hoge,8,314,185,129,2019,total_driving,NA
200,200,Mark Anderson,7,319,132,187,2019,total_driving,NA
201,204,Smylie Kaufman,3,320,64,256,2019,total_driving,NA
T202,199,Zac Blair,10,322,225,97,2019,total_driving,NA
T202,214,Francesco Molinari,3,322,125,197,2019,total_driving,NA
T204,T170,John Senden,5,324,120,204,2019,total_driving,NA
T204,180,Ben Martin,6,324,223,101,2019,total_driving,NA
T206,T205,James Hahn,6,325,163,162,2019,total_driving,NA
T206,186,Aaron Baddeley,6,325,198,127,2019,total_driving,NA
208,T211,J.J. Spaun,9,330,118,212,2019,total_driving,NA
T209,203,Robert Streb,9,332,141,191,2019,total_driving,NA
T209,T208,Robert Allenby,3,332,164,168,2019,total_driving,NA
211,T211,Martin Trainer,8,339,94,245,2019,total_driving,NA
212,T205,"Ted Potter, Jr.",7,340,151,189,2019,total_driving,NA
213,T201,Chris Stroud,6,341,194,147,2019,total_driving,NA
T214,T205,Rob Oppenheim,10,342,200,142,2019,total_driving,NA
T214,198,Matt Every,7,342,122,220,2019,total_driving,NA
T214,213,Morgan Hoffmann,4,342,143,199,2019,total_driving,NA
217,215,Roberto Díaz,2,345,110,235,2019,total_driving,NA
218,216,Stewart Cink,4,350,112,238,2019,total_driving,NA
219,217,C.T. Pan,5,353,189,164,2019,total_driving,NA
220,T218,Patton Kizzire,9,354,158,196,2019,total_driving,NA
221,222,Hudson Swafford,4,356,183,173,2019,total_driving,NA
222,T218,George McNeill,6,359,145,214,2019,total_driving,NA
223,220,Patrick Reed,4,363,239,124,2019,total_driving,NA
224,221,Jamie Lovemark,4,365,114,251,2019,total_driving,NA
225,224,Luke Donald,2,378,232,146,2019,total_driving,NA
226,226,Bo Van Pelt,7,387,155,232,2019,total_driving,NA
227,225,Davis Love III,3,400,172,228,2019,total_driving,NA
228,228,Arjun Atwal,5,404,173,231,2019,total_driving,NA
T229,231,Daniel Chopra,3,411,157,254,2019,total_driving,NA
T229,227,Kevin Stadler,6,411,217,194,2019,total_driving,NA
231,229,John Rollins,4,414,209,205,2019,total_driving,NA
232,230,Parker McLachlin,4,421,201,220,2019,total_driving,NA
233,232,Peter Malnati,9,422,197,225,2019,total_driving,NA
234,233,Michael Kim,8,435,211,224,2019,total_driving,NA
235,235,Tommy Gainey,4,442,209,233,2019,total_driving,NA
236,234,D.A. Points,4,446,226,220,2019,total_driving,NA
237,236,Ricky Barnes,6,451,214,237,2019,total_driving,NA
238,237,Brendon de Jonge,3,462,205,257,2019,total_driving,NA
239,238,Shugo Imahira,2,490,235,255,2019,total_driving,NA
1,1,Andrew Novak,2,35,17,18,2004,total_driving,NA
2,3,Viktor Hovland,4,63,16,47,2004,total_driving,NA
3,4,Chase Koepka,2,72,34,38,2004,total_driving,NA
4,5,John Oda,2,74,70,4,2004,total_driving,NA
5,6,D.J. Trahan,7,91,47,44,2004,total_driving,NA
6,8,Gary Woodland,4,98,94,4,2004,total_driving,NA
7,9,Branden Grace,4,99,21,78,2004,total_driving,NA
T8,10,Patrick Cantlay,3,103,86,17,2004,total_driving,NA
T8,7,Doc Redman,10,103,77,26,2004,total_driving,NA
10,2,Ryan Moore,5,105,94,11,2004,total_driving,NA
11,13,Scottie Scheffler,8,126,15,111,2004,total_driving,NA
12,T19,Kyoung-Hoon Lee,10,128,106,22,2004,total_driving,NA
13,14,Martin Laird,8,129,42,87,2004,total_driving,NA
14,11,Kevin Streelman,9,130,62,68,2004,total_driving,NA
15,25,Jhonattan Vegas,6,132,24,108,2004,total_driving,NA
T16,15,Nick Taylor,8,133,109,24,2004,total_driving,NA
T16,T23,Brendan Steele,8,133,63,70,2004,total_driving,NA
18,12,Harris English,7,135,36,99,2004,total_driving,NA
T19,T27,Harry Higgs,10,140,79,61,2004,total_driving,NA
T19,T27,Sung Kang,7,140,53,87,2004,total_driving,NA
T21,22,Emiliano Grillo,7,142,110,32,2004,total_driving,NA
T21,18,Bubba Watson,4,142,1,141,2004,total_driving,NA
23,T19,Bryson DeChambeau,3,144,13,131,2004,total_driving,NA
24,T52,Matthew Wolff,5,145,40,105,2004,total_driving,NA
25,29,Joel Dahmen,8,149,100,49,2004,total_driving,NA
26,16,Jason Kokrak,5,153,8,145,2004,total_driving,NA
27,17,Josh Teater,6,156,83,73,2004,total_driving,NA
28,T23,Cameron Champ,7,157,2,155,2004,total_driving,NA
29,33,Ryan Palmer,5,160,146,14,2004,total_driving,NA
30,T35,Adam Hadwin,5,164,121,43,2004,total_driving,NA
31,26,Sungjae Im,8,165,50,115,2004,total_driving,NA
32,31,Henrik Norlander,10,168,132,36,2004,total_driving,NA
T33,38,Boo Weekley,5,169,147,22,2004,total_driving,NA
T33,T35,Harold Varner III,7,169,18,151,2004,total_driving,NA
35,37,Lanto Griffin,10,170,40,130,2004,total_driving,NA
36,T19,Lucas Glover,7,174,98,76,2004,total_driving,NA
37,34,Scott Brown,9,175,151,24,2004,total_driving,NA
38,T44,Sebastián Muñoz,10,176,60,116,2004,total_driving,NA
T39,40,Daniel Berger,6,177,56,121,2004,total_driving,NA
T39,42,Keegan Bradley,7,177,71,106,2004,total_driving,NA
41,39,Chesson Hadley,7,179,106,73,2004,total_driving,NA
42,43,Webb Simpson,3,182,170,12,2004,total_driving,NA
43,48,Danny Lee,7,185,9,176,2004,total_driving,NA
44,T50,Pat Perez,6,186,130,56,2004,total_driving,NA
45,T52,Matthew NeSmith,9,188,154,34,2004,total_driving,NA
46,T99,Sepp Straka,10,191,92,99,2004,total_driving,NA
T47,T90,Isaiah Salinda,3,192,14,178,2004,total_driving,NA
T47,T56,John Merrick,4,192,135,57,2004,total_driving,NA
T49,T50,Jim Furyk,3,193,192,1,2004,total_driving,NA
T49,55,Chad Campbell,4,193,178,15,2004,total_driving,NA
T49,T44,Wyndham Clark,7,193,32,161,2004,total_driving,NA
52,32,Alex Noren,4,195,108,87,2004,total_driving,NA
53,NA,Rickie Fowler,2,196,194,2,2004,total_driving,NA
T54,T56,Tony Finau,5,198,12,186,2004,total_driving,NA
T54,T62,Phil Mickelson,5,198,31,167,2004,total_driving,NA
T54,T62,Aaron Wise,7,198,51,147,2004,total_driving,NA
T54,T69,Chase Seiffert,9,198,127,71,2004,total_driving,NA
T58,T73,Abraham Ancer,8,199,113,86,2004,total_driving,NA
T58,61,Adam Schenk,10,199,33,166,2004,total_driving,NA
T58,T64,Scott Harrington,9,199,34,165,2004,total_driving,NA
T61,T52,Brian Harman,8,200,143,57,2004,total_driving,NA
T61,47,Jason Dufner,7,200,140,60,2004,total_driving,NA
T61,59,Cameron Smith,6,200,77,123,2004,total_driving,NA
T64,46,Kramer Hickok,9,201,124,77,2004,total_driving,NA
T64,60,Matt Jones,8,201,49,152,2004,total_driving,NA
66,30,Robby Shelton,10,202,88,114,2004,total_driving,NA
T67,83,Grayson Murray,6,203,4,199,2004,total_driving,NA
T67,T73,Russell Knox,8,203,138,65,2004,total_driving,NA
69,41,Denny McCarthy,8,204,101,103,2004,total_driving,NA
70,T80,Sam Ryder,10,209,53,156,2004,total_driving,NA
71,58,Brice Garnett,8,214,150,64,2004,total_driving,NA
72,66,Michael Thompson,7,215,175,40,2004,total_driving,NA
73,76,Collin Morikawa,6,216,168,48,2004,total_driving,NA
T74,T69,Derek Ernst,4,217,80,137,2004,total_driving,NA
T74,T67,Adam Long,10,217,189,28,2004,total_driving,NA
T74,96,Andrew Landry,9,217,171,46,2004,total_driving,NA
77,T84,Akshay Bhatia,5,218,7,211,2004,total_driving,NA
78,T69,Rod Pampling,3,220,28,192,2004,total_driving,NA
79,136,Nick Watney,7,222,73,149,2004,total_driving,NA
T80,T84,Hideki Matsuyama,6,223,115,108,2004,total_driving,NA
T80,115,Doug Ghim,7,223,116,107,2004,total_driving,NA
T80,T90,Kristoffer Ventura,9,223,44,179,2004,total_driving,NA
T83,T73,Byeong Hun An,8,225,10,215,2004,total_driving,NA
T83,T90,Chandler Phillips,2,225,57,168,2004,total_driving,NA
T83,T69,Brian Stuard,10,225,215,10,2004,total_driving,NA
T83,T97,Alex Cejka,5,225,175,50,2004,total_driving,NA
T83,T80,Ryan Armour,9,225,217,8,2004,total_driving,NA
T88,T90,Graham DeLaet,5,226,36,190,2004,total_driving,NA
T88,T77,Tim Wilkinson,6,226,189,37,2004,total_driving,NA
T88,T86,Brandon Wu,2,226,188,38,2004,total_driving,NA
T91,T88,Hank Lebioda,9,228,104,124,2004,total_driving,NA
T91,79,Charles Howell III,9,228,69,159,2004,total_driving,NA
93,T67,Tyler McCumber,9,229,11,218,2004,total_driving,NA
94,T90,Fabián Gómez,9,230,167,63,2004,total_driving,NA
95,T90,Brendon Todd,11,231,228,3,2004,total_driving,NA
T96,49,Cameron Percy,8,233,61,172,2004,total_driving,NA
T96,T99,Adam Scott,4,233,46,187,2004,total_driving,NA
T96,T80,Luke List,9,233,80,153,2004,total_driving,NA
T96,T86,Russell Henley,8,233,179,54,2004,total_driving,NA
T96,T130,Mackenzie Hughes,8,233,101,132,2004,total_driving,NA
101,T109,J.T. Poston,9,234,175,59,2004,total_driving,NA
102,T64,Vince Covello,8,235,73,162,2004,total_driving,NA
103,T99,Xinjun Zhang,10,236,116,120,2004,total_driving,NA
104,105,K.J. Choi,3,237,233,4,2004,total_driving,NA
T105,107,Tim Herron,4,238,220,18,2004,total_driving,NA
T105,T109,Corey Conners,7,238,186,52,2004,total_driving,NA
T107,108,Keith Mitchell,7,239,135,104,2004,total_driving,NA
T107,T130,Cameron Davis,8,239,22,217,2004,total_driving,NA
T107,T99,Richy Werenski,4,239,45,194,2004,total_driving,NA
T107,T88,Vaughn Taylor,8,239,212,27,2004,total_driving,NA
111,168,Chris Baker,9,240,168,72,2004,total_driving,NA
T112,T112,Jim Herman,8,241,221,20,2004,total_driving,NA
T112,T127,Scott Piercy,8,241,105,136,2004,total_driving,NA
T114,T120,J.J. Henry,5,242,173,69,2004,total_driving,NA
T114,T103,Tyler Duncan,10,242,221,21,2004,total_driving,NA
116,T112,Davis Riley,2,243,83,160,2004,total_driving,NA
T117,T125,Bo Hoag,10,244,127,117,2004,total_driving,NA
T117,T116,Chez Reavie,9,244,228,16,2004,total_driving,NA
119,T116,Matt Kuchar,4,245,238,7,2004,total_driving,NA
T120,223,Paul Casey,4,247,160,87,2004,total_driving,NA
T120,T116,Satoshi Kodaira,6,247,234,13,2004,total_driving,NA
T120,T127,Shawn Stefani,6,247,73,174,2004,total_driving,NA
123,106,Carlos Ortiz,8,248,67,181,2004,total_driving,NA
124,T122,Ben Crane,6,249,207,42,2004,total_driving,NA
125,T130,Tom Lewis,3,252,5,247,2004,total_driving,NA
126,T139,Michael Gligic,9,253,73,180,2004,total_driving,NA
T127,T139,Scott Stallings,8,254,47,207,2004,total_driving,NA
T127,T137,Kyle Stanley,8,254,213,41,2004,total_driving,NA
T129,T137,Henrik Stenson,2,255,202,53,2004,total_driving,NA
T129,T125,Austin Cook,8,255,127,128,2004,total_driving,NA
T131,T120,Beau Hossler,8,256,29,227,2004,total_driving,NA
T131,T122,Patrick Rodgers,10,256,26,230,2004,total_driving,NA
T131,T143,Sebastian Cappelen,8,256,30,226,2004,total_driving,NA
T131,T133,Kurt Kitayama,2,256,3,253,2004,total_driving,NA
T131,T77,Vincent Whaley,7,256,103,153,2004,total_driving,NA
T131,T141,Ryan Brehm,10,256,6,250,2004,total_driving,NA
137,T122,Mark Hubbard,10,257,149,108,2004,total_driving,NA
T138,T163,Brandon Hagy,8,258,22,236,2004,total_driving,NA
T138,T109,Billy Horschel,6,258,196,62,2004,total_driving,NA
T140,T147,Sam Burns,6,259,20,239,2004,total_driving,NA
T140,T133,David Lingmerth,5,259,230,29,2004,total_driving,NA
T142,T187,Bud Cauley,6,262,125,137,2004,total_driving,NA
T142,T143,Cameron Tringale,7,262,55,207,2004,total_driving,NA
144,T143,Rikuya Hoshino,2,264,138,126,2004,total_driving,NA
145,T155,Jonathan Byrd,5,265,72,193,2004,total_driving,NA
T146,T116,Maverick McNealy,9,266,89,177,2004,total_driving,NA
T146,T147,Xander Schauffele,3,266,231,35,2004,total_driving,NA
T148,154,Whee Kim,2,267,180,87,2004,total_driving,NA
T148,T141,Lucas Bjerregaard,3,267,18,249,2004,total_driving,NA
150,T152,Chip McDaniel,2,268,59,209,2004,total_driving,NA
T151,T178,Max Homa,6,269,187,82,2004,total_driving,NA
T151,T112,Bill Haas,6,269,147,122,2004,total_driving,NA
T151,146,J.B. Holmes,3,269,224,45,2004,total_driving,NA
T154,129,Zack Sucher,6,270,24,246,2004,total_driving,NA
T154,T157,Roberto Castro,5,270,183,87,2004,total_driving,NA
156,151,Kevin Tway,6,271,27,244,2004,total_driving,NA
T157,T155,Kevin Chappell,6,272,43,229,2004,total_driving,NA
T157,T152,Dominic Bozzelli,7,272,38,234,2004,total_driving,NA
T159,T147,David Hearn,9,273,206,67,2004,total_driving,NA
T159,174,Jimmy Walker,4,273,92,181,2004,total_driving,NA
161,165,Sangmoon Bae,6,274,64,210,2004,total_driving,NA
162,167,Michael Gellerman,8,275,135,140,2004,total_driving,NA
163,T159,Kevin Kisner,7,277,227,50,2004,total_driving,NA
T164,T159,Justin Thomas,5,278,161,117,2004,total_driving,NA
T164,T187,Troy Merritt,7,278,182,96,2004,total_driving,NA
T164,T163,Freddie Jacobson,3,278,141,137,2004,total_driving,NA
167,T175,Talor Gooch,8,280,122,158,2004,total_driving,NA
168,T103,Andrew Putnam,6,283,181,102,2004,total_driving,NA
T169,T157,Si Woo Kim,8,284,99,185,2004,total_driving,NA
T169,T97,Charley Hoffman,7,284,87,197,2004,total_driving,NA
T169,169,Seamus Power,5,284,83,201,2004,total_driving,NA
172,T133,John Huh,5,285,166,119,2004,total_driving,NA
T173,T172,Jason Day,3,286,80,206,2004,total_driving,NA
T173,T172,Chris Kirk,3,286,199,87,2004,total_driving,NA
T173,T175,Rafael Campos,9,286,67,219,2004,total_driving,NA
176,T159,Nate Lashley,8,287,204,83,2004,total_driving,NA
177,177,Brandt Snedeker,4,288,155,133,2004,total_driving,NA
178,T178,Peter Uihlein,6,289,38,251,2004,total_driving,NA
179,150,Kevin Na,7,290,203,87,2004,total_driving,NA
180,T170,Ben Taylor,10,291,134,157,2004,total_driving,NA
181,162,Anirban Lahiri,8,292,118,174,2004,total_driving,NA
182,T208,Roger Sloan,8,293,158,135,2004,total_driving,NA
T183,182,Johnson Wagner,5,294,207,87,2004,total_driving,NA
T183,T183,Robert Garrigus,5,294,52,242,2004,total_driving,NA
T183,T187,Wes Roach,7,294,151,143,2004,total_driving,NA
186,181,Zach Johnson,7,299,216,83,2004,total_driving,NA
187,191,Mikumu Horikawa,3,303,237,66,2004,total_driving,NA
T188,194,Will Gordon,4,304,64,240,2004,total_driving,NA
T188,210,Rory Sabbatini,7,304,219,85,2004,total_driving,NA
T188,T183,Dylan Frittelli,9,304,193,111,2004,total_driving,NA
191,185,Nelson Ledesma,10,305,57,248,2004,total_driving,NA
192,192,Marc Leishman,5,306,90,216,2004,total_driving,NA
193,166,Joseph Bramlett,7,307,94,213,2004,total_driving,NA
194,195,Joaquin Niemann,8,308,164,144,2004,total_driving,NA
T195,T196,Graeme McDowell,5,311,236,75,2004,total_driving,NA
T195,T201,Bronson Burgoon,8,311,130,181,2004,total_driving,NA
197,T187,Brian Gay,9,312,162,150,2004,total_driving,NA
198,193,Rhein Gibson,9,313,90,223,2004,total_driving,NA
199,T196,Tom Hoge,8,314,185,129,2004,total_driving,NA
200,200,Mark Anderson,7,319,132,187,2004,total_driving,NA
201,204,Smylie Kaufman,3,320,64,256,2004,total_driving,NA
T202,199,Zac Blair,10,322,225,97,2004,total_driving,NA
T202,214,Francesco Molinari,3,322,125,197,2004,total_driving,NA
T204,T170,John Senden,5,324,120,204,2004,total_driving,NA
T204,180,Ben Martin,6,324,223,101,2004,total_driving,NA
T206,T205,James Hahn,6,325,163,162,2004,total_driving,NA
T206,186,Aaron Baddeley,6,325,198,127,2004,total_driving,NA
208,T211,J.J. Spaun,9,330,118,212,2004,total_driving,NA
T209,203,Robert Streb,9,332,141,191,2004,total_driving,NA
T209,T208,Robert Allenby,3,332,164,168,2004,total_driving,NA
211,T211,Martin Trainer,8,339,94,245,2004,total_driving,NA
212,T205,"Ted Potter, Jr.",7,340,151,189,2004,total_driving,NA
213,T201,Chris Stroud,6,341,194,147,2004,total_driving,NA
T214,T205,Rob Oppenheim,10,342,200,142,2004,total_driving,NA
T214,198,Matt Every,7,342,122,220,2004,total_driving,NA
T214,213,Morgan Hoffmann,4,342,143,199,2004,total_driving,NA
217,215,Roberto Díaz,2,345,110,235,2004,total_driving,NA
218,216,Stewart Cink,4,350,112,238,2004,total_driving,NA
219,217,C.T. Pan,5,353,189,164,2004,total_driving,NA
220,T218,Patton Kizzire,9,354,158,196,2004,total_driving,NA
221,222,Hudson Swafford,4,356,183,173,2004,total_driving,NA
222,T218,George McNeill,6,359,145,214,2004,total_driving,NA
223,220,Patrick Reed,4,363,239,124,2004,total_driving,NA
224,221,Jamie Lovemark,4,365,114,251,2004,total_driving,NA
225,224,Luke Donald,2,378,232,146,2004,total_driving,NA
226,226,Bo Van Pelt,7,387,155,232,2004,total_driving,NA
227,225,Davis Love III,3,400,172,228,2004,total_driving,NA
228,228,Arjun Atwal,5,404,173,231,2004,total_driving,NA
T229,231,Daniel Chopra,3,411,157,254,2004,total_driving,NA
T229,227,Kevin Stadler,6,411,217,194,2004,total_driving,NA
231,229,John Rollins,4,414,209,205,2004,total_driving,NA
232,230,Parker McLachlin,4,421,201,220,2004,total_driving,NA
233,232,Peter Malnati,9,422,197,225,2004,total_driving,NA
234,233,Michael Kim,8,435,211,224,2004,total_driving,NA
235,235,Tommy Gainey,4,442,209,233,2004,total_driving,NA
236,234,D.A. Points,4,446,226,220,2004,total_driving,NA
237,236,Ricky Barnes,6,451,214,237,2004,total_driving,NA
238,237,Brendon de Jonge,3,462,205,257,2004,total_driving,NA
239,238,Shugo Imahira,2,490,235,255,2004,total_driving,NA
1,1,Andrew Novak,2,35,17,18,2005,total_driving,NA
2,3,Viktor Hovland,4,63,16,47,2005,total_driving,NA
3,4,Chase Koepka,2,72,34,38,2005,total_driving,NA
4,5,John Oda,2,74,70,4,2005,total_driving,NA
5,6,D.J. Trahan,7,91,47,44,2005,total_driving,NA
6,8,Gary Woodland,4,98,94,4,2005,total_driving,NA
7,9,Branden Grace,4,99,21,78,2005,total_driving,NA
T8,10,Patrick Cantlay,3,103,86,17,2005,total_driving,NA
T8,7,Doc Redman,10,103,77,26,2005,total_driving,NA
10,2,Ryan Moore,5,105,94,11,2005,total_driving,NA
11,13,Scottie Scheffler,8,126,15,111,2005,total_driving,NA
12,T19,Kyoung-Hoon Lee,10,128,106,22,2005,total_driving,NA
13,14,Martin Laird,8,129,42,87,2005,total_driving,NA
14,11,Kevin Streelman,9,130,62,68,2005,total_driving,NA
15,25,Jhonattan Vegas,6,132,24,108,2005,total_driving,NA
T16,15,Nick Taylor,8,133,109,24,2005,total_driving,NA
T16,T23,Brendan Steele,8,133,63,70,2005,total_driving,NA
18,12,Harris English,7,135,36,99,2005,total_driving,NA
T19,T27,Harry Higgs,10,140,79,61,2005,total_driving,NA
T19,T27,Sung Kang,7,140,53,87,2005,total_driving,NA
T21,22,Emiliano Grillo,7,142,110,32,2005,total_driving,NA
T21,18,Bubba Watson,4,142,1,141,2005,total_driving,NA
23,T19,Bryson DeChambeau,3,144,13,131,2005,total_driving,NA
24,T52,Matthew Wolff,5,145,40,105,2005,total_driving,NA
25,29,Joel Dahmen,8,149,100,49,2005,total_driving,NA
26,16,Jason Kokrak,5,153,8,145,2005,total_driving,NA
27,17,Josh Teater,6,156,83,73,2005,total_driving,NA
28,T23,Cameron Champ,7,157,2,155,2005,total_driving,NA
29,33,Ryan Palmer,5,160,146,14,2005,total_driving,NA
30,T35,Adam Hadwin,5,164,121,43,2005,total_driving,NA
31,26,Sungjae Im,8,165,50,115,2005,total_driving,NA
32,31,Henrik Norlander,10,168,132,36,2005,total_driving,NA
T33,38,Boo Weekley,5,169,147,22,2005,total_driving,NA
T33,T35,Harold Varner III,7,169,18,151,2005,total_driving,NA
35,37,Lanto Griffin,10,170,40,130,2005,total_driving,NA
36,T19,Lucas Glover,7,174,98,76,2005,total_driving,NA
37,34,Scott Brown,9,175,151,24,2005,total_driving,NA
38,T44,Sebastián Muñoz,10,176,60,116,2005,total_driving,NA
T39,40,Daniel Berger,6,177,56,121,2005,total_driving,NA
T39,42,Keegan Bradley,7,177,71,106,2005,total_driving,NA
41,39,Chesson Hadley,7,179,106,73,2005,total_driving,NA
42,43,Webb Simpson,3,182,170,12,2005,total_driving,NA
43,48,Danny Lee,7,185,9,176,2005,total_driving,NA
44,T50,Pat Perez,6,186,130,56,2005,total_driving,NA
45,T52,Matthew NeSmith,9,188,154,34,2005,total_driving,NA
46,T99,Sepp Straka,10,191,92,99,2005,total_driving,NA
T47,T90,Isaiah Salinda,3,192,14,178,2005,total_driving,NA
T47,T56,John Merrick,4,192,135,57,2005,total_driving,NA
T49,T50,Jim Furyk,3,193,192,1,2005,total_driving,NA
T49,55,Chad Campbell,4,193,178,15,2005,total_driving,NA
T49,T44,Wyndham Clark,7,193,32,161,2005,total_driving,NA
52,32,Alex Noren,4,195,108,87,2005,total_driving,NA
53,NA,Rickie Fowler,2,196,194,2,2005,total_driving,NA
T54,T56,Tony Finau,5,198,12,186,2005,total_driving,NA
T54,T62,Phil Mickelson,5,198,31,167,2005,total_driving,NA
T54,T62,Aaron Wise,7,198,51,147,2005,total_driving,NA
T54,T69,Chase Seiffert,9,198,127,71,2005,total_driving,NA
T58,T73,Abraham Ancer,8,199,113,86,2005,total_driving,NA
T58,61,Adam Schenk,10,199,33,166,2005,total_driving,NA
T58,T64,Scott Harrington,9,199,34,165,2005,total_driving,NA
T61,T52,Brian Harman,8,200,143,57,2005,total_driving,NA
T61,47,Jason Dufner,7,200,140,60,2005,total_driving,NA
T61,59,Cameron Smith,6,200,77,123,2005,total_driving,NA
T64,46,Kramer Hickok,9,201,124,77,2005,total_driving,NA
T64,60,Matt Jones,8,201,49,152,2005,total_driving,NA
66,30,Robby Shelton,10,202,88,114,2005,total_driving,NA
T67,83,Grayson Murray,6,203,4,199,2005,total_driving,NA
T67,T73,Russell Knox,8,203,138,65,2005,total_driving,NA
69,41,Denny McCarthy,8,204,101,103,2005,total_driving,NA
70,T80,Sam Ryder,10,209,53,156,2005,total_driving,NA
71,58,Brice Garnett,8,214,150,64,2005,total_driving,NA
72,66,Michael Thompson,7,215,175,40,2005,total_driving,NA
73,76,Collin Morikawa,6,216,168,48,2005,total_driving,NA
T74,T69,Derek Ernst,4,217,80,137,2005,total_driving,NA
T74,T67,Adam Long,10,217,189,28,2005,total_driving,NA
T74,96,Andrew Landry,9,217,171,46,2005,total_driving,NA
77,T84,Akshay Bhatia,5,218,7,211,2005,total_driving,NA
78,T69,Rod Pampling,3,220,28,192,2005,total_driving,NA
79,136,Nick Watney,7,222,73,149,2005,total_driving,NA
T80,T84,Hideki Matsuyama,6,223,115,108,2005,total_driving,NA
T80,115,Doug Ghim,7,223,116,107,2005,total_driving,NA
T80,T90,Kristoffer Ventura,9,223,44,179,2005,total_driving,NA
T83,T73,Byeong Hun An,8,225,10,215,2005,total_driving,NA
T83,T90,Chandler Phillips,2,225,57,168,2005,total_driving,NA
T83,T69,Brian Stuard,10,225,215,10,2005,total_driving,NA
T83,T97,Alex Cejka,5,225,175,50,2005,total_driving,NA
T83,T80,Ryan Armour,9,225,217,8,2005,total_driving,NA
T88,T90,Graham DeLaet,5,226,36,190,2005,total_driving,NA
T88,T77,Tim Wilkinson,6,226,189,37,2005,total_driving,NA
T88,T86,Brandon Wu,2,226,188,38,2005,total_driving,NA
T91,T88,Hank Lebioda,9,228,104,124,2005,total_driving,NA
T91,79,Charles Howell III,9,228,69,159,2005,total_driving,NA
93,T67,Tyler McCumber,9,229,11,218,2005,total_driving,NA
94,T90,Fabián Gómez,9,230,167,63,2005,total_driving,NA
95,T90,Brendon Todd,11,231,228,3,2005,total_driving,NA
T96,49,Cameron Percy,8,233,61,172,2005,total_driving,NA
T96,T99,Adam Scott,4,233,46,187,2005,total_driving,NA
T96,T80,Luke List,9,233,80,153,2005,total_driving,NA
T96,T86,Russell Henley,8,233,179,54,2005,total_driving,NA
T96,T130,Mackenzie Hughes,8,233,101,132,2005,total_driving,NA
101,T109,J.T. Poston,9,234,175,59,2005,total_driving,NA
102,T64,Vince Covello,8,235,73,162,2005,total_driving,NA
103,T99,Xinjun Zhang,10,236,116,120,2005,total_driving,NA
104,105,K.J. Choi,3,237,233,4,2005,total_driving,NA
T105,107,Tim Herron,4,238,220,18,2005,total_driving,NA
T105,T109,Corey Conners,7,238,186,52,2005,total_driving,NA
T107,108,Keith Mitchell,7,239,135,104,2005,total_driving,NA
T107,T130,Cameron Davis,8,239,22,217,2005,total_driving,NA
T107,T99,Richy Werenski,4,239,45,194,2005,total_driving,NA
T107,T88,Vaughn Taylor,8,239,212,27,2005,total_driving,NA
111,168,Chris Baker,9,240,168,72,2005,total_driving,NA
T112,T112,Jim Herman,8,241,221,20,2005,total_driving,NA
T112,T127,Scott Piercy,8,241,105,136,2005,total_driving,NA
T114,T120,J.J. Henry,5,242,173,69,2005,total_driving,NA
T114,T103,Tyler Duncan,10,242,221,21,2005,total_driving,NA
116,T112,Davis Riley,2,243,83,160,2005,total_driving,NA
T117,T125,Bo Hoag,10,244,127,117,2005,total_driving,NA
T117,T116,Chez Reavie,9,244,228,16,2005,total_driving,NA
119,T116,Matt Kuchar,4,245,238,7,2005,total_driving,NA
T120,223,Paul Casey,4,247,160,87,2005,total_driving,NA
T120,T116,Satoshi Kodaira,6,247,234,13,2005,total_driving,NA
T120,T127,Shawn Stefani,6,247,73,174,2005,total_driving,NA
123,106,Carlos Ortiz,8,248,67,181,2005,total_driving,NA
124,T122,Ben Crane,6,249,207,42,2005,total_driving,NA
125,T130,Tom Lewis,3,252,5,247,2005,total_driving,NA
126,T139,Michael Gligic,9,253,73,180,2005,total_driving,NA
T127,T139,Scott Stallings,8,254,47,207,2005,total_driving,NA
T127,T137,Kyle Stanley,8,254,213,41,2005,total_driving,NA
T129,T137,Henrik Stenson,2,255,202,53,2005,total_driving,NA
T129,T125,Austin Cook,8,255,127,128,2005,total_driving,NA
T131,T120,Beau Hossler,8,256,29,227,2005,total_driving,NA
T131,T122,Patrick Rodgers,10,256,26,230,2005,total_driving,NA
T131,T143,Sebastian Cappelen,8,256,30,226,2005,total_driving,NA
T131,T133,Kurt Kitayama,2,256,3,253,2005,total_driving,NA
T131,T77,Vincent Whaley,7,256,103,153,2005,total_driving,NA
T131,T141,Ryan Brehm,10,256,6,250,2005,total_driving,NA
137,T122,Mark Hubbard,10,257,149,108,2005,total_driving,NA
T138,T163,Brandon Hagy,8,258,22,236,2005,total_driving,NA
T138,T109,Billy Horschel,6,258,196,62,2005,total_driving,NA
T140,T147,Sam Burns,6,259,20,239,2005,total_driving,NA
T140,T133,David Lingmerth,5,259,230,29,2005,total_driving,NA
T142,T187,Bud Cauley,6,262,125,137,2005,total_driving,NA
T142,T143,Cameron Tringale,7,262,55,207,2005,total_driving,NA
144,T143,Rikuya Hoshino,2,264,138,126,2005,total_driving,NA
145,T155,Jonathan Byrd,5,265,72,193,2005,total_driving,NA
T146,T116,Maverick McNealy,9,266,89,177,2005,total_driving,NA
T146,T147,Xander Schauffele,3,266,231,35,2005,total_driving,NA
T148,154,Whee Kim,2,267,180,87,2005,total_driving,NA
T148,T141,Lucas Bjerregaard,3,267,18,249,2005,total_driving,NA
150,T152,Chip McDaniel,2,268,59,209,2005,total_driving,NA
T151,T178,Max Homa,6,269,187,82,2005,total_driving,NA
T151,T112,Bill Haas,6,269,147,122,2005,total_driving,NA
T151,146,J.B. Holmes,3,269,224,45,2005,total_driving,NA
T154,129,Zack Sucher,6,270,24,246,2005,total_driving,NA
T154,T157,Roberto Castro,5,270,183,87,2005,total_driving,NA
156,151,Kevin Tway,6,271,27,244,2005,total_driving,NA
T157,T155,Kevin Chappell,6,272,43,229,2005,total_driving,NA
T157,T152,Dominic Bozzelli,7,272,38,234,2005,total_driving,NA
T159,T147,David Hearn,9,273,206,67,2005,total_driving,NA
T159,174,Jimmy Walker,4,273,92,181,2005,total_driving,NA
161,165,Sangmoon Bae,6,274,64,210,2005,total_driving,NA
162,167,Michael Gellerman,8,275,135,140,2005,total_driving,NA
163,T159,Kevin Kisner,7,277,227,50,2005,total_driving,NA
T164,T159,Justin Thomas,5,278,161,117,2005,total_driving,NA
T164,T187,Troy Merritt,7,278,182,96,2005,total_driving,NA
T164,T163,Freddie Jacobson,3,278,141,137,2005,total_driving,NA
167,T175,Talor Gooch,8,280,122,158,2005,total_driving,NA
168,T103,Andrew Putnam,6,283,181,102,2005,total_driving,NA
T169,T157,Si Woo Kim,8,284,99,185,2005,total_driving,NA
T169,T97,Charley Hoffman,7,284,87,197,2005,total_driving,NA
T169,169,Seamus Power,5,284,83,201,2005,total_driving,NA
172,T133,John Huh,5,285,166,119,2005,total_driving,NA
T173,T172,Jason Day,3,286,80,206,2005,total_driving,NA
T173,T172,Chris Kirk,3,286,199,87,2005,total_driving,NA
T173,T175,Rafael Campos,9,286,67,219,2005,total_driving,NA
176,T159,Nate Lashley,8,287,204,83,2005,total_driving,NA
177,177,Brandt Snedeker,4,288,155,133,2005,total_driving,NA
178,T178,Peter Uihlein,6,289,38,251,2005,total_driving,NA
179,150,Kevin Na,7,290,203,87,2005,total_driving,NA
180,T170,Ben Taylor,10,291,134,157,2005,total_driving,NA
181,162,Anirban Lahiri,8,292,118,174,2005,total_driving,NA
182,T208,Roger Sloan,8,293,158,135,2005,total_driving,NA
T183,182,Johnson Wagner,5,294,207,87,2005,total_driving,NA
T183,T183,Robert Garrigus,5,294,52,242,2005,total_driving,NA
T183,T187,Wes Roach,7,294,151,143,2005,total_driving,NA
186,181,Zach Johnson,7,299,216,83,2005,total_driving,NA
187,191,Mikumu Horikawa,3,303,237,66,2005,total_driving,NA
T188,194,Will Gordon,4,304,64,240,2005,total_driving,NA
T188,210,Rory Sabbatini,7,304,219,85,2005,total_driving,NA
T188,T183,Dylan Frittelli,9,304,193,111,2005,total_driving,NA
191,185,Nelson Ledesma,10,305,57,248,2005,total_driving,NA
192,192,Marc Leishman,5,306,90,216,2005,total_driving,NA
193,166,Joseph Bramlett,7,307,94,213,2005,total_driving,NA
194,195,Joaquin Niemann,8,308,164,144,2005,total_driving,NA
T195,T196,Graeme McDowell,5,311,236,75,2005,total_driving,NA
T195,T201,Bronson Burgoon,8,311,130,181,2005,total_driving,NA
197,T187,Brian Gay,9,312,162,150,2005,total_driving,NA
198,193,Rhein Gibson,9,313,90,223,2005,total_driving,NA
199,T196,Tom Hoge,8,314,185,129,2005,total_driving,NA
200,200,Mark Anderson,7,319,132,187,2005,total_driving,NA
201,204,Smylie Kaufman,3,320,64,256,2005,total_driving,NA
T202,199,Zac Blair,10,322,225,97,2005,total_driving,NA
T202,214,Francesco Molinari,3,322,125,197,2005,total_driving,NA
T204,T170,John Senden,5,324,120,204,2005,total_driving,NA
T204,180,Ben Martin,6,324,223,101,2005,total_driving,NA
T206,T205,James Hahn,6,325,163,162,2005,total_driving,NA
T206,186,Aaron Baddeley,6,325,198,127,2005,total_driving,NA
208,T211,J.J. Spaun,9,330,118,212,2005,total_driving,NA
T209,203,Robert Streb,9,332,141,191,2005,total_driving,NA
T209,T208,Robert Allenby,3,332,164,168,2005,total_driving,NA
211,T211,Martin Trainer,8,339,94,245,2005,total_driving,NA
212,T205,"Ted Potter, Jr.",7,340,151,189,2005,total_driving,NA
213,T201,Chris Stroud,6,341,194,147,2005,total_driving,NA
T214,T205,Rob Oppenheim,10,342,200,142,2005,total_driving,NA
T214,198,Matt Every,7,342,122,220,2005,total_driving,NA
T214,213,Morgan Hoffmann,4,342,143,199,2005,total_driving,NA
217,215,Roberto Díaz,2,345,110,235,2005,total_driving,NA
218,216,Stewart Cink,4,350,112,238,2005,total_driving,NA
219,217,C.T. Pan,5,353,189,164,2005,total_driving,NA
220,T218,Patton Kizzire,9,354,158,196,2005,total_driving,NA
221,222,Hudson Swafford,4,356,183,173,2005,total_driving,NA
222,T218,George McNeill,6,359,145,214,2005,total_driving,NA
223,220,Patrick Reed,4,363,239,124,2005,total_driving,NA
224,221,Jamie Lovemark,4,365,114,251,2005,total_driving,NA
225,224,Luke Donald,2,378,232,146,2005,total_driving,NA
226,226,Bo Van Pelt,7,387,155,232,2005,total_driving,NA
227,225,Davis Love III,3,400,172,228,2005,total_driving,NA
228,228,Arjun Atwal,5,404,173,231,2005,total_driving,NA
T229,231,Daniel Chopra,3,411,157,254,2005,total_driving,NA
T229,227,Kevin Stadler,6,411,217,194,2005,total_driving,NA
231,229,John Rollins,4,414,209,205,2005,total_driving,NA
232,230,Parker McLachlin,4,421,201,220,2005,total_driving,NA
233,232,Peter Malnati,9,422,197,225,2005,total_driving,NA
234,233,Michael Kim,8,435,211,224,2005,total_driving,NA
235,235,Tommy Gainey,4,442,209,233,2005,total_driving,NA
236,234,D.A. Points,4,446,226,220,2005,total_driving,NA
237,236,Ricky Barnes,6,451,214,237,2005,total_driving,NA
238,237,Brendon de Jonge,3,462,205,257,2005,total_driving,NA
239,238,Shugo Imahira,2,490,235,255,2005,total_driving,NA
1,1,Andrew Novak,2,35,17,18,2006,total_driving,NA
2,3,Viktor Hovland,4,63,16,47,2006,total_driving,NA
3,4,Chase Koepka,2,72,34,38,2006,total_driving,NA
4,5,John Oda,2,74,70,4,2006,total_driving,NA
5,6,D.J. Trahan,7,91,47,44,2006,total_driving,NA
6,8,Gary Woodland,4,98,94,4,2006,total_driving,NA
7,9,Branden Grace,4,99,21,78,2006,total_driving,NA
T8,10,Patrick Cantlay,3,103,86,17,2006,total_driving,NA
T8,7,Doc Redman,10,103,77,26,2006,total_driving,NA
10,2,Ryan Moore,5,105,94,11,2006,total_driving,NA
11,13,Scottie Scheffler,8,126,15,111,2006,total_driving,NA
12,T19,Kyoung-Hoon Lee,10,128,106,22,2006,total_driving,NA
13,14,Martin Laird,8,129,42,87,2006,total_driving,NA
14,11,Kevin Streelman,9,130,62,68,2006,total_driving,NA
15,25,Jhonattan Vegas,6,132,24,108,2006,total_driving,NA
T16,15,Nick Taylor,8,133,109,24,2006,total_driving,NA
T16,T23,Brendan Steele,8,133,63,70,2006,total_driving,NA
18,12,Harris English,7,135,36,99,2006,total_driving,NA
T19,T27,Harry Higgs,10,140,79,61,2006,total_driving,NA
T19,T27,Sung Kang,7,140,53,87,2006,total_driving,NA
T21,22,Emiliano Grillo,7,142,110,32,2006,total_driving,NA
T21,18,Bubba Watson,4,142,1,141,2006,total_driving,NA
23,T19,Bryson DeChambeau,3,144,13,131,2006,total_driving,NA
24,T52,Matthew Wolff,5,145,40,105,2006,total_driving,NA
25,29,Joel Dahmen,8,149,100,49,2006,total_driving,NA
26,16,Jason Kokrak,5,153,8,145,2006,total_driving,NA
27,17,Josh Teater,6,156,83,73,2006,total_driving,NA
28,T23,Cameron Champ,7,157,2,155,2006,total_driving,NA
29,33,Ryan Palmer,5,160,146,14,2006,total_driving,NA
30,T35,Adam Hadwin,5,164,121,43,2006,total_driving,NA
31,26,Sungjae Im,8,165,50,115,2006,total_driving,NA
32,31,Henrik Norlander,10,168,132,36,2006,total_driving,NA
T33,38,Boo Weekley,5,169,147,22,2006,total_driving,NA
T33,T35,Harold Varner III,7,169,18,151,2006,total_driving,NA
35,37,Lanto Griffin,10,170,40,130,2006,total_driving,NA
36,T19,Lucas Glover,7,174,98,76,2006,total_driving,NA
37,34,Scott Brown,9,175,151,24,2006,total_driving,NA
38,T44,Sebastián Muñoz,10,176,60,116,2006,total_driving,NA
T39,40,Daniel Berger,6,177,56,121,2006,total_driving,NA
T39,42,Keegan Bradley,7,177,71,106,2006,total_driving,NA
41,39,Chesson Hadley,7,179,106,73,2006,total_driving,NA
42,43,Webb Simpson,3,182,170,12,2006,total_driving,NA
43,48,Danny Lee,7,185,9,176,2006,total_driving,NA
44,T50,Pat Perez,6,186,130,56,2006,total_driving,NA
45,T52,Matthew NeSmith,9,188,154,34,2006,total_driving,NA
46,T99,Sepp Straka,10,191,92,99,2006,total_driving,NA
T47,T90,Isaiah Salinda,3,192,14,178,2006,total_driving,NA
T47,T56,John Merrick,4,192,135,57,2006,total_driving,NA
T49,T50,Jim Furyk,3,193,192,1,2006,total_driving,NA
T49,55,Chad Campbell,4,193,178,15,2006,total_driving,NA
T49,T44,Wyndham Clark,7,193,32,161,2006,total_driving,NA
52,32,Alex Noren,4,195,108,87,2006,total_driving,NA
53,NA,Rickie Fowler,2,196,194,2,2006,total_driving,NA
T54,T56,Tony Finau,5,198,12,186,2006,total_driving,NA
T54,T62,Phil Mickelson,5,198,31,167,2006,total_driving,NA
T54,T62,Aaron Wise,7,198,51,147,2006,total_driving,NA
T54,T69,Chase Seiffert,9,198,127,71,2006,total_driving,NA
T58,T73,Abraham Ancer,8,199,113,86,2006,total_driving,NA
T58,61,Adam Schenk,10,199,33,166,2006,total_driving,NA
T58,T64,Scott Harrington,9,199,34,165,2006,total_driving,NA
T61,T52,Brian Harman,8,200,143,57,2006,total_driving,NA
T61,47,Jason Dufner,7,200,140,60,2006,total_driving,NA
T61,59,Cameron Smith,6,200,77,123,2006,total_driving,NA
T64,46,Kramer Hickok,9,201,124,77,2006,total_driving,NA
T64,60,Matt Jones,8,201,49,152,2006,total_driving,NA
66,30,Robby Shelton,10,202,88,114,2006,total_driving,NA
T67,83,Grayson Murray,6,203,4,199,2006,total_driving,NA
T67,T73,Russell Knox,8,203,138,65,2006,total_driving,NA
69,41,Denny McCarthy,8,204,101,103,2006,total_driving,NA
70,T80,Sam Ryder,10,209,53,156,2006,total_driving,NA
71,58,Brice Garnett,8,214,150,64,2006,total_driving,NA
72,66,Michael Thompson,7,215,175,40,2006,total_driving,NA
73,76,Collin Morikawa,6,216,168,48,2006,total_driving,NA
T74,T69,Derek Ernst,4,217,80,137,2006,total_driving,NA
T74,T67,Adam Long,10,217,189,28,2006,total_driving,NA
T74,96,Andrew Landry,9,217,171,46,2006,total_driving,NA
77,T84,Akshay Bhatia,5,218,7,211,2006,total_driving,NA
78,T69,Rod Pampling,3,220,28,192,2006,total_driving,NA
79,136,Nick Watney,7,222,73,149,2006,total_driving,NA
T80,T84,Hideki Matsuyama,6,223,115,108,2006,total_driving,NA
T80,115,Doug Ghim,7,223,116,107,2006,total_driving,NA
T80,T90,Kristoffer Ventura,9,223,44,179,2006,total_driving,NA
T83,T73,Byeong Hun An,8,225,10,215,2006,total_driving,NA
T83,T90,Chandler Phillips,2,225,57,168,2006,total_driving,NA
T83,T69,Brian Stuard,10,225,215,10,2006,total_driving,NA
T83,T97,Alex Cejka,5,225,175,50,2006,total_driving,NA
T83,T80,Ryan Armour,9,225,217,8,2006,total_driving,NA
T88,T90,Graham DeLaet,5,226,36,190,2006,total_driving,NA
T88,T77,Tim Wilkinson,6,226,189,37,2006,total_driving,NA
T88,T86,Brandon Wu,2,226,188,38,2006,total_driving,NA
T91,T88,Hank Lebioda,9,228,104,124,2006,total_driving,NA
T91,79,Charles Howell III,9,228,69,159,2006,total_driving,NA
93,T67,Tyler McCumber,9,229,11,218,2006,total_driving,NA
94,T90,Fabián Gómez,9,230,167,63,2006,total_driving,NA
95,T90,Brendon Todd,11,231,228,3,2006,total_driving,NA
T96,49,Cameron Percy,8,233,61,172,2006,total_driving,NA
T96,T99,Adam Scott,4,233,46,187,2006,total_driving,NA
T96,T80,Luke List,9,233,80,153,2006,total_driving,NA
T96,T86,Russell Henley,8,233,179,54,2006,total_driving,NA
T96,T130,Mackenzie Hughes,8,233,101,132,2006,total_driving,NA
101,T109,J.T. Poston,9,234,175,59,2006,total_driving,NA
102,T64,Vince Covello,8,235,73,162,2006,total_driving,NA
103,T99,Xinjun Zhang,10,236,116,120,2006,total_driving,NA
104,105,K.J. Choi,3,237,233,4,2006,total_driving,NA
T105,107,Tim Herron,4,238,220,18,2006,total_driving,NA
T105,T109,Corey Conners,7,238,186,52,2006,total_driving,NA
T107,108,Keith Mitchell,7,239,135,104,2006,total_driving,NA
T107,T130,Cameron Davis,8,239,22,217,2006,total_driving,NA
T107,T99,Richy Werenski,4,239,45,194,2006,total_driving,NA
T107,T88,Vaughn Taylor,8,239,212,27,2006,total_driving,NA
111,168,Chris Baker,9,240,168,72,2006,total_driving,NA
T112,T112,Jim Herman,8,241,221,20,2006,total_driving,NA
T112,T127,Scott Piercy,8,241,105,136,2006,total_driving,NA
T114,T120,J.J. Henry,5,242,173,69,2006,total_driving,NA
T114,T103,Tyler Duncan,10,242,221,21,2006,total_driving,NA
116,T112,Davis Riley,2,243,83,160,2006,total_driving,NA
T117,T125,Bo Hoag,10,244,127,117,2006,total_driving,NA
T117,T116,Chez Reavie,9,244,228,16,2006,total_driving,NA
119,T116,Matt Kuchar,4,245,238,7,2006,total_driving,NA
T120,223,Paul Casey,4,247,160,87,2006,total_driving,NA
T120,T116,Satoshi Kodaira,6,247,234,13,2006,total_driving,NA
T120,T127,Shawn Stefani,6,247,73,174,2006,total_driving,NA
123,106,Carlos Ortiz,8,248,67,181,2006,total_driving,NA
124,T122,Ben Crane,6,249,207,42,2006,total_driving,NA
125,T130,Tom Lewis,3,252,5,247,2006,total_driving,NA
126,T139,Michael Gligic,9,253,73,180,2006,total_driving,NA
T127,T139,Scott Stallings,8,254,47,207,2006,total_driving,NA
T127,T137,Kyle Stanley,8,254,213,41,2006,total_driving,NA
T129,T137,Henrik Stenson,2,255,202,53,2006,total_driving,NA
T129,T125,Austin Cook,8,255,127,128,2006,total_driving,NA
T131,T120,Beau Hossler,8,256,29,227,2006,total_driving,NA
T131,T122,Patrick Rodgers,10,256,26,230,2006,total_driving,NA
T131,T143,Sebastian Cappelen,8,256,30,226,2006,total_driving,NA
T131,T133,Kurt Kitayama,2,256,3,253,2006,total_driving,NA
T131,T77,Vincent Whaley,7,256,103,153,2006,total_driving,NA
T131,T141,Ryan Brehm,10,256,6,250,2006,total_driving,NA
137,T122,Mark Hubbard,10,257,149,108,2006,total_driving,NA
T138,T163,Brandon Hagy,8,258,22,236,2006,total_driving,NA
T138,T109,Billy Horschel,6,258,196,62,2006,total_driving,NA
T140,T147,Sam Burns,6,259,20,239,2006,total_driving,NA
T140,T133,David Lingmerth,5,259,230,29,2006,total_driving,NA
T142,T187,Bud Cauley,6,262,125,137,2006,total_driving,NA
T142,T143,Cameron Tringale,7,262,55,207,2006,total_driving,NA
144,T143,Rikuya Hoshino,2,264,138,126,2006,total_driving,NA
145,T155,Jonathan Byrd,5,265,72,193,2006,total_driving,NA
T146,T116,Maverick McNealy,9,266,89,177,2006,total_driving,NA
T146,T147,Xander Schauffele,3,266,231,35,2006,total_driving,NA
T148,154,Whee Kim,2,267,180,87,2006,total_driving,NA
T148,T141,Lucas Bjerregaard,3,267,18,249,2006,total_driving,NA
150,T152,Chip McDaniel,2,268,59,209,2006,total_driving,NA
T151,T178,Max Homa,6,269,187,82,2006,total_driving,NA
T151,T112,Bill Haas,6,269,147,122,2006,total_driving,NA
T151,146,J.B. Holmes,3,269,224,45,2006,total_driving,NA
T154,129,Zack Sucher,6,270,24,246,2006,total_driving,NA
T154,T157,Roberto Castro,5,270,183,87,2006,total_driving,NA
156,151,Kevin Tway,6,271,27,244,2006,total_driving,NA
T157,T155,Kevin Chappell,6,272,43,229,2006,total_driving,NA
T157,T152,Dominic Bozzelli,7,272,38,234,2006,total_driving,NA
T159,T147,David Hearn,9,273,206,67,2006,total_driving,NA
T159,174,Jimmy Walker,4,273,92,181,2006,total_driving,NA
161,165,Sangmoon Bae,6,274,64,210,2006,total_driving,NA
162,167,Michael Gellerman,8,275,135,140,2006,total_driving,NA
163,T159,Kevin Kisner,7,277,227,50,2006,total_driving,NA
T164,T159,Justin Thomas,5,278,161,117,2006,total_driving,NA
T164,T187,Troy Merritt,7,278,182,96,2006,total_driving,NA
T164,T163,Freddie Jacobson,3,278,141,137,2006,total_driving,NA
167,T175,Talor Gooch,8,280,122,158,2006,total_driving,NA
168,T103,Andrew Putnam,6,283,181,102,2006,total_driving,NA
T169,T157,Si Woo Kim,8,284,99,185,2006,total_driving,NA
T169,T97,Charley Hoffman,7,284,87,197,2006,total_driving,NA
T169,169,Seamus Power,5,284,83,201,2006,total_driving,NA
172,T133,John Huh,5,285,166,119,2006,total_driving,NA
T173,T172,Jason Day,3,286,80,206,2006,total_driving,NA
T173,T172,Chris Kirk,3,286,199,87,2006,total_driving,NA
T173,T175,Rafael Campos,9,286,67,219,2006,total_driving,NA
176,T159,Nate Lashley,8,287,204,83,2006,total_driving,NA
177,177,Brandt Snedeker,4,288,155,133,2006,total_driving,NA
178,T178,Peter Uihlein,6,289,38,251,2006,total_driving,NA
179,150,Kevin Na,7,290,203,87,2006,total_driving,NA
180,T170,Ben Taylor,10,291,134,157,2006,total_driving,NA
181,162,Anirban Lahiri,8,292,118,174,2006,total_driving,NA
182,T208,Roger Sloan,8,293,158,135,2006,total_driving,NA
T183,182,Johnson Wagner,5,294,207,87,2006,total_driving,NA
T183,T183,Robert Garrigus,5,294,52,242,2006,total_driving,NA
T183,T187,Wes Roach,7,294,151,143,2006,total_driving,NA
186,181,Zach Johnson,7,299,216,83,2006,total_driving,NA
187,191,Mikumu Horikawa,3,303,237,66,2006,total_driving,NA
T188,194,Will Gordon,4,304,64,240,2006,total_driving,NA
T188,210,Rory Sabbatini,7,304,219,85,2006,total_driving,NA
T188,T183,Dylan Frittelli,9,304,193,111,2006,total_driving,NA
191,185,Nelson Ledesma,10,305,57,248,2006,total_driving,NA
192,192,Marc Leishman,5,306,90,216,2006,total_driving,NA
193,166,Joseph Bramlett,7,307,94,213,2006,total_driving,NA
194,195,Joaquin Niemann,8,308,164,144,2006,total_driving,NA
T195,T196,Graeme McDowell,5,311,236,75,2006,total_driving,NA
T195,T201,Bronson Burgoon,8,311,130,181,2006,total_driving,NA
197,T187,Brian Gay,9,312,162,150,2006,total_driving,NA
198,193,Rhein Gibson,9,313,90,223,2006,total_driving,NA
199,T196,Tom Hoge,8,314,185,129,2006,total_driving,NA
200,200,Mark Anderson,7,319,132,187,2006,total_driving,NA
201,204,Smylie Kaufman,3,320,64,256,2006,total_driving,NA
T202,199,Zac Blair,10,322,225,97,2006,total_driving,NA
T202,214,Francesco Molinari,3,322,125,197,2006,total_driving,NA
T204,T170,John Senden,5,324,120,204,2006,total_driving,NA
T204,180,Ben Martin,6,324,223,101,2006,total_driving,NA
T206,T205,James Hahn,6,325,163,162,2006,total_driving,NA
T206,186,Aaron Baddeley,6,325,198,127,2006,total_driving,NA
208,T211,J.J. Spaun,9,330,118,212,2006,total_driving,NA
T209,203,Robert Streb,9,332,141,191,2006,total_driving,NA
T209,T208,Robert Allenby,3,332,164,168,2006,total_driving,NA
211,T211,Martin Trainer,8,339,94,245,2006,total_driving,NA
212,T205,"Ted Potter, Jr.",7,340,151,189,2006,total_driving,NA
213,T201,Chris Stroud,6,341,194,147,2006,total_driving,NA
T214,T205,Rob Oppenheim,10,342,200,142,2006,total_driving,NA
T214,198,Matt Every,7,342,122,220,2006,total_driving,NA
T214,213,Morgan Hoffmann,4,342,143,199,2006,total_driving,NA
217,215,Roberto Díaz,2,345,110,235,2006,total_driving,NA
218,216,Stewart Cink,4,350,112,238,2006,total_driving,NA
219,217,C.T. Pan,5,353,189,164,2006,total_driving,NA
220,T218,Patton Kizzire,9,354,158,196,2006,total_driving,NA
221,222,Hudson Swafford,4,356,183,173,2006,total_driving,NA
222,T218,George McNeill,6,359,145,214,2006,total_driving,NA
223,220,Patrick Reed,4,363,239,124,2006,total_driving,NA
224,221,Jamie Lovemark,4,365,114,251,2006,total_driving,NA
225,224,Luke Donald,2,378,232,146,2006,total_driving,NA
226,226,Bo Van Pelt,7,387,155,232,2006,total_driving,NA
227,225,Davis Love III,3,400,172,228,2006,total_driving,NA
228,228,Arjun Atwal,5,404,173,231,2006,total_driving,NA
T229,231,Daniel Chopra,3,411,157,254,2006,total_driving,NA
T229,227,Kevin Stadler,6,411,217,194,2006,total_driving,NA
231,229,John Rollins,4,414,209,205,2006,total_driving,NA
232,230,Parker McLachlin,4,421,201,220,2006,total_driving,NA
233,232,Peter Malnati,9,422,197,225,2006,total_driving,NA
234,233,Michael Kim,8,435,211,224,2006,total_driving,NA
235,235,Tommy Gainey,4,442,209,233,2006,total_driving,NA
236,234,D.A. Points,4,446,226,220,2006,total_driving,NA
237,236,Ricky Barnes,6,451,214,237,2006,total_driving,NA
238,237,Brendon de Jonge,3,462,205,257,2006,total_driving,NA
239,238,Shugo Imahira,2,490,235,255,2006,total_driving,NA
1,1,Andrew Novak,2,35,17,18,2007,total_driving,NA
2,3,Viktor Hovland,4,63,16,47,2007,total_driving,NA
3,4,Chase Koepka,2,72,34,38,2007,total_driving,NA
4,5,John Oda,2,74,70,4,2007,total_driving,NA
5,6,D.J. Trahan,7,91,47,44,2007,total_driving,NA
6,8,Gary Woodland,4,98,94,4,2007,total_driving,NA
7,9,Branden Grace,4,99,21,78,2007,total_driving,NA
T8,10,Patrick Cantlay,3,103,86,17,2007,total_driving,NA
T8,7,Doc Redman,10,103,77,26,2007,total_driving,NA
10,2,Ryan Moore,5,105,94,11,2007,total_driving,NA
11,13,Scottie Scheffler,8,126,15,111,2007,total_driving,NA
12,T19,Kyoung-Hoon Lee,10,128,106,22,2007,total_driving,NA
13,14,Martin Laird,8,129,42,87,2007,total_driving,NA
14,11,Kevin Streelman,9,130,62,68,2007,total_driving,NA
15,25,Jhonattan Vegas,6,132,24,108,2007,total_driving,NA
T16,15,Nick Taylor,8,133,109,24,2007,total_driving,NA
T16,T23,Brendan Steele,8,133,63,70,2007,total_driving,NA
18,12,Harris English,7,135,36,99,2007,total_driving,NA
T19,T27,Harry Higgs,10,140,79,61,2007,total_driving,NA
T19,T27,Sung Kang,7,140,53,87,2007,total_driving,NA
T21,22,Emiliano Grillo,7,142,110,32,2007,total_driving,NA
T21,18,Bubba Watson,4,142,1,141,2007,total_driving,NA
23,T19,Bryson DeChambeau,3,144,13,131,2007,total_driving,NA
24,T52,Matthew Wolff,5,145,40,105,2007,total_driving,NA
25,29,Joel Dahmen,8,149,100,49,2007,total_driving,NA
26,16,Jason Kokrak,5,153,8,145,2007,total_driving,NA
27,17,Josh Teater,6,156,83,73,2007,total_driving,NA
28,T23,Cameron Champ,7,157,2,155,2007,total_driving,NA
29,33,Ryan Palmer,5,160,146,14,2007,total_driving,NA
30,T35,Adam Hadwin,5,164,121,43,2007,total_driving,NA
31,26,Sungjae Im,8,165,50,115,2007,total_driving,NA
32,31,Henrik Norlander,10,168,132,36,2007,total_driving,NA
T33,38,Boo Weekley,5,169,147,22,2007,total_driving,NA
T33,T35,Harold Varner III,7,169,18,151,2007,total_driving,NA
35,37,Lanto Griffin,10,170,40,130,2007,total_driving,NA
36,T19,Lucas Glover,7,174,98,76,2007,total_driving,NA
37,34,Scott Brown,9,175,151,24,2007,total_driving,NA
38,T44,Sebastián Muñoz,10,176,60,116,2007,total_driving,NA
T39,40,Daniel Berger,6,177,56,121,2007,total_driving,NA
T39,42,Keegan Bradley,7,177,71,106,2007,total_driving,NA
41,39,Chesson Hadley,7,179,106,73,2007,total_driving,NA
42,43,Webb Simpson,3,182,170,12,2007,total_driving,NA
43,48,Danny Lee,7,185,9,176,2007,total_driving,NA
44,T50,Pat Perez,6,186,130,56,2007,total_driving,NA
45,T52,Matthew NeSmith,9,188,154,34,2007,total_driving,NA
46,T99,Sepp Straka,10,191,92,99,2007,total_driving,NA
T47,T90,Isaiah Salinda,3,192,14,178,2007,total_driving,NA
T47,T56,John Merrick,4,192,135,57,2007,total_driving,NA
T49,T50,Jim Furyk,3,193,192,1,2007,total_driving,NA
T49,55,Chad Campbell,4,193,178,15,2007,total_driving,NA
T49,T44,Wyndham Clark,7,193,32,161,2007,total_driving,NA
52,32,Alex Noren,4,195,108,87,2007,total_driving,NA
53,NA,Rickie Fowler,2,196,194,2,2007,total_driving,NA
T54,T56,Tony Finau,5,198,12,186,2007,total_driving,NA
T54,T62,Phil Mickelson,5,198,31,167,2007,total_driving,NA
T54,T62,Aaron Wise,7,198,51,147,2007,total_driving,NA
T54,T69,Chase Seiffert,9,198,127,71,2007,total_driving,NA
T58,T73,Abraham Ancer,8,199,113,86,2007,total_driving,NA
T58,61,Adam Schenk,10,199,33,166,2007,total_driving,NA
T58,T64,Scott Harrington,9,199,34,165,2007,total_driving,NA
T61,T52,Brian Harman,8,200,143,57,2007,total_driving,NA
T61,47,Jason Dufner,7,200,140,60,2007,total_driving,NA
T61,59,Cameron Smith,6,200,77,123,2007,total_driving,NA
T64,46,Kramer Hickok,9,201,124,77,2007,total_driving,NA
T64,60,Matt Jones,8,201,49,152,2007,total_driving,NA
66,30,Robby Shelton,10,202,88,114,2007,total_driving,NA
T67,83,Grayson Murray,6,203,4,199,2007,total_driving,NA
T67,T73,Russell Knox,8,203,138,65,2007,total_driving,NA
69,41,Denny McCarthy,8,204,101,103,2007,total_driving,NA
70,T80,Sam Ryder,10,209,53,156,2007,total_driving,NA
71,58,Brice Garnett,8,214,150,64,2007,total_driving,NA
72,66,Michael Thompson,7,215,175,40,2007,total_driving,NA
73,76,Collin Morikawa,6,216,168,48,2007,total_driving,NA
T74,T69,Derek Ernst,4,217,80,137,2007,total_driving,NA
T74,T67,Adam Long,10,217,189,28,2007,total_driving,NA
T74,96,Andrew Landry,9,217,171,46,2007,total_driving,NA
77,T84,Akshay Bhatia,5,218,7,211,2007,total_driving,NA
78,T69,Rod Pampling,3,220,28,192,2007,total_driving,NA
79,136,Nick Watney,7,222,73,149,2007,total_driving,NA
T80,T84,Hideki Matsuyama,6,223,115,108,2007,total_driving,NA
T80,115,Doug Ghim,7,223,116,107,2007,total_driving,NA
T80,T90,Kristoffer Ventura,9,223,44,179,2007,total_driving,NA
T83,T73,Byeong Hun An,8,225,10,215,2007,total_driving,NA
T83,T90,Chandler Phillips,2,225,57,168,2007,total_driving,NA
T83,T69,Brian Stuard,10,225,215,10,2007,total_driving,NA
T83,T97,Alex Cejka,5,225,175,50,2007,total_driving,NA
T83,T80,Ryan Armour,9,225,217,8,2007,total_driving,NA
T88,T90,Graham DeLaet,5,226,36,190,2007,total_driving,NA
T88,T77,Tim Wilkinson,6,226,189,37,2007,total_driving,NA
T88,T86,Brandon Wu,2,226,188,38,2007,total_driving,NA
T91,T88,Hank Lebioda,9,228,104,124,2007,total_driving,NA
T91,79,Charles Howell III,9,228,69,159,2007,total_driving,NA
93,T67,Tyler McCumber,9,229,11,218,2007,total_driving,NA
94,T90,Fabián Gómez,9,230,167,63,2007,total_driving,NA
95,T90,Brendon Todd,11,231,228,3,2007,total_driving,NA
T96,49,Cameron Percy,8,233,61,172,2007,total_driving,NA
T96,T99,Adam Scott,4,233,46,187,2007,total_driving,NA
T96,T80,Luke List,9,233,80,153,2007,total_driving,NA
T96,T86,Russell Henley,8,233,179,54,2007,total_driving,NA
T96,T130,Mackenzie Hughes,8,233,101,132,2007,total_driving,NA
101,T109,J.T. Poston,9,234,175,59,2007,total_driving,NA
102,T64,Vince Covello,8,235,73,162,2007,total_driving,NA
103,T99,Xinjun Zhang,10,236,116,120,2007,total_driving,NA
104,105,K.J. Choi,3,237,233,4,2007,total_driving,NA
T105,107,Tim Herron,4,238,220,18,2007,total_driving,NA
T105,T109,Corey Conners,7,238,186,52,2007,total_driving,NA
T107,108,Keith Mitchell,7,239,135,104,2007,total_driving,NA
T107,T130,Cameron Davis,8,239,22,217,2007,total_driving,NA
T107,T99,Richy Werenski,4,239,45,194,2007,total_driving,NA
T107,T88,Vaughn Taylor,8,239,212,27,2007,total_driving,NA
111,168,Chris Baker,9,240,168,72,2007,total_driving,NA
T112,T112,Jim Herman,8,241,221,20,2007,total_driving,NA
T112,T127,Scott Piercy,8,241,105,136,2007,total_driving,NA
T114,T120,J.J. Henry,5,242,173,69,2007,total_driving,NA
T114,T103,Tyler Duncan,10,242,221,21,2007,total_driving,NA
116,T112,Davis Riley,2,243,83,160,2007,total_driving,NA
T117,T125,Bo Hoag,10,244,127,117,2007,total_driving,NA
T117,T116,Chez Reavie,9,244,228,16,2007,total_driving,NA
119,T116,Matt Kuchar,4,245,238,7,2007,total_driving,NA
T120,223,Paul Casey,4,247,160,87,2007,total_driving,NA
T120,T116,Satoshi Kodaira,6,247,234,13,2007,total_driving,NA
T120,T127,Shawn Stefani,6,247,73,174,2007,total_driving,NA
123,106,Carlos Ortiz,8,248,67,181,2007,total_driving,NA
124,T122,Ben Crane,6,249,207,42,2007,total_driving,NA
125,T130,Tom Lewis,3,252,5,247,2007,total_driving,NA
126,T139,Michael Gligic,9,253,73,180,2007,total_driving,NA
T127,T139,Scott Stallings,8,254,47,207,2007,total_driving,NA
T127,T137,Kyle Stanley,8,254,213,41,2007,total_driving,NA
T129,T137,Henrik Stenson,2,255,202,53,2007,total_driving,NA
T129,T125,Austin Cook,8,255,127,128,2007,total_driving,NA
T131,T120,Beau Hossler,8,256,29,227,2007,total_driving,NA
T131,T122,Patrick Rodgers,10,256,26,230,2007,total_driving,NA
T131,T143,Sebastian Cappelen,8,256,30,226,2007,total_driving,NA
T131,T133,Kurt Kitayama,2,256,3,253,2007,total_driving,NA
T131,T77,Vincent Whaley,7,256,103,153,2007,total_driving,NA
T131,T141,Ryan Brehm,10,256,6,250,2007,total_driving,NA
137,T122,Mark Hubbard,10,257,149,108,2007,total_driving,NA
T138,T163,Brandon Hagy,8,258,22,236,2007,total_driving,NA
T138,T109,Billy Horschel,6,258,196,62,2007,total_driving,NA
T140,T147,Sam Burns,6,259,20,239,2007,total_driving,NA
T140,T133,David Lingmerth,5,259,230,29,2007,total_driving,NA
T142,T187,Bud Cauley,6,262,125,137,2007,total_driving,NA
T142,T143,Cameron Tringale,7,262,55,207,2007,total_driving,NA
144,T143,Rikuya Hoshino,2,264,138,126,2007,total_driving,NA
145,T155,Jonathan Byrd,5,265,72,193,2007,total_driving,NA
T146,T116,Maverick McNealy,9,266,89,177,2007,total_driving,NA
T146,T147,Xander Schauffele,3,266,231,35,2007,total_driving,NA
T148,154,Whee Kim,2,267,180,87,2007,total_driving,NA
T148,T141,Lucas Bjerregaard,3,267,18,249,2007,total_driving,NA
150,T152,Chip McDaniel,2,268,59,209,2007,total_driving,NA
T151,T178,Max Homa,6,269,187,82,2007,total_driving,NA
T151,T112,Bill Haas,6,269,147,122,2007,total_driving,NA
T151,146,J.B. Holmes,3,269,224,45,2007,total_driving,NA
T154,129,Zack Sucher,6,270,24,246,2007,total_driving,NA
T154,T157,Roberto Castro,5,270,183,87,2007,total_driving,NA
156,151,Kevin Tway,6,271,27,244,2007,total_driving,NA
T157,T155,Kevin Chappell,6,272,43,229,2007,total_driving,NA
T157,T152,Dominic Bozzelli,7,272,38,234,2007,total_driving,NA
T159,T147,David Hearn,9,273,206,67,2007,total_driving,NA
T159,174,Jimmy Walker,4,273,92,181,2007,total_driving,NA
161,165,Sangmoon Bae,6,274,64,210,2007,total_driving,NA
162,167,Michael Gellerman,8,275,135,140,2007,total_driving,NA
163,T159,Kevin Kisner,7,277,227,50,2007,total_driving,NA
T164,T159,Justin Thomas,5,278,161,117,2007,total_driving,NA
T164,T187,Troy Merritt,7,278,182,96,2007,total_driving,NA
T164,T163,Freddie Jacobson,3,278,141,137,2007,total_driving,NA
167,T175,Talor Gooch,8,280,122,158,2007,total_driving,NA
168,T103,Andrew Putnam,6,283,181,102,2007,total_driving,NA
T169,T157,Si Woo Kim,8,284,99,185,2007,total_driving,NA
T169,T97,Charley Hoffman,7,284,87,197,2007,total_driving,NA
T169,169,Seamus Power,5,284,83,201,2007,total_driving,NA
172,T133,John Huh,5,285,166,119,2007,total_driving,NA
T173,T172,Jason Day,3,286,80,206,2007,total_driving,NA
T173,T172,Chris Kirk,3,286,199,87,2007,total_driving,NA
T173,T175,Rafael Campos,9,286,67,219,2007,total_driving,NA
176,T159,Nate Lashley,8,287,204,83,2007,total_driving,NA
177,177,Brandt Snedeker,4,288,155,133,2007,total_driving,NA
178,T178,Peter Uihlein,6,289,38,251,2007,total_driving,NA
179,150,Kevin Na,7,290,203,87,2007,total_driving,NA
180,T170,Ben Taylor,10,291,134,157,2007,total_driving,NA
181,162,Anirban Lahiri,8,292,118,174,2007,total_driving,NA
182,T208,Roger Sloan,8,293,158,135,2007,total_driving,NA
T183,182,Johnson Wagner,5,294,207,87,2007,total_driving,NA
T183,T183,Robert Garrigus,5,294,52,242,2007,total_driving,NA
T183,T187,Wes Roach,7,294,151,143,2007,total_driving,NA
186,181,Zach Johnson,7,299,216,83,2007,total_driving,NA
187,191,Mikumu Horikawa,3,303,237,66,2007,total_driving,NA
T188,194,Will Gordon,4,304,64,240,2007,total_driving,NA
T188,210,Rory Sabbatini,7,304,219,85,2007,total_driving,NA
T188,T183,Dylan Frittelli,9,304,193,111,2007,total_driving,NA
191,185,Nelson Ledesma,10,305,57,248,2007,total_driving,NA
192,192,Marc Leishman,5,306,90,216,2007,total_driving,NA
193,166,Joseph Bramlett,7,307,94,213,2007,total_driving,NA
194,195,Joaquin Niemann,8,308,164,144,2007,total_driving,NA
T195,T196,Graeme McDowell,5,311,236,75,2007,total_driving,NA
T195,T201,Bronson Burgoon,8,311,130,181,2007,total_driving,NA
197,T187,Brian Gay,9,312,162,150,2007,total_driving,NA
198,193,Rhein Gibson,9,313,90,223,2007,total_driving,NA
199,T196,Tom Hoge,8,314,185,129,2007,total_driving,NA
200,200,Mark Anderson,7,319,132,187,2007,total_driving,NA
201,204,Smylie Kaufman,3,320,64,256,2007,total_driving,NA
T202,199,Zac Blair,10,322,225,97,2007,total_driving,NA
T202,214,Francesco Molinari,3,322,125,197,2007,total_driving,NA
T204,T170,John Senden,5,324,120,204,2007,total_driving,NA
T204,180,Ben Martin,6,324,223,101,2007,total_driving,NA
T206,T205,James Hahn,6,325,163,162,2007,total_driving,NA
T206,186,Aaron Baddeley,6,325,198,127,2007,total_driving,NA
208,T211,J.J. Spaun,9,330,118,212,2007,total_driving,NA
T209,203,Robert Streb,9,332,141,191,2007,total_driving,NA
T209,T208,Robert Allenby,3,332,164,168,2007,total_driving,NA
211,T211,Martin Trainer,8,339,94,245,2007,total_driving,NA
212,T205,"Ted Potter, Jr.",7,340,151,189,2007,total_driving,NA
213,T201,Chris Stroud,6,341,194,147,2007,total_driving,NA
T214,T205,Rob Oppenheim,10,342,200,142,2007,total_driving,NA
T214,198,Matt Every,7,342,122,220,2007,total_driving,NA
T214,213,Morgan Hoffmann,4,342,143,199,2007,total_driving,NA
217,215,Roberto Díaz,2,345,110,235,2007,total_driving,NA
218,216,Stewart Cink,4,350,112,238,2007,total_driving,NA
219,217,C.T. Pan,5,353,189,164,2007,total_driving,NA
220,T218,Patton Kizzire,9,354,158,196,2007,total_driving,NA
221,222,Hudson Swafford,4,356,183,173,2007,total_driving,NA
222,T218,George McNeill,6,359,145,214,2007,total_driving,NA
223,220,Patrick Reed,4,363,239,124,2007,total_driving,NA
224,221,Jamie Lovemark,4,365,114,251,2007,total_driving,NA
225,224,Luke Donald,2,378,232,146,2007,total_driving,NA
226,226,Bo Van Pelt,7,387,155,232,2007,total_driving,NA
227,225,Davis Love III,3,400,172,228,2007,total_driving,NA
228,228,Arjun Atwal,5,404,173,231,2007,total_driving,NA
T229,231,Daniel Chopra,3,411,157,254,2007,total_driving,NA
T229,227,Kevin Stadler,6,411,217,194,2007,total_driving,NA
231,229,John Rollins,4,414,209,205,2007,total_driving,NA
232,230,Parker McLachlin,4,421,201,220,2007,total_driving,NA
233,232,Peter Malnati,9,422,197,225,2007,total_driving,NA
234,233,Michael Kim,8,435,211,224,2007,total_driving,NA
235,235,Tommy Gainey,4,442,209,233,2007,total_driving,NA
236,234,D.A. Points,4,446,226,220,2007,total_driving,NA
237,236,Ricky Barnes,6,451,214,237,2007,total_driving,NA
238,237,Brendon de Jonge,3,462,205,257,2007,total_driving,NA
239,238,Shugo Imahira,2,490,235,255,2007,total_driving,NA
1,1,Andrew Novak,2,35,17,18,2008,total_driving,NA
2,3,Viktor Hovland,4,63,16,47,2008,total_driving,NA
3,4,Chase Koepka,2,72,34,38,2008,total_driving,NA
4,5,John Oda,2,74,70,4,2008,total_driving,NA
5,6,D.J. Trahan,7,91,47,44,2008,total_driving,NA
6,8,Gary Woodland,4,98,94,4,2008,total_driving,NA
7,9,Branden Grace,4,99,21,78,2008,total_driving,NA
T8,10,Patrick Cantlay,3,103,86,17,2008,total_driving,NA
T8,7,Doc Redman,10,103,77,26,2008,total_driving,NA
10,2,Ryan Moore,5,105,94,11,2008,total_driving,NA
11,13,Scottie Scheffler,8,126,15,111,2008,total_driving,NA
12,T19,Kyoung-Hoon Lee,10,128,106,22,2008,total_driving,NA
13,14,Martin Laird,8,129,42,87,2008,total_driving,NA
14,11,Kevin Streelman,9,130,62,68,2008,total_driving,NA
15,25,Jhonattan Vegas,6,132,24,108,2008,total_driving,NA
T16,15,Nick Taylor,8,133,109,24,2008,total_driving,NA
T16,T23,Brendan Steele,8,133,63,70,2008,total_driving,NA
18,12,Harris English,7,135,36,99,2008,total_driving,NA
T19,T27,Harry Higgs,10,140,79,61,2008,total_driving,NA
T19,T27,Sung Kang,7,140,53,87,2008,total_driving,NA
T21,22,Emiliano Grillo,7,142,110,32,2008,total_driving,NA
T21,18,Bubba Watson,4,142,1,141,2008,total_driving,NA
23,T19,Bryson DeChambeau,3,144,13,131,2008,total_driving,NA
24,T52,Matthew Wolff,5,145,40,105,2008,total_driving,NA
25,29,Joel Dahmen,8,149,100,49,2008,total_driving,NA
26,16,Jason Kokrak,5,153,8,145,2008,total_driving,NA
27,17,Josh Teater,6,156,83,73,2008,total_driving,NA
28,T23,Cameron Champ,7,157,2,155,2008,total_driving,NA
29,33,Ryan Palmer,5,160,146,14,2008,total_driving,NA
30,T35,Adam Hadwin,5,164,121,43,2008,total_driving,NA
31,26,Sungjae Im,8,165,50,115,2008,total_driving,NA
32,31,Henrik Norlander,10,168,132,36,2008,total_driving,NA
T33,38,Boo Weekley,5,169,147,22,2008,total_driving,NA
T33,T35,Harold Varner III,7,169,18,151,2008,total_driving,NA
35,37,Lanto Griffin,10,170,40,130,2008,total_driving,NA
36,T19,Lucas Glover,7,174,98,76,2008,total_driving,NA
37,34,Scott Brown,9,175,151,24,2008,total_driving,NA
38,T44,Sebastián Muñoz,10,176,60,116,2008,total_driving,NA
T39,40,Daniel Berger,6,177,56,121,2008,total_driving,NA
T39,42,Keegan Bradley,7,177,71,106,2008,total_driving,NA
41,39,Chesson Hadley,7,179,106,73,2008,total_driving,NA
42,43,Webb Simpson,3,182,170,12,2008,total_driving,NA
43,48,Danny Lee,7,185,9,176,2008,total_driving,NA
44,T50,Pat Perez,6,186,130,56,2008,total_driving,NA
45,T52,Matthew NeSmith,9,188,154,34,2008,total_driving,NA
46,T99,Sepp Straka,10,191,92,99,2008,total_driving,NA
T47,T90,Isaiah Salinda,3,192,14,178,2008,total_driving,NA
T47,T56,John Merrick,4,192,135,57,2008,total_driving,NA
T49,T50,Jim Furyk,3,193,192,1,2008,total_driving,NA
T49,55,Chad Campbell,4,193,178,15,2008,total_driving,NA
T49,T44,Wyndham Clark,7,193,32,161,2008,total_driving,NA
52,32,Alex Noren,4,195,108,87,2008,total_driving,NA
53,NA,Rickie Fowler,2,196,194,2,2008,total_driving,NA
T54,T56,Tony Finau,5,198,12,186,2008,total_driving,NA
T54,T62,Phil Mickelson,5,198,31,167,2008,total_driving,NA
T54,T62,Aaron Wise,7,198,51,147,2008,total_driving,NA
T54,T69,Chase Seiffert,9,198,127,71,2008,total_driving,NA
T58,T73,Abraham Ancer,8,199,113,86,2008,total_driving,NA
T58,61,Adam Schenk,10,199,33,166,2008,total_driving,NA
T58,T64,Scott Harrington,9,199,34,165,2008,total_driving,NA
T61,T52,Brian Harman,8,200,143,57,2008,total_driving,NA
T61,47,Jason Dufner,7,200,140,60,2008,total_driving,NA
T61,59,Cameron Smith,6,200,77,123,2008,total_driving,NA
T64,46,Kramer Hickok,9,201,124,77,2008,total_driving,NA
T64,60,Matt Jones,8,201,49,152,2008,total_driving,NA
66,30,Robby Shelton,10,202,88,114,2008,total_driving,NA
T67,83,Grayson Murray,6,203,4,199,2008,total_driving,NA
T67,T73,Russell Knox,8,203,138,65,2008,total_driving,NA
69,41,Denny McCarthy,8,204,101,103,2008,total_driving,NA
70,T80,Sam Ryder,10,209,53,156,2008,total_driving,NA
71,58,Brice Garnett,8,214,150,64,2008,total_driving,NA
72,66,Michael Thompson,7,215,175,40,2008,total_driving,NA
73,76,Collin Morikawa,6,216,168,48,2008,total_driving,NA
T74,T69,Derek Ernst,4,217,80,137,2008,total_driving,NA
T74,T67,Adam Long,10,217,189,28,2008,total_driving,NA
T74,96,Andrew Landry,9,217,171,46,2008,total_driving,NA
77,T84,Akshay Bhatia,5,218,7,211,2008,total_driving,NA
78,T69,Rod Pampling,3,220,28,192,2008,total_driving,NA
79,136,Nick Watney,7,222,73,149,2008,total_driving,NA
T80,T84,Hideki Matsuyama,6,223,115,108,2008,total_driving,NA
T80,115,Doug Ghim,7,223,116,107,2008,total_driving,NA
T80,T90,Kristoffer Ventura,9,223,44,179,2008,total_driving,NA
T83,T73,Byeong Hun An,8,225,10,215,2008,total_driving,NA
T83,T90,Chandler Phillips,2,225,57,168,2008,total_driving,NA
T83,T69,Brian Stuard,10,225,215,10,2008,total_driving,NA
T83,T97,Alex Cejka,5,225,175,50,2008,total_driving,NA
T83,T80,Ryan Armour,9,225,217,8,2008,total_driving,NA
T88,T90,Graham DeLaet,5,226,36,190,2008,total_driving,NA
T88,T77,Tim Wilkinson,6,226,189,37,2008,total_driving,NA
T88,T86,Brandon Wu,2,226,188,38,2008,total_driving,NA
T91,T88,Hank Lebioda,9,228,104,124,2008,total_driving,NA
T91,79,Charles Howell III,9,228,69,159,2008,total_driving,NA
93,T67,Tyler McCumber,9,229,11,218,2008,total_driving,NA
94,T90,Fabián Gómez,9,230,167,63,2008,total_driving,NA
95,T90,Brendon Todd,11,231,228,3,2008,total_driving,NA
T96,49,Cameron Percy,8,233,61,172,2008,total_driving,NA
T96,T99,Adam Scott,4,233,46,187,2008,total_driving,NA
T96,T80,Luke List,9,233,80,153,2008,total_driving,NA
T96,T86,Russell Henley,8,233,179,54,2008,total_driving,NA
T96,T130,Mackenzie Hughes,8,233,101,132,2008,total_driving,NA
101,T109,J.T. Poston,9,234,175,59,2008,total_driving,NA
102,T64,Vince Covello,8,235,73,162,2008,total_driving,NA
103,T99,Xinjun Zhang,10,236,116,120,2008,total_driving,NA
104,105,K.J. Choi,3,237,233,4,2008,total_driving,NA
T105,107,Tim Herron,4,238,220,18,2008,total_driving,NA
T105,T109,Corey Conners,7,238,186,52,2008,total_driving,NA
T107,108,Keith Mitchell,7,239,135,104,2008,total_driving,NA
T107,T130,Cameron Davis,8,239,22,217,2008,total_driving,NA
T107,T99,Richy Werenski,4,239,45,194,2008,total_driving,NA
T107,T88,Vaughn Taylor,8,239,212,27,2008,total_driving,NA
111,168,Chris Baker,9,240,168,72,2008,total_driving,NA
T112,T112,Jim Herman,8,241,221,20,2008,total_driving,NA
T112,T127,Scott Piercy,8,241,105,136,2008,total_driving,NA
T114,T120,J.J. Henry,5,242,173,69,2008,total_driving,NA
T114,T103,Tyler Duncan,10,242,221,21,2008,total_driving,NA
116,T112,Davis Riley,2,243,83,160,2008,total_driving,NA
T117,T125,Bo Hoag,10,244,127,117,2008,total_driving,NA
T117,T116,Chez Reavie,9,244,228,16,2008,total_driving,NA
119,T116,Matt Kuchar,4,245,238,7,2008,total_driving,NA
T120,223,Paul Casey,4,247,160,87,2008,total_driving,NA
T120,T116,Satoshi Kodaira,6,247,234,13,2008,total_driving,NA
T120,T127,Shawn Stefani,6,247,73,174,2008,total_driving,NA
123,106,Carlos Ortiz,8,248,67,181,2008,total_driving,NA
124,T122,Ben Crane,6,249,207,42,2008,total_driving,NA
125,T130,Tom Lewis,3,252,5,247,2008,total_driving,NA
126,T139,Michael Gligic,9,253,73,180,2008,total_driving,NA
T127,T139,Scott Stallings,8,254,47,207,2008,total_driving,NA
T127,T137,Kyle Stanley,8,254,213,41,2008,total_driving,NA
T129,T137,Henrik Stenson,2,255,202,53,2008,total_driving,NA
T129,T125,Austin Cook,8,255,127,128,2008,total_driving,NA
T131,T120,Beau Hossler,8,256,29,227,2008,total_driving,NA
T131,T122,Patrick Rodgers,10,256,26,230,2008,total_driving,NA
T131,T143,Sebastian Cappelen,8,256,30,226,2008,total_driving,NA
T131,T133,Kurt Kitayama,2,256,3,253,2008,total_driving,NA
T131,T77,Vincent Whaley,7,256,103,153,2008,total_driving,NA
T131,T141,Ryan Brehm,10,256,6,250,2008,total_driving,NA
137,T122,Mark Hubbard,10,257,149,108,2008,total_driving,NA
T138,T163,Brandon Hagy,8,258,22,236,2008,total_driving,NA
T138,T109,Billy Horschel,6,258,196,62,2008,total_driving,NA
T140,T147,Sam Burns,6,259,20,239,2008,total_driving,NA
T140,T133,David Lingmerth,5,259,230,29,2008,total_driving,NA
T142,T187,Bud Cauley,6,262,125,137,2008,total_driving,NA
T142,T143,Cameron Tringale,7,262,55,207,2008,total_driving,NA
144,T143,Rikuya Hoshino,2,264,138,126,2008,total_driving,NA
145,T155,Jonathan Byrd,5,265,72,193,2008,total_driving,NA
T146,T116,Maverick McNealy,9,266,89,177,2008,total_driving,NA
T146,T147,Xander Schauffele,3,266,231,35,2008,total_driving,NA
T148,154,Whee Kim,2,267,180,87,2008,total_driving,NA
T148,T141,Lucas Bjerregaard,3,267,18,249,2008,total_driving,NA
150,T152,Chip McDaniel,2,268,59,209,2008,total_driving,NA
T151,T178,Max Homa,6,269,187,82,2008,total_driving,NA
T151,T112,Bill Haas,6,269,147,122,2008,total_driving,NA
T151,146,J.B. Holmes,3,269,224,45,2008,total_driving,NA
T154,129,Zack Sucher,6,270,24,246,2008,total_driving,NA
T154,T157,Roberto Castro,5,270,183,87,2008,total_driving,NA
156,151,Kevin Tway,6,271,27,244,2008,total_driving,NA
T157,T155,Kevin Chappell,6,272,43,229,2008,total_driving,NA
T157,T152,Dominic Bozzelli,7,272,38,234,2008,total_driving,NA
T159,T147,David Hearn,9,273,206,67,2008,total_driving,NA
T159,174,Jimmy Walker,4,273,92,181,2008,total_driving,NA
161,165,Sangmoon Bae,6,274,64,210,2008,total_driving,NA
162,167,Michael Gellerman,8,275,135,140,2008,total_driving,NA
163,T159,Kevin Kisner,7,277,227,50,2008,total_driving,NA
T164,T159,Justin Thomas,5,278,161,117,2008,total_driving,NA
T164,T187,Troy Merritt,7,278,182,96,2008,total_driving,NA
T164,T163,Freddie Jacobson,3,278,141,137,2008,total_driving,NA
167,T175,Talor Gooch,8,280,122,158,2008,total_driving,NA
168,T103,Andrew Putnam,6,283,181,102,2008,total_driving,NA
T169,T157,Si Woo Kim,8,284,99,185,2008,total_driving,NA
T169,T97,Charley Hoffman,7,284,87,197,2008,total_driving,NA
T169,169,Seamus Power,5,284,83,201,2008,total_driving,NA
172,T133,John Huh,5,285,166,119,2008,total_driving,NA
T173,T172,Jason Day,3,286,80,206,2008,total_driving,NA
T173,T172,Chris Kirk,3,286,199,87,2008,total_driving,NA
T173,T175,Rafael Campos,9,286,67,219,2008,total_driving,NA
176,T159,Nate Lashley,8,287,204,83,2008,total_driving,NA
177,177,Brandt Snedeker,4,288,155,133,2008,total_driving,NA
178,T178,Peter Uihlein,6,289,38,251,2008,total_driving,NA
179,150,Kevin Na,7,290,203,87,2008,total_driving,NA
180,T170,Ben Taylor,10,291,134,157,2008,total_driving,NA
181,162,Anirban Lahiri,8,292,118,174,2008,total_driving,NA
182,T208,Roger Sloan,8,293,158,135,2008,total_driving,NA
T183,182,Johnson Wagner,5,294,207,87,2008,total_driving,NA
T183,T183,Robert Garrigus,5,294,52,242,2008,total_driving,NA
T183,T187,Wes Roach,7,294,151,143,2008,total_driving,NA
186,181,Zach Johnson,7,299,216,83,2008,total_driving,NA
187,191,Mikumu Horikawa,3,303,237,66,2008,total_driving,NA
T188,194,Will Gordon,4,304,64,240,2008,total_driving,NA
T188,210,Rory Sabbatini,7,304,219,85,2008,total_driving,NA
T188,T183,Dylan Frittelli,9,304,193,111,2008,total_driving,NA
191,185,Nelson Ledesma,10,305,57,248,2008,total_driving,NA
192,192,Marc Leishman,5,306,90,216,2008,total_driving,NA
193,166,Joseph Bramlett,7,307,94,213,2008,total_driving,NA
194,195,Joaquin Niemann,8,308,164,144,2008,total_driving,NA
T195,T196,Graeme McDowell,5,311,236,75,2008,total_driving,NA
T195,T201,Bronson Burgoon,8,311,130,181,2008,total_driving,NA
197,T187,Brian Gay,9,312,162,150,2008,total_driving,NA
198,193,Rhein Gibson,9,313,90,223,2008,total_driving,NA
199,T196,Tom Hoge,8,314,185,129,2008,total_driving,NA
200,200,Mark Anderson,7,319,132,187,2008,total_driving,NA
201,204,Smylie Kaufman,3,320,64,256,2008,total_driving,NA
T202,199,Zac Blair,10,322,225,97,2008,total_driving,NA
T202,214,Francesco Molinari,3,322,125,197,2008,total_driving,NA
T204,T170,John Senden,5,324,120,204,2008,total_driving,NA
T204,180,Ben Martin,6,324,223,101,2008,total_driving,NA
T206,T205,James Hahn,6,325,163,162,2008,total_driving,NA
T206,186,Aaron Baddeley,6,325,198,127,2008,total_driving,NA
208,T211,J.J. Spaun,9,330,118,212,2008,total_driving,NA
T209,203,Robert Streb,9,332,141,191,2008,total_driving,NA
T209,T208,Robert Allenby,3,332,164,168,2008,total_driving,NA
211,T211,Martin Trainer,8,339,94,245,2008,total_driving,NA
212,T205,"Ted Potter, Jr.",7,340,151,189,2008,total_driving,NA
213,T201,Chris Stroud,6,341,194,147,2008,total_driving,NA
T214,T205,Rob Oppenheim,10,342,200,142,2008,total_driving,NA
T214,198,Matt Every,7,342,122,220,2008,total_driving,NA
T214,213,Morgan Hoffmann,4,342,143,199,2008,total_driving,NA
217,215,Roberto Díaz,2,345,110,235,2008,total_driving,NA
218,216,Stewart Cink,4,350,112,238,2008,total_driving,NA
219,217,C.T. Pan,5,353,189,164,2008,total_driving,NA
220,T218,Patton Kizzire,9,354,158,196,2008,total_driving,NA
221,222,Hudson Swafford,4,356,183,173,2008,total_driving,NA
222,T218,George McNeill,6,359,145,214,2008,total_driving,NA
223,220,Patrick Reed,4,363,239,124,2008,total_driving,NA
224,221,Jamie Lovemark,4,365,114,251,2008,total_driving,NA
225,224,Luke Donald,2,378,232,146,2008,total_driving,NA
226,226,Bo Van Pelt,7,387,155,232,2008,total_driving,NA
227,225,Davis Love III,3,400,172,228,2008,total_driving,NA
228,228,Arjun Atwal,5,404,173,231,2008,total_driving,NA
T229,231,Daniel Chopra,3,411,157,254,2008,total_driving,NA
T229,227,Kevin Stadler,6,411,217,194,2008,total_driving,NA
231,229,John Rollins,4,414,209,205,2008,total_driving,NA
232,230,Parker McLachlin,4,421,201,220,2008,total_driving,NA
233,232,Peter Malnati,9,422,197,225,2008,total_driving,NA
234,233,Michael Kim,8,435,211,224,2008,total_driving,NA
235,235,Tommy Gainey,4,442,209,233,2008,total_driving,NA
236,234,D.A. Points,4,446,226,220,2008,total_driving,NA
237,236,Ricky Barnes,6,451,214,237,2008,total_driving,NA
238,237,Brendon de Jonge,3,462,205,257,2008,total_driving,NA
239,238,Shugo Imahira,2,490,235,255,2008,total_driving,NA
1,1,Andrew Novak,2,35,17,18,2009,total_driving,NA
2,3,Viktor Hovland,4,63,16,47,2009,total_driving,NA
3,4,Chase Koepka,2,72,34,38,2009,total_driving,NA
4,5,John Oda,2,74,70,4,2009,total_driving,NA
5,6,D.J. Trahan,7,91,47,44,2009,total_driving,NA
6,8,Gary Woodland,4,98,94,4,2009,total_driving,NA
7,9,Branden Grace,4,99,21,78,2009,total_driving,NA
T8,10,Patrick Cantlay,3,103,86,17,2009,total_driving,NA
T8,7,Doc Redman,10,103,77,26,2009,total_driving,NA
10,2,Ryan Moore,5,105,94,11,2009,total_driving,NA
11,13,Scottie Scheffler,8,126,15,111,2009,total_driving,NA
12,T19,Kyoung-Hoon Lee,10,128,106,22,2009,total_driving,NA
13,14,Martin Laird,8,129,42,87,2009,total_driving,NA
14,11,Kevin Streelman,9,130,62,68,2009,total_driving,NA
15,25,Jhonattan Vegas,6,132,24,108,2009,total_driving,NA
T16,15,Nick Taylor,8,133,109,24,2009,total_driving,NA
T16,T23,Brendan Steele,8,133,63,70,2009,total_driving,NA
18,12,Harris English,7,135,36,99,2009,total_driving,NA
T19,T27,Harry Higgs,10,140,79,61,2009,total_driving,NA
T19,T27,Sung Kang,7,140,53,87,2009,total_driving,NA
T21,22,Emiliano Grillo,7,142,110,32,2009,total_driving,NA
T21,18,Bubba Watson,4,142,1,141,2009,total_driving,NA
23,T19,Bryson DeChambeau,3,144,13,131,2009,total_driving,NA
24,T52,Matthew Wolff,5,145,40,105,2009,total_driving,NA
25,29,Joel Dahmen,8,149,100,49,2009,total_driving,NA
26,16,Jason Kokrak,5,153,8,145,2009,total_driving,NA
27,17,Josh Teater,6,156,83,73,2009,total_driving,NA
28,T23,Cameron Champ,7,157,2,155,2009,total_driving,NA
29,33,Ryan Palmer,5,160,146,14,2009,total_driving,NA
30,T35,Adam Hadwin,5,164,121,43,2009,total_driving,NA
31,26,Sungjae Im,8,165,50,115,2009,total_driving,NA
32,31,Henrik Norlander,10,168,132,36,2009,total_driving,NA
T33,38,Boo Weekley,5,169,147,22,2009,total_driving,NA
T33,T35,Harold Varner III,7,169,18,151,2009,total_driving,NA
35,37,Lanto Griffin,10,170,40,130,2009,total_driving,NA
36,T19,Lucas Glover,7,174,98,76,2009,total_driving,NA
37,34,Scott Brown,9,175,151,24,2009,total_driving,NA
38,T44,Sebastián Muñoz,10,176,60,116,2009,total_driving,NA
T39,40,Daniel Berger,6,177,56,121,2009,total_driving,NA
T39,42,Keegan Bradley,7,177,71,106,2009,total_driving,NA
41,39,Chesson Hadley,7,179,106,73,2009,total_driving,NA
42,43,Webb Simpson,3,182,170,12,2009,total_driving,NA
43,48,Danny Lee,7,185,9,176,2009,total_driving,NA
44,T50,Pat Perez,6,186,130,56,2009,total_driving,NA
45,T52,Matthew NeSmith,9,188,154,34,2009,total_driving,NA
46,T99,Sepp Straka,10,191,92,99,2009,total_driving,NA
T47,T90,Isaiah Salinda,3,192,14,178,2009,total_driving,NA
T47,T56,John Merrick,4,192,135,57,2009,total_driving,NA
T49,T50,Jim Furyk,3,193,192,1,2009,total_driving,NA
T49,55,Chad Campbell,4,193,178,15,2009,total_driving,NA
T49,T44,Wyndham Clark,7,193,32,161,2009,total_driving,NA
52,32,Alex Noren,4,195,108,87,2009,total_driving,NA
53,NA,Rickie Fowler,2,196,194,2,2009,total_driving,NA
T54,T56,Tony Finau,5,198,12,186,2009,total_driving,NA
T54,T62,Phil Mickelson,5,198,31,167,2009,total_driving,NA
T54,T62,Aaron Wise,7,198,51,147,2009,total_driving,NA
T54,T69,Chase Seiffert,9,198,127,71,2009,total_driving,NA
T58,T73,Abraham Ancer,8,199,113,86,2009,total_driving,NA
T58,61,Adam Schenk,10,199,33,166,2009,total_driving,NA
T58,T64,Scott Harrington,9,199,34,165,2009,total_driving,NA
T61,T52,Brian Harman,8,200,143,57,2009,total_driving,NA
T61,47,Jason Dufner,7,200,140,60,2009,total_driving,NA
T61,59,Cameron Smith,6,200,77,123,2009,total_driving,NA
T64,46,Kramer Hickok,9,201,124,77,2009,total_driving,NA
T64,60,Matt Jones,8,201,49,152,2009,total_driving,NA
66,30,Robby Shelton,10,202,88,114,2009,total_driving,NA
T67,83,Grayson Murray,6,203,4,199,2009,total_driving,NA
T67,T73,Russell Knox,8,203,138,65,2009,total_driving,NA
69,41,Denny McCarthy,8,204,101,103,2009,total_driving,NA
70,T80,Sam Ryder,10,209,53,156,2009,total_driving,NA
71,58,Brice Garnett,8,214,150,64,2009,total_driving,NA
72,66,Michael Thompson,7,215,175,40,2009,total_driving,NA
73,76,Collin Morikawa,6,216,168,48,2009,total_driving,NA
T74,T69,Derek Ernst,4,217,80,137,2009,total_driving,NA
T74,T67,Adam Long,10,217,189,28,2009,total_driving,NA
T74,96,Andrew Landry,9,217,171,46,2009,total_driving,NA
77,T84,Akshay Bhatia,5,218,7,211,2009,total_driving,NA
78,T69,Rod Pampling,3,220,28,192,2009,total_driving,NA
79,136,Nick Watney,7,222,73,149,2009,total_driving,NA
T80,T84,Hideki Matsuyama,6,223,115,108,2009,total_driving,NA
T80,115,Doug Ghim,7,223,116,107,2009,total_driving,NA
T80,T90,Kristoffer Ventura,9,223,44,179,2009,total_driving,NA
T83,T73,Byeong Hun An,8,225,10,215,2009,total_driving,NA
T83,T90,Chandler Phillips,2,225,57,168,2009,total_driving,NA
T83,T69,Brian Stuard,10,225,215,10,2009,total_driving,NA
T83,T97,Alex Cejka,5,225,175,50,2009,total_driving,NA
T83,T80,Ryan Armour,9,225,217,8,2009,total_driving,NA
T88,T90,Graham DeLaet,5,226,36,190,2009,total_driving,NA
T88,T77,Tim Wilkinson,6,226,189,37,2009,total_driving,NA
T88,T86,Brandon Wu,2,226,188,38,2009,total_driving,NA
T91,T88,Hank Lebioda,9,228,104,124,2009,total_driving,NA
T91,79,Charles Howell III,9,228,69,159,2009,total_driving,NA
93,T67,Tyler McCumber,9,229,11,218,2009,total_driving,NA
94,T90,Fabián Gómez,9,230,167,63,2009,total_driving,NA
95,T90,Brendon Todd,11,231,228,3,2009,total_driving,NA
T96,49,Cameron Percy,8,233,61,172,2009,total_driving,NA
T96,T99,Adam Scott,4,233,46,187,2009,total_driving,NA
T96,T80,Luke List,9,233,80,153,2009,total_driving,NA
T96,T86,Russell Henley,8,233,179,54,2009,total_driving,NA
T96,T130,Mackenzie Hughes,8,233,101,132,2009,total_driving,NA
101,T109,J.T. Poston,9,234,175,59,2009,total_driving,NA
102,T64,Vince Covello,8,235,73,162,2009,total_driving,NA
103,T99,Xinjun Zhang,10,236,116,120,2009,total_driving,NA
104,105,K.J. Choi,3,237,233,4,2009,total_driving,NA
T105,107,Tim Herron,4,238,220,18,2009,total_driving,NA
T105,T109,Corey Conners,7,238,186,52,2009,total_driving,NA
T107,108,Keith Mitchell,7,239,135,104,2009,total_driving,NA
T107,T130,Cameron Davis,8,239,22,217,2009,total_driving,NA
T107,T99,Richy Werenski,4,239,45,194,2009,total_driving,NA
T107,T88,Vaughn Taylor,8,239,212,27,2009,total_driving,NA
111,168,Chris Baker,9,240,168,72,2009,total_driving,NA
T112,T112,Jim Herman,8,241,221,20,2009,total_driving,NA
T112,T127,Scott Piercy,8,241,105,136,2009,total_driving,NA
T114,T120,J.J. Henry,5,242,173,69,2009,total_driving,NA
T114,T103,Tyler Duncan,10,242,221,21,2009,total_driving,NA
116,T112,Davis Riley,2,243,83,160,2009,total_driving,NA
T117,T125,Bo Hoag,10,244,127,117,2009,total_driving,NA
T117,T116,Chez Reavie,9,244,228,16,2009,total_driving,NA
119,T116,Matt Kuchar,4,245,238,7,2009,total_driving,NA
T120,223,Paul Casey,4,247,160,87,2009,total_driving,NA
T120,T116,Satoshi Kodaira,6,247,234,13,2009,total_driving,NA
T120,T127,Shawn Stefani,6,247,73,174,2009,total_driving,NA
123,106,Carlos Ortiz,8,248,67,181,2009,total_driving,NA
124,T122,Ben Crane,6,249,207,42,2009,total_driving,NA
125,T130,Tom Lewis,3,252,5,247,2009,total_driving,NA
126,T139,Michael Gligic,9,253,73,180,2009,total_driving,NA
T127,T139,Scott Stallings,8,254,47,207,2009,total_driving,NA
T127,T137,Kyle Stanley,8,254,213,41,2009,total_driving,NA
T129,T137,Henrik Stenson,2,255,202,53,2009,total_driving,NA
T129,T125,Austin Cook,8,255,127,128,2009,total_driving,NA
T131,T120,Beau Hossler,8,256,29,227,2009,total_driving,NA
T131,T122,Patrick Rodgers,10,256,26,230,2009,total_driving,NA
T131,T143,Sebastian Cappelen,8,256,30,226,2009,total_driving,NA
T131,T133,Kurt Kitayama,2,256,3,253,2009,total_driving,NA
T131,T77,Vincent Whaley,7,256,103,153,2009,total_driving,NA
T131,T141,Ryan Brehm,10,256,6,250,2009,total_driving,NA
137,T122,Mark Hubbard,10,257,149,108,2009,total_driving,NA
T138,T163,Brandon Hagy,8,258,22,236,2009,total_driving,NA
T138,T109,Billy Horschel,6,258,196,62,2009,total_driving,NA
T140,T147,Sam Burns,6,259,20,239,2009,total_driving,NA
T140,T133,David Lingmerth,5,259,230,29,2009,total_driving,NA
T142,T187,Bud Cauley,6,262,125,137,2009,total_driving,NA
T142,T143,Cameron Tringale,7,262,55,207,2009,total_driving,NA
144,T143,Rikuya Hoshino,2,264,138,126,2009,total_driving,NA
145,T155,Jonathan Byrd,5,265,72,193,2009,total_driving,NA
T146,T116,Maverick McNealy,9,266,89,177,2009,total_driving,NA
T146,T147,Xander Schauffele,3,266,231,35,2009,total_driving,NA
T148,154,Whee Kim,2,267,180,87,2009,total_driving,NA
T148,T141,Lucas Bjerregaard,3,267,18,249,2009,total_driving,NA
150,T152,Chip McDaniel,2,268,59,209,2009,total_driving,NA
T151,T178,Max Homa,6,269,187,82,2009,total_driving,NA
T151,T112,Bill Haas,6,269,147,122,2009,total_driving,NA
T151,146,J.B. Holmes,3,269,224,45,2009,total_driving,NA
T154,129,Zack Sucher,6,270,24,246,2009,total_driving,NA
T154,T157,Roberto Castro,5,270,183,87,2009,total_driving,NA
156,151,Kevin Tway,6,271,27,244,2009,total_driving,NA
T157,T155,Kevin Chappell,6,272,43,229,2009,total_driving,NA
T157,T152,Dominic Bozzelli,7,272,38,234,2009,total_driving,NA
T159,T147,David Hearn,9,273,206,67,2009,total_driving,NA
T159,174,Jimmy Walker,4,273,92,181,2009,total_driving,NA
161,165,Sangmoon Bae,6,274,64,210,2009,total_driving,NA
162,167,Michael Gellerman,8,275,135,140,2009,total_driving,NA
163,T159,Kevin Kisner,7,277,227,50,2009,total_driving,NA
T164,T159,Justin Thomas,5,278,161,117,2009,total_driving,NA
T164,T187,Troy Merritt,7,278,182,96,2009,total_driving,NA
T164,T163,Freddie Jacobson,3,278,141,137,2009,total_driving,NA
167,T175,Talor Gooch,8,280,122,158,2009,total_driving,NA
168,T103,Andrew Putnam,6,283,181,102,2009,total_driving,NA
T169,T157,Si Woo Kim,8,284,99,185,2009,total_driving,NA
T169,T97,Charley Hoffman,7,284,87,197,2009,total_driving,NA
T169,169,Seamus Power,5,284,83,201,2009,total_driving,NA
172,T133,John Huh,5,285,166,119,2009,total_driving,NA
T173,T172,Jason Day,3,286,80,206,2009,total_driving,NA
T173,T172,Chris Kirk,3,286,199,87,2009,total_driving,NA
T173,T175,Rafael Campos,9,286,67,219,2009,total_driving,NA
176,T159,Nate Lashley,8,287,204,83,2009,total_driving,NA
177,177,Brandt Snedeker,4,288,155,133,2009,total_driving,NA
178,T178,Peter Uihlein,6,289,38,251,2009,total_driving,NA
179,150,Kevin Na,7,290,203,87,2009,total_driving,NA
180,T170,Ben Taylor,10,291,134,157,2009,total_driving,NA
181,162,Anirban Lahiri,8,292,118,174,2009,total_driving,NA
182,T208,Roger Sloan,8,293,158,135,2009,total_driving,NA
T183,182,Johnson Wagner,5,294,207,87,2009,total_driving,NA
T183,T183,Robert Garrigus,5,294,52,242,2009,total_driving,NA
T183,T187,Wes Roach,7,294,151,143,2009,total_driving,NA
186,181,Zach Johnson,7,299,216,83,2009,total_driving,NA
187,191,Mikumu Horikawa,3,303,237,66,2009,total_driving,NA
T188,194,Will Gordon,4,304,64,240,2009,total_driving,NA
T188,210,Rory Sabbatini,7,304,219,85,2009,total_driving,NA
T188,T183,Dylan Frittelli,9,304,193,111,2009,total_driving,NA
191,185,Nelson Ledesma,10,305,57,248,2009,total_driving,NA
192,192,Marc Leishman,5,306,90,216,2009,total_driving,NA
193,166,Joseph Bramlett,7,307,94,213,2009,total_driving,NA
194,195,Joaquin Niemann,8,308,164,144,2009,total_driving,NA
T195,T196,Graeme McDowell,5,311,236,75,2009,total_driving,NA
T195,T201,Bronson Burgoon,8,311,130,181,2009,total_driving,NA
197,T187,Brian Gay,9,312,162,150,2009,total_driving,NA
198,193,Rhein Gibson,9,313,90,223,2009,total_driving,NA
199,T196,Tom Hoge,8,314,185,129,2009,total_driving,NA
200,200,Mark Anderson,7,319,132,187,2009,total_driving,NA
201,204,Smylie Kaufman,3,320,64,256,2009,total_driving,NA
T202,199,Zac Blair,10,322,225,97,2009,total_driving,NA
T202,214,Francesco Molinari,3,322,125,197,2009,total_driving,NA
T204,T170,John Senden,5,324,120,204,2009,total_driving,NA
T204,180,Ben Martin,6,324,223,101,2009,total_driving,NA
T206,T205,James Hahn,6,325,163,162,2009,total_driving,NA
T206,186,Aaron Baddeley,6,325,198,127,2009,total_driving,NA
208,T211,J.J. Spaun,9,330,118,212,2009,total_driving,NA
T209,203,Robert Streb,9,332,141,191,2009,total_driving,NA
T209,T208,Robert Allenby,3,332,164,168,2009,total_driving,NA
211,T211,Martin Trainer,8,339,94,245,2009,total_driving,NA
212,T205,"Ted Potter, Jr.",7,340,151,189,2009,total_driving,NA
213,T201,Chris Stroud,6,341,194,147,2009,total_driving,NA
T214,T205,Rob Oppenheim,10,342,200,142,2009,total_driving,NA
T214,198,Matt Every,7,342,122,220,2009,total_driving,NA
T214,213,Morgan Hoffmann,4,342,143,199,2009,total_driving,NA
217,215,Roberto Díaz,2,345,110,235,2009,total_driving,NA
218,216,Stewart Cink,4,350,112,238,2009,total_driving,NA
219,217,C.T. Pan,5,353,189,164,2009,total_driving,NA
220,T218,Patton Kizzire,9,354,158,196,2009,total_driving,NA
221,222,Hudson Swafford,4,356,183,173,2009,total_driving,NA
222,T218,George McNeill,6,359,145,214,2009,total_driving,NA
223,220,Patrick Reed,4,363,239,124,2009,total_driving,NA
224,221,Jamie Lovemark,4,365,114,251,2009,total_driving,NA
225,224,Luke Donald,2,378,232,146,2009,total_driving,NA
226,226,Bo Van Pelt,7,387,155,232,2009,total_driving,NA
227,225,Davis Love III,3,400,172,228,2009,total_driving,NA
228,228,Arjun Atwal,5,404,173,231,2009,total_driving,NA
T229,231,Daniel Chopra,3,411,157,254,2009,total_driving,NA
T229,227,Kevin Stadler,6,411,217,194,2009,total_driving,NA
231,229,John Rollins,4,414,209,205,2009,total_driving,NA
232,230,Parker McLachlin,4,421,201,220,2009,total_driving,NA
233,232,Peter Malnati,9,422,197,225,2009,total_driving,NA
234,233,Michael Kim,8,435,211,224,2009,total_driving,NA
235,235,Tommy Gainey,4,442,209,233,2009,total_driving,NA
236,234,D.A. Points,4,446,226,220,2009,total_driving,NA
237,236,Ricky Barnes,6,451,214,237,2009,total_driving,NA
238,237,Brendon de Jonge,3,462,205,257,2009,total_driving,NA
239,238,Shugo Imahira,2,490,235,255,2009,total_driving,NA
1,1,Andrew Novak,2,35,17,18,2010,total_driving,NA
2,3,Viktor Hovland,4,63,16,47,2010,total_driving,NA
3,4,Chase Koepka,2,72,34,38,2010,total_driving,NA
4,5,John Oda,2,74,70,4,2010,total_driving,NA
5,6,D.J. Trahan,7,91,47,44,2010,total_driving,NA
6,8,Gary Woodland,4,98,94,4,2010,total_driving,NA
7,9,Branden Grace,4,99,21,78,2010,total_driving,NA
T8,10,Patrick Cantlay,3,103,86,17,2010,total_driving,NA
T8,7,Doc Redman,10,103,77,26,2010,total_driving,NA
10,2,Ryan Moore,5,105,94,11,2010,total_driving,NA
11,13,Scottie Scheffler,8,126,15,111,2010,total_driving,NA
12,T19,Kyoung-Hoon Lee,10,128,106,22,2010,total_driving,NA
13,14,Martin Laird,8,129,42,87,2010,total_driving,NA
14,11,Kevin Streelman,9,130,62,68,2010,total_driving,NA
15,25,Jhonattan Vegas,6,132,24,108,2010,total_driving,NA
T16,15,Nick Taylor,8,133,109,24,2010,total_driving,NA
T16,T23,Brendan Steele,8,133,63,70,2010,total_driving,NA
18,12,Harris English,7,135,36,99,2010,total_driving,NA
T19,T27,Harry Higgs,10,140,79,61,2010,total_driving,NA
T19,T27,Sung Kang,7,140,53,87,2010,total_driving,NA
T21,22,Emiliano Grillo,7,142,110,32,2010,total_driving,NA
T21,18,Bubba Watson,4,142,1,141,2010,total_driving,NA
23,T19,Bryson DeChambeau,3,144,13,131,2010,total_driving,NA
24,T52,Matthew Wolff,5,145,40,105,2010,total_driving,NA
25,29,Joel Dahmen,8,149,100,49,2010,total_driving,NA
26,16,Jason Kokrak,5,153,8,145,2010,total_driving,NA
27,17,Josh Teater,6,156,83,73,2010,total_driving,NA
28,T23,Cameron Champ,7,157,2,155,2010,total_driving,NA
29,33,Ryan Palmer,5,160,146,14,2010,total_driving,NA
30,T35,Adam Hadwin,5,164,121,43,2010,total_driving,NA
31,26,Sungjae Im,8,165,50,115,2010,total_driving,NA
32,31,Henrik Norlander,10,168,132,36,2010,total_driving,NA
T33,38,Boo Weekley,5,169,147,22,2010,total_driving,NA
T33,T35,Harold Varner III,7,169,18,151,2010,total_driving,NA
35,37,Lanto Griffin,10,170,40,130,2010,total_driving,NA
36,T19,Lucas Glover,7,174,98,76,2010,total_driving,NA
37,34,Scott Brown,9,175,151,24,2010,total_driving,NA
38,T44,Sebastián Muñoz,10,176,60,116,2010,total_driving,NA
T39,40,Daniel Berger,6,177,56,121,2010,total_driving,NA
T39,42,Keegan Bradley,7,177,71,106,2010,total_driving,NA
41,39,Chesson Hadley,7,179,106,73,2010,total_driving,NA
42,43,Webb Simpson,3,182,170,12,2010,total_driving,NA
43,48,Danny Lee,7,185,9,176,2010,total_driving,NA
44,T50,Pat Perez,6,186,130,56,2010,total_driving,NA
45,T52,Matthew NeSmith,9,188,154,34,2010,total_driving,NA
46,T99,Sepp Straka,10,191,92,99,2010,total_driving,NA
T47,T90,Isaiah Salinda,3,192,14,178,2010,total_driving,NA
T47,T56,John Merrick,4,192,135,57,2010,total_driving,NA
T49,T50,Jim Furyk,3,193,192,1,2010,total_driving,NA
T49,55,Chad Campbell,4,193,178,15,2010,total_driving,NA
T49,T44,Wyndham Clark,7,193,32,161,2010,total_driving,NA
52,32,Alex Noren,4,195,108,87,2010,total_driving,NA
53,NA,Rickie Fowler,2,196,194,2,2010,total_driving,NA
T54,T56,Tony Finau,5,198,12,186,2010,total_driving,NA
T54,T62,Phil Mickelson,5,198,31,167,2010,total_driving,NA
T54,T62,Aaron Wise,7,198,51,147,2010,total_driving,NA
T54,T69,Chase Seiffert,9,198,127,71,2010,total_driving,NA
T58,T73,Abraham Ancer,8,199,113,86,2010,total_driving,NA
T58,61,Adam Schenk,10,199,33,166,2010,total_driving,NA
T58,T64,Scott Harrington,9,199,34,165,2010,total_driving,NA
T61,T52,Brian Harman,8,200,143,57,2010,total_driving,NA
T61,47,Jason Dufner,7,200,140,60,2010,total_driving,NA
T61,59,Cameron Smith,6,200,77,123,2010,total_driving,NA
T64,46,Kramer Hickok,9,201,124,77,2010,total_driving,NA
T64,60,Matt Jones,8,201,49,152,2010,total_driving,NA
66,30,Robby Shelton,10,202,88,114,2010,total_driving,NA
T67,83,Grayson Murray,6,203,4,199,2010,total_driving,NA
T67,T73,Russell Knox,8,203,138,65,2010,total_driving,NA
69,41,Denny McCarthy,8,204,101,103,2010,total_driving,NA
70,T80,Sam Ryder,10,209,53,156,2010,total_driving,NA
71,58,Brice Garnett,8,214,150,64,2010,total_driving,NA
72,66,Michael Thompson,7,215,175,40,2010,total_driving,NA
73,76,Collin Morikawa,6,216,168,48,2010,total_driving,NA
T74,T69,Derek Ernst,4,217,80,137,2010,total_driving,NA
T74,T67,Adam Long,10,217,189,28,2010,total_driving,NA
T74,96,Andrew Landry,9,217,171,46,2010,total_driving,NA
77,T84,Akshay Bhatia,5,218,7,211,2010,total_driving,NA
78,T69,Rod Pampling,3,220,28,192,2010,total_driving,NA
79,136,Nick Watney,7,222,73,149,2010,total_driving,NA
T80,T84,Hideki Matsuyama,6,223,115,108,2010,total_driving,NA
T80,115,Doug Ghim,7,223,116,107,2010,total_driving,NA
T80,T90,Kristoffer Ventura,9,223,44,179,2010,total_driving,NA
T83,T73,Byeong Hun An,8,225,10,215,2010,total_driving,NA
T83,T90,Chandler Phillips,2,225,57,168,2010,total_driving,NA
T83,T69,Brian Stuard,10,225,215,10,2010,total_driving,NA
T83,T97,Alex Cejka,5,225,175,50,2010,total_driving,NA
T83,T80,Ryan Armour,9,225,217,8,2010,total_driving,NA
T88,T90,Graham DeLaet,5,226,36,190,2010,total_driving,NA
T88,T77,Tim Wilkinson,6,226,189,37,2010,total_driving,NA
T88,T86,Brandon Wu,2,226,188,38,2010,total_driving,NA
T91,T88,Hank Lebioda,9,228,104,124,2010,total_driving,NA
T91,79,Charles Howell III,9,228,69,159,2010,total_driving,NA
93,T67,Tyler McCumber,9,229,11,218,2010,total_driving,NA
94,T90,Fabián Gómez,9,230,167,63,2010,total_driving,NA
95,T90,Brendon Todd,11,231,228,3,2010,total_driving,NA
T96,49,Cameron Percy,8,233,61,172,2010,total_driving,NA
T96,T99,Adam Scott,4,233,46,187,2010,total_driving,NA
T96,T80,Luke List,9,233,80,153,2010,total_driving,NA
T96,T86,Russell Henley,8,233,179,54,2010,total_driving,NA
T96,T130,Mackenzie Hughes,8,233,101,132,2010,total_driving,NA
101,T109,J.T. Poston,9,234,175,59,2010,total_driving,NA
102,T64,Vince Covello,8,235,73,162,2010,total_driving,NA
103,T99,Xinjun Zhang,10,236,116,120,2010,total_driving,NA
104,105,K.J. Choi,3,237,233,4,2010,total_driving,NA
T105,107,Tim Herron,4,238,220,18,2010,total_driving,NA
T105,T109,Corey Conners,7,238,186,52,2010,total_driving,NA
T107,108,Keith Mitchell,7,239,135,104,2010,total_driving,NA
T107,T130,Cameron Davis,8,239,22,217,2010,total_driving,NA
T107,T99,Richy Werenski,4,239,45,194,2010,total_driving,NA
T107,T88,Vaughn Taylor,8,239,212,27,2010,total_driving,NA
111,168,Chris Baker,9,240,168,72,2010,total_driving,NA
T112,T112,Jim Herman,8,241,221,20,2010,total_driving,NA
T112,T127,Scott Piercy,8,241,105,136,2010,total_driving,NA
T114,T120,J.J. Henry,5,242,173,69,2010,total_driving,NA
T114,T103,Tyler Duncan,10,242,221,21,2010,total_driving,NA
116,T112,Davis Riley,2,243,83,160,2010,total_driving,NA
T117,T125,Bo Hoag,10,244,127,117,2010,total_driving,NA
T117,T116,Chez Reavie,9,244,228,16,2010,total_driving,NA
119,T116,Matt Kuchar,4,245,238,7,2010,total_driving,NA
T120,223,Paul Casey,4,247,160,87,2010,total_driving,NA
T120,T116,Satoshi Kodaira,6,247,234,13,2010,total_driving,NA
T120,T127,Shawn Stefani,6,247,73,174,2010,total_driving,NA
123,106,Carlos Ortiz,8,248,67,181,2010,total_driving,NA
124,T122,Ben Crane,6,249,207,42,2010,total_driving,NA
125,T130,Tom Lewis,3,252,5,247,2010,total_driving,NA
126,T139,Michael Gligic,9,253,73,180,2010,total_driving,NA
T127,T139,Scott Stallings,8,254,47,207,2010,total_driving,NA
T127,T137,Kyle Stanley,8,254,213,41,2010,total_driving,NA
T129,T137,Henrik Stenson,2,255,202,53,2010,total_driving,NA
T129,T125,Austin Cook,8,255,127,128,2010,total_driving,NA
T131,T120,Beau Hossler,8,256,29,227,2010,total_driving,NA
T131,T122,Patrick Rodgers,10,256,26,230,2010,total_driving,NA
T131,T143,Sebastian Cappelen,8,256,30,226,2010,total_driving,NA
T131,T133,Kurt Kitayama,2,256,3,253,2010,total_driving,NA
T131,T77,Vincent Whaley,7,256,103,153,2010,total_driving,NA
T131,T141,Ryan Brehm,10,256,6,250,2010,total_driving,NA
137,T122,Mark Hubbard,10,257,149,108,2010,total_driving,NA
T138,T163,Brandon Hagy,8,258,22,236,2010,total_driving,NA
T138,T109,Billy Horschel,6,258,196,62,2010,total_driving,NA
T140,T147,Sam Burns,6,259,20,239,2010,total_driving,NA
T140,T133,David Lingmerth,5,259,230,29,2010,total_driving,NA
T142,T187,Bud Cauley,6,262,125,137,2010,total_driving,NA
T142,T143,Cameron Tringale,7,262,55,207,2010,total_driving,NA
144,T143,Rikuya Hoshino,2,264,138,126,2010,total_driving,NA
145,T155,Jonathan Byrd,5,265,72,193,2010,total_driving,NA
T146,T116,Maverick McNealy,9,266,89,177,2010,total_driving,NA
T146,T147,Xander Schauffele,3,266,231,35,2010,total_driving,NA
T148,154,Whee Kim,2,267,180,87,2010,total_driving,NA
T148,T141,Lucas Bjerregaard,3,267,18,249,2010,total_driving,NA
150,T152,Chip McDaniel,2,268,59,209,2010,total_driving,NA
T151,T178,Max Homa,6,269,187,82,2010,total_driving,NA
T151,T112,Bill Haas,6,269,147,122,2010,total_driving,NA
T151,146,J.B. Holmes,3,269,224,45,2010,total_driving,NA
T154,129,Zack Sucher,6,270,24,246,2010,total_driving,NA
T154,T157,Roberto Castro,5,270,183,87,2010,total_driving,NA
156,151,Kevin Tway,6,271,27,244,2010,total_driving,NA
T157,T155,Kevin Chappell,6,272,43,229,2010,total_driving,NA
T157,T152,Dominic Bozzelli,7,272,38,234,2010,total_driving,NA
T159,T147,David Hearn,9,273,206,67,2010,total_driving,NA
T159,174,Jimmy Walker,4,273,92,181,2010,total_driving,NA
161,165,Sangmoon Bae,6,274,64,210,2010,total_driving,NA
162,167,Michael Gellerman,8,275,135,140,2010,total_driving,NA
163,T159,Kevin Kisner,7,277,227,50,2010,total_driving,NA
T164,T159,Justin Thomas,5,278,161,117,2010,total_driving,NA
T164,T187,Troy Merritt,7,278,182,96,2010,total_driving,NA
T164,T163,Freddie Jacobson,3,278,141,137,2010,total_driving,NA
167,T175,Talor Gooch,8,280,122,158,2010,total_driving,NA
168,T103,Andrew Putnam,6,283,181,102,2010,total_driving,NA
T169,T157,Si Woo Kim,8,284,99,185,2010,total_driving,NA
T169,T97,Charley Hoffman,7,284,87,197,2010,total_driving,NA
T169,169,Seamus Power,5,284,83,201,2010,total_driving,NA
172,T133,John Huh,5,285,166,119,2010,total_driving,NA
T173,T172,Jason Day,3,286,80,206,2010,total_driving,NA
T173,T172,Chris Kirk,3,286,199,87,2010,total_driving,NA
T173,T175,Rafael Campos,9,286,67,219,2010,total_driving,NA
176,T159,Nate Lashley,8,287,204,83,2010,total_driving,NA
177,177,Brandt Snedeker,4,288,155,133,2010,total_driving,NA
178,T178,Peter Uihlein,6,289,38,251,2010,total_driving,NA
179,150,Kevin Na,7,290,203,87,2010,total_driving,NA
180,T170,Ben Taylor,10,291,134,157,2010,total_driving,NA
181,162,Anirban Lahiri,8,292,118,174,2010,total_driving,NA
182,T208,Roger Sloan,8,293,158,135,2010,total_driving,NA
T183,182,Johnson Wagner,5,294,207,87,2010,total_driving,NA
T183,T183,Robert Garrigus,5,294,52,242,2010,total_driving,NA
T183,T187,Wes Roach,7,294,151,143,2010,total_driving,NA
186,181,Zach Johnson,7,299,216,83,2010,total_driving,NA
187,191,Mikumu Horikawa,3,303,237,66,2010,total_driving,NA
T188,194,Will Gordon,4,304,64,240,2010,total_driving,NA
T188,210,Rory Sabbatini,7,304,219,85,2010,total_driving,NA
T188,T183,Dylan Frittelli,9,304,193,111,2010,total_driving,NA
191,185,Nelson Ledesma,10,305,57,248,2010,total_driving,NA
192,192,Marc Leishman,5,306,90,216,2010,total_driving,NA
193,166,Joseph Bramlett,7,307,94,213,2010,total_driving,NA
194,195,Joaquin Niemann,8,308,164,144,2010,total_driving,NA
T195,T196,Graeme McDowell,5,311,236,75,2010,total_driving,NA
T195,T201,Bronson Burgoon,8,311,130,181,2010,total_driving,NA
197,T187,Brian Gay,9,312,162,150,2010,total_driving,NA
198,193,Rhein Gibson,9,313,90,223,2010,total_driving,NA
199,T196,Tom Hoge,8,314,185,129,2010,total_driving,NA
200,200,Mark Anderson,7,319,132,187,2010,total_driving,NA
201,204,Smylie Kaufman,3,320,64,256,2010,total_driving,NA
T202,199,Zac Blair,10,322,225,97,2010,total_driving,NA
T202,214,Francesco Molinari,3,322,125,197,2010,total_driving,NA
T204,T170,John Senden,5,324,120,204,2010,total_driving,NA
T204,180,Ben Martin,6,324,223,101,2010,total_driving,NA
T206,T205,James Hahn,6,325,163,162,2010,total_driving,NA
T206,186,Aaron Baddeley,6,325,198,127,2010,total_driving,NA
208,T211,J.J. Spaun,9,330,118,212,2010,total_driving,NA
T209,203,Robert Streb,9,332,141,191,2010,total_driving,NA
T209,T208,Robert Allenby,3,332,164,168,2010,total_driving,NA
211,T211,Martin Trainer,8,339,94,245,2010,total_driving,NA
212,T205,"Ted Potter, Jr.",7,340,151,189,2010,total_driving,NA
213,T201,Chris Stroud,6,341,194,147,2010,total_driving,NA
T214,T205,Rob Oppenheim,10,342,200,142,2010,total_driving,NA
T214,198,Matt Every,7,342,122,220,2010,total_driving,NA
T214,213,Morgan Hoffmann,4,342,143,199,2010,total_driving,NA
217,215,Roberto Díaz,2,345,110,235,2010,total_driving,NA
218,216,Stewart Cink,4,350,112,238,2010,total_driving,NA
219,217,C.T. Pan,5,353,189,164,2010,total_driving,NA
220,T218,Patton Kizzire,9,354,158,196,2010,total_driving,NA
221,222,Hudson Swafford,4,356,183,173,2010,total_driving,NA
222,T218,George McNeill,6,359,145,214,2010,total_driving,NA
223,220,Patrick Reed,4,363,239,124,2010,total_driving,NA
224,221,Jamie Lovemark,4,365,114,251,2010,total_driving,NA
225,224,Luke Donald,2,378,232,146,2010,total_driving,NA
226,226,Bo Van Pelt,7,387,155,232,2010,total_driving,NA
227,225,Davis Love III,3,400,172,228,2010,total_driving,NA
228,228,Arjun Atwal,5,404,173,231,2010,total_driving,NA
T229,231,Daniel Chopra,3,411,157,254,2010,total_driving,NA
T229,227,Kevin Stadler,6,411,217,194,2010,total_driving,NA
231,229,John Rollins,4,414,209,205,2010,total_driving,NA
232,230,Parker McLachlin,4,421,201,220,2010,total_driving,NA
233,232,Peter Malnati,9,422,197,225,2010,total_driving,NA
234,233,Michael Kim,8,435,211,224,2010,total_driving,NA
235,235,Tommy Gainey,4,442,209,233,2010,total_driving,NA
236,234,D.A. Points,4,446,226,220,2010,total_driving,NA
237,236,Ricky Barnes,6,451,214,237,2010,total_driving,NA
238,237,Brendon de Jonge,3,462,205,257,2010,total_driving,NA
239,238,Shugo Imahira,2,490,235,255,2010,total_driving,NA
1,1,Andrew Novak,2,35,17,18,2011,total_driving,NA
2,3,Viktor Hovland,4,63,16,47,2011,total_driving,NA
3,4,Chase Koepka,2,72,34,38,2011,total_driving,NA
4,5,John Oda,2,74,70,4,2011,total_driving,NA
5,6,D.J. Trahan,7,91,47,44,2011,total_driving,NA
6,8,Gary Woodland,4,98,94,4,2011,total_driving,NA
7,9,Branden Grace,4,99,21,78,2011,total_driving,NA
T8,10,Patrick Cantlay,3,103,86,17,2011,total_driving,NA
T8,7,Doc Redman,10,103,77,26,2011,total_driving,NA
10,2,Ryan Moore,5,105,94,11,2011,total_driving,NA
11,13,Scottie Scheffler,8,126,15,111,2011,total_driving,NA
12,T19,Kyoung-Hoon Lee,10,128,106,22,2011,total_driving,NA
13,14,Martin Laird,8,129,42,87,2011,total_driving,NA
14,11,Kevin Streelman,9,130,62,68,2011,total_driving,NA
15,25,Jhonattan Vegas,6,132,24,108,2011,total_driving,NA
T16,15,Nick Taylor,8,133,109,24,2011,total_driving,NA
T16,T23,Brendan Steele,8,133,63,70,2011,total_driving,NA
18,12,Harris English,7,135,36,99,2011,total_driving,NA
T19,T27,Harry Higgs,10,140,79,61,2011,total_driving,NA
T19,T27,Sung Kang,7,140,53,87,2011,total_driving,NA
T21,22,Emiliano Grillo,7,142,110,32,2011,total_driving,NA
T21,18,Bubba Watson,4,142,1,141,2011,total_driving,NA
23,T19,Bryson DeChambeau,3,144,13,131,2011,total_driving,NA
24,T52,Matthew Wolff,5,145,40,105,2011,total_driving,NA
25,29,Joel Dahmen,8,149,100,49,2011,total_driving,NA
26,16,Jason Kokrak,5,153,8,145,2011,total_driving,NA
27,17,Josh Teater,6,156,83,73,2011,total_driving,NA
28,T23,Cameron Champ,7,157,2,155,2011,total_driving,NA
29,33,Ryan Palmer,5,160,146,14,2011,total_driving,NA
30,T35,Adam Hadwin,5,164,121,43,2011,total_driving,NA
31,26,Sungjae Im,8,165,50,115,2011,total_driving,NA
32,31,Henrik Norlander,10,168,132,36,2011,total_driving,NA
T33,38,Boo Weekley,5,169,147,22,2011,total_driving,NA
T33,T35,Harold Varner III,7,169,18,151,2011,total_driving,NA
35,37,Lanto Griffin,10,170,40,130,2011,total_driving,NA
36,T19,Lucas Glover,7,174,98,76,2011,total_driving,NA
37,34,Scott Brown,9,175,151,24,2011,total_driving,NA
38,T44,Sebastián Muñoz,10,176,60,116,2011,total_driving,NA
T39,40,Daniel Berger,6,177,56,121,2011,total_driving,NA
T39,42,Keegan Bradley,7,177,71,106,2011,total_driving,NA
41,39,Chesson Hadley,7,179,106,73,2011,total_driving,NA
42,43,Webb Simpson,3,182,170,12,2011,total_driving,NA
43,48,Danny Lee,7,185,9,176,2011,total_driving,NA
44,T50,Pat Perez,6,186,130,56,2011,total_driving,NA
45,T52,Matthew NeSmith,9,188,154,34,2011,total_driving,NA
46,T99,Sepp Straka,10,191,92,99,2011,total_driving,NA
T47,T90,Isaiah Salinda,3,192,14,178,2011,total_driving,NA
T47,T56,John Merrick,4,192,135,57,2011,total_driving,NA
T49,T50,Jim Furyk,3,193,192,1,2011,total_driving,NA
T49,55,Chad Campbell,4,193,178,15,2011,total_driving,NA
T49,T44,Wyndham Clark,7,193,32,161,2011,total_driving,NA
52,32,Alex Noren,4,195,108,87,2011,total_driving,NA
53,NA,Rickie Fowler,2,196,194,2,2011,total_driving,NA
T54,T56,Tony Finau,5,198,12,186,2011,total_driving,NA
T54,T62,Phil Mickelson,5,198,31,167,2011,total_driving,NA
T54,T62,Aaron Wise,7,198,51,147,2011,total_driving,NA
T54,T69,Chase Seiffert,9,198,127,71,2011,total_driving,NA
T58,T73,Abraham Ancer,8,199,113,86,2011,total_driving,NA
T58,61,Adam Schenk,10,199,33,166,2011,total_driving,NA
T58,T64,Scott Harrington,9,199,34,165,2011,total_driving,NA
T61,T52,Brian Harman,8,200,143,57,2011,total_driving,NA
T61,47,Jason Dufner,7,200,140,60,2011,total_driving,NA
T61,59,Cameron Smith,6,200,77,123,2011,total_driving,NA
T64,46,Kramer Hickok,9,201,124,77,2011,total_driving,NA
T64,60,Matt Jones,8,201,49,152,2011,total_driving,NA
66,30,Robby Shelton,10,202,88,114,2011,total_driving,NA
T67,83,Grayson Murray,6,203,4,199,2011,total_driving,NA
T67,T73,Russell Knox,8,203,138,65,2011,total_driving,NA
69,41,Denny McCarthy,8,204,101,103,2011,total_driving,NA
70,T80,Sam Ryder,10,209,53,156,2011,total_driving,NA
71,58,Brice Garnett,8,214,150,64,2011,total_driving,NA
72,66,Michael Thompson,7,215,175,40,2011,total_driving,NA
73,76,Collin Morikawa,6,216,168,48,2011,total_driving,NA
T74,T69,Derek Ernst,4,217,80,137,2011,total_driving,NA
T74,T67,Adam Long,10,217,189,28,2011,total_driving,NA
T74,96,Andrew Landry,9,217,171,46,2011,total_driving,NA
77,T84,Akshay Bhatia,5,218,7,211,2011,total_driving,NA
78,T69,Rod Pampling,3,220,28,192,2011,total_driving,NA
79,136,Nick Watney,7,222,73,149,2011,total_driving,NA
T80,T84,Hideki Matsuyama,6,223,115,108,2011,total_driving,NA
T80,115,Doug Ghim,7,223,116,107,2011,total_driving,NA
T80,T90,Kristoffer Ventura,9,223,44,179,2011,total_driving,NA
T83,T73,Byeong Hun An,8,225,10,215,2011,total_driving,NA
T83,T90,Chandler Phillips,2,225,57,168,2011,total_driving,NA
T83,T69,Brian Stuard,10,225,215,10,2011,total_driving,NA
T83,T97,Alex Cejka,5,225,175,50,2011,total_driving,NA
T83,T80,Ryan Armour,9,225,217,8,2011,total_driving,NA
T88,T90,Graham DeLaet,5,226,36,190,2011,total_driving,NA
T88,T77,Tim Wilkinson,6,226,189,37,2011,total_driving,NA
T88,T86,Brandon Wu,2,226,188,38,2011,total_driving,NA
T91,T88,Hank Lebioda,9,228,104,124,2011,total_driving,NA
T91,79,Charles Howell III,9,228,69,159,2011,total_driving,NA
93,T67,Tyler McCumber,9,229,11,218,2011,total_driving,NA
94,T90,Fabián Gómez,9,230,167,63,2011,total_driving,NA
95,T90,Brendon Todd,11,231,228,3,2011,total_driving,NA
T96,49,Cameron Percy,8,233,61,172,2011,total_driving,NA
T96,T99,Adam Scott,4,233,46,187,2011,total_driving,NA
T96,T80,Luke List,9,233,80,153,2011,total_driving,NA
T96,T86,Russell Henley,8,233,179,54,2011,total_driving,NA
T96,T130,Mackenzie Hughes,8,233,101,132,2011,total_driving,NA
101,T109,J.T. Poston,9,234,175,59,2011,total_driving,NA
102,T64,Vince Covello,8,235,73,162,2011,total_driving,NA
103,T99,Xinjun Zhang,10,236,116,120,2011,total_driving,NA
104,105,K.J. Choi,3,237,233,4,2011,total_driving,NA
T105,107,Tim Herron,4,238,220,18,2011,total_driving,NA
T105,T109,Corey Conners,7,238,186,52,2011,total_driving,NA
T107,108,Keith Mitchell,7,239,135,104,2011,total_driving,NA
T107,T130,Cameron Davis,8,239,22,217,2011,total_driving,NA
T107,T99,Richy Werenski,4,239,45,194,2011,total_driving,NA
T107,T88,Vaughn Taylor,8,239,212,27,2011,total_driving,NA
111,168,Chris Baker,9,240,168,72,2011,total_driving,NA
T112,T112,Jim Herman,8,241,221,20,2011,total_driving,NA
T112,T127,Scott Piercy,8,241,105,136,2011,total_driving,NA
T114,T120,J.J. Henry,5,242,173,69,2011,total_driving,NA
T114,T103,Tyler Duncan,10,242,221,21,2011,total_driving,NA
116,T112,Davis Riley,2,243,83,160,2011,total_driving,NA
T117,T125,Bo Hoag,10,244,127,117,2011,total_driving,NA
T117,T116,Chez Reavie,9,244,228,16,2011,total_driving,NA
119,T116,Matt Kuchar,4,245,238,7,2011,total_driving,NA
T120,223,Paul Casey,4,247,160,87,2011,total_driving,NA
T120,T116,Satoshi Kodaira,6,247,234,13,2011,total_driving,NA
T120,T127,Shawn Stefani,6,247,73,174,2011,total_driving,NA
123,106,Carlos Ortiz,8,248,67,181,2011,total_driving,NA
124,T122,Ben Crane,6,249,207,42,2011,total_driving,NA
125,T130,Tom Lewis,3,252,5,247,2011,total_driving,NA
126,T139,Michael Gligic,9,253,73,180,2011,total_driving,NA
T127,T139,Scott Stallings,8,254,47,207,2011,total_driving,NA
T127,T137,Kyle Stanley,8,254,213,41,2011,total_driving,NA
T129,T137,Henrik Stenson,2,255,202,53,2011,total_driving,NA
T129,T125,Austin Cook,8,255,127,128,2011,total_driving,NA
T131,T120,Beau Hossler,8,256,29,227,2011,total_driving,NA
T131,T122,Patrick Rodgers,10,256,26,230,2011,total_driving,NA
T131,T143,Sebastian Cappelen,8,256,30,226,2011,total_driving,NA
T131,T133,Kurt Kitayama,2,256,3,253,2011,total_driving,NA
T131,T77,Vincent Whaley,7,256,103,153,2011,total_driving,NA
T131,T141,Ryan Brehm,10,256,6,250,2011,total_driving,NA
137,T122,Mark Hubbard,10,257,149,108,2011,total_driving,NA
T138,T163,Brandon Hagy,8,258,22,236,2011,total_driving,NA
T138,T109,Billy Horschel,6,258,196,62,2011,total_driving,NA
T140,T147,Sam Burns,6,259,20,239,2011,total_driving,NA
T140,T133,David Lingmerth,5,259,230,29,2011,total_driving,NA
T142,T187,Bud Cauley,6,262,125,137,2011,total_driving,NA
T142,T143,Cameron Tringale,7,262,55,207,2011,total_driving,NA
144,T143,Rikuya Hoshino,2,264,138,126,2011,total_driving,NA
145,T155,Jonathan Byrd,5,265,72,193,2011,total_driving,NA
T146,T116,Maverick McNealy,9,266,89,177,2011,total_driving,NA
T146,T147,Xander Schauffele,3,266,231,35,2011,total_driving,NA
T148,154,Whee Kim,2,267,180,87,2011,total_driving,NA
T148,T141,Lucas Bjerregaard,3,267,18,249,2011,total_driving,NA
150,T152,Chip McDaniel,2,268,59,209,2011,total_driving,NA
T151,T178,Max Homa,6,269,187,82,2011,total_driving,NA
T151,T112,Bill Haas,6,269,147,122,2011,total_driving,NA
T151,146,J.B. Holmes,3,269,224,45,2011,total_driving,NA
T154,129,Zack Sucher,6,270,24,246,2011,total_driving,NA
T154,T157,Roberto Castro,5,270,183,87,2011,total_driving,NA
156,151,Kevin Tway,6,271,27,244,2011,total_driving,NA
T157,T155,Kevin Chappell,6,272,43,229,2011,total_driving,NA
T157,T152,Dominic Bozzelli,7,272,38,234,2011,total_driving,NA
T159,T147,David Hearn,9,273,206,67,2011,total_driving,NA
T159,174,Jimmy Walker,4,273,92,181,2011,total_driving,NA
161,165,Sangmoon Bae,6,274,64,210,2011,total_driving,NA
162,167,Michael Gellerman,8,275,135,140,2011,total_driving,NA
163,T159,Kevin Kisner,7,277,227,50,2011,total_driving,NA
T164,T159,Justin Thomas,5,278,161,117,2011,total_driving,NA
T164,T187,Troy Merritt,7,278,182,96,2011,total_driving,NA
T164,T163,Freddie Jacobson,3,278,141,137,2011,total_driving,NA
167,T175,Talor Gooch,8,280,122,158,2011,total_driving,NA
168,T103,Andrew Putnam,6,283,181,102,2011,total_driving,NA
T169,T157,Si Woo Kim,8,284,99,185,2011,total_driving,NA
T169,T97,Charley Hoffman,7,284,87,197,2011,total_driving,NA
T169,169,Seamus Power,5,284,83,201,2011,total_driving,NA
172,T133,John Huh,5,285,166,119,2011,total_driving,NA
T173,T172,Jason Day,3,286,80,206,2011,total_driving,NA
T173,T172,Chris Kirk,3,286,199,87,2011,total_driving,NA
T173,T175,Rafael Campos,9,286,67,219,2011,total_driving,NA
176,T159,Nate Lashley,8,287,204,83,2011,total_driving,NA
177,177,Brandt Snedeker,4,288,155,133,2011,total_driving,NA
178,T178,Peter Uihlein,6,289,38,251,2011,total_driving,NA
179,150,Kevin Na,7,290,203,87,2011,total_driving,NA
180,T170,Ben Taylor,10,291,134,157,2011,total_driving,NA
181,162,Anirban Lahiri,8,292,118,174,2011,total_driving,NA
182,T208,Roger Sloan,8,293,158,135,2011,total_driving,NA
T183,182,Johnson Wagner,5,294,207,87,2011,total_driving,NA
T183,T183,Robert Garrigus,5,294,52,242,2011,total_driving,NA
T183,T187,Wes Roach,7,294,151,143,2011,total_driving,NA
186,181,Zach Johnson,7,299,216,83,2011,total_driving,NA
187,191,Mikumu Horikawa,3,303,237,66,2011,total_driving,NA
T188,194,Will Gordon,4,304,64,240,2011,total_driving,NA
T188,210,Rory Sabbatini,7,304,219,85,2011,total_driving,NA
T188,T183,Dylan Frittelli,9,304,193,111,2011,total_driving,NA
191,185,Nelson Ledesma,10,305,57,248,2011,total_driving,NA
192,192,Marc Leishman,5,306,90,216,2011,total_driving,NA
193,166,Joseph Bramlett,7,307,94,213,2011,total_driving,NA
194,195,Joaquin Niemann,8,308,164,144,2011,total_driving,NA
T195,T196,Graeme McDowell,5,311,236,75,2011,total_driving,NA
T195,T201,Bronson Burgoon,8,311,130,181,2011,total_driving,NA
197,T187,Brian Gay,9,312,162,150,2011,total_driving,NA
198,193,Rhein Gibson,9,313,90,223,2011,total_driving,NA
199,T196,Tom Hoge,8,314,185,129,2011,total_driving,NA
200,200,Mark Anderson,7,319,132,187,2011,total_driving,NA
201,204,Smylie Kaufman,3,320,64,256,2011,total_driving,NA
T202,199,Zac Blair,10,322,225,97,2011,total_driving,NA
T202,214,Francesco Molinari,3,322,125,197,2011,total_driving,NA
T204,T170,John Senden,5,324,120,204,2011,total_driving,NA
T204,180,Ben Martin,6,324,223,101,2011,total_driving,NA
T206,T205,James Hahn,6,325,163,162,2011,total_driving,NA
T206,186,Aaron Baddeley,6,325,198,127,2011,total_driving,NA
208,T211,J.J. Spaun,9,330,118,212,2011,total_driving,NA
T209,203,Robert Streb,9,332,141,191,2011,total_driving,NA
T209,T208,Robert Allenby,3,332,164,168,2011,total_driving,NA
211,T211,Martin Trainer,8,339,94,245,2011,total_driving,NA
212,T205,"Ted Potter, Jr.",7,340,151,189,2011,total_driving,NA
213,T201,Chris Stroud,6,341,194,147,2011,total_driving,NA
T214,T205,Rob Oppenheim,10,342,200,142,2011,total_driving,NA
T214,198,Matt Every,7,342,122,220,2011,total_driving,NA
T214,213,Morgan Hoffmann,4,342,143,199,2011,total_driving,NA
217,215,Roberto Díaz,2,345,110,235,2011,total_driving,NA
218,216,Stewart Cink,4,350,112,238,2011,total_driving,NA
219,217,C.T. Pan,5,353,189,164,2011,total_driving,NA
220,T218,Patton Kizzire,9,354,158,196,2011,total_driving,NA
221,222,Hudson Swafford,4,356,183,173,2011,total_driving,NA
222,T218,George McNeill,6,359,145,214,2011,total_driving,NA
223,220,Patrick Reed,4,363,239,124,2011,total_driving,NA
224,221,Jamie Lovemark,4,365,114,251,2011,total_driving,NA
225,224,Luke Donald,2,378,232,146,2011,total_driving,NA
226,226,Bo Van Pelt,7,387,155,232,2011,total_driving,NA
227,225,Davis Love III,3,400,172,228,2011,total_driving,NA
228,228,Arjun Atwal,5,404,173,231,2011,total_driving,NA
T229,231,Daniel Chopra,3,411,157,254,2011,total_driving,NA
T229,227,Kevin Stadler,6,411,217,194,2011,total_driving,NA
231,229,John Rollins,4,414,209,205,2011,total_driving,NA
232,230,Parker McLachlin,4,421,201,220,2011,total_driving,NA
233,232,Peter Malnati,9,422,197,225,2011,total_driving,NA
234,233,Michael Kim,8,435,211,224,2011,total_driving,NA
235,235,Tommy Gainey,4,442,209,233,2011,total_driving,NA
236,234,D.A. Points,4,446,226,220,2011,total_driving,NA
237,236,Ricky Barnes,6,451,214,237,2011,total_driving,NA
238,237,Brendon de Jonge,3,462,205,257,2011,total_driving,NA
239,238,Shugo Imahira,2,490,235,255,2011,total_driving,NA
1,1,Andrew Novak,2,35,17,18,2012,total_driving,NA
2,3,Viktor Hovland,4,63,16,47,2012,total_driving,NA
3,4,Chase Koepka,2,72,34,38,2012,total_driving,NA
4,5,John Oda,2,74,70,4,2012,total_driving,NA
5,6,D.J. Trahan,7,91,47,44,2012,total_driving,NA
6,8,Gary Woodland,4,98,94,4,2012,total_driving,NA
7,9,Branden Grace,4,99,21,78,2012,total_driving,NA
T8,10,Patrick Cantlay,3,103,86,17,2012,total_driving,NA
T8,7,Doc Redman,10,103,77,26,2012,total_driving,NA
10,2,Ryan Moore,5,105,94,11,2012,total_driving,NA
11,13,Scottie Scheffler,8,126,15,111,2012,total_driving,NA
12,T19,Kyoung-Hoon Lee,10,128,106,22,2012,total_driving,NA
13,14,Martin Laird,8,129,42,87,2012,total_driving,NA
14,11,Kevin Streelman,9,130,62,68,2012,total_driving,NA
15,25,Jhonattan Vegas,6,132,24,108,2012,total_driving,NA
T16,15,Nick Taylor,8,133,109,24,2012,total_driving,NA
T16,T23,Brendan Steele,8,133,63,70,2012,total_driving,NA
18,12,Harris English,7,135,36,99,2012,total_driving,NA
T19,T27,Harry Higgs,10,140,79,61,2012,total_driving,NA
T19,T27,Sung Kang,7,140,53,87,2012,total_driving,NA
T21,22,Emiliano Grillo,7,142,110,32,2012,total_driving,NA
T21,18,Bubba Watson,4,142,1,141,2012,total_driving,NA
23,T19,Bryson DeChambeau,3,144,13,131,2012,total_driving,NA
24,T52,Matthew Wolff,5,145,40,105,2012,total_driving,NA
25,29,Joel Dahmen,8,149,100,49,2012,total_driving,NA
26,16,Jason Kokrak,5,153,8,145,2012,total_driving,NA
27,17,Josh Teater,6,156,83,73,2012,total_driving,NA
28,T23,Cameron Champ,7,157,2,155,2012,total_driving,NA
29,33,Ryan Palmer,5,160,146,14,2012,total_driving,NA
30,T35,Adam Hadwin,5,164,121,43,2012,total_driving,NA
31,26,Sungjae Im,8,165,50,115,2012,total_driving,NA
32,31,Henrik Norlander,10,168,132,36,2012,total_driving,NA
T33,38,Boo Weekley,5,169,147,22,2012,total_driving,NA
T33,T35,Harold Varner III,7,169,18,151,2012,total_driving,NA
35,37,Lanto Griffin,10,170,40,130,2012,total_driving,NA
36,T19,Lucas Glover,7,174,98,76,2012,total_driving,NA
37,34,Scott Brown,9,175,151,24,2012,total_driving,NA
38,T44,Sebastián Muñoz,10,176,60,116,2012,total_driving,NA
T39,40,Daniel Berger,6,177,56,121,2012,total_driving,NA
T39,42,Keegan Bradley,7,177,71,106,2012,total_driving,NA
41,39,Chesson Hadley,7,179,106,73,2012,total_driving,NA
42,43,Webb Simpson,3,182,170,12,2012,total_driving,NA
43,48,Danny Lee,7,185,9,176,2012,total_driving,NA
44,T50,Pat Perez,6,186,130,56,2012,total_driving,NA
45,T52,Matthew NeSmith,9,188,154,34,2012,total_driving,NA
46,T99,Sepp Straka,10,191,92,99,2012,total_driving,NA
T47,T90,Isaiah Salinda,3,192,14,178,2012,total_driving,NA
T47,T56,John Merrick,4,192,135,57,2012,total_driving,NA
T49,T50,Jim Furyk,3,193,192,1,2012,total_driving,NA
T49,55,Chad Campbell,4,193,178,15,2012,total_driving,NA
T49,T44,Wyndham Clark,7,193,32,161,2012,total_driving,NA
52,32,Alex Noren,4,195,108,87,2012,total_driving,NA
53,NA,Rickie Fowler,2,196,194,2,2012,total_driving,NA
T54,T56,Tony Finau,5,198,12,186,2012,total_driving,NA
T54,T62,Phil Mickelson,5,198,31,167,2012,total_driving,NA
T54,T62,Aaron Wise,7,198,51,147,2012,total_driving,NA
T54,T69,Chase Seiffert,9,198,127,71,2012,total_driving,NA
T58,T73,Abraham Ancer,8,199,113,86,2012,total_driving,NA
T58,61,Adam Schenk,10,199,33,166,2012,total_driving,NA
T58,T64,Scott Harrington,9,199,34,165,2012,total_driving,NA
T61,T52,Brian Harman,8,200,143,57,2012,total_driving,NA
T61,47,Jason Dufner,7,200,140,60,2012,total_driving,NA
T61,59,Cameron Smith,6,200,77,123,2012,total_driving,NA
T64,46,Kramer Hickok,9,201,124,77,2012,total_driving,NA
T64,60,Matt Jones,8,201,49,152,2012,total_driving,NA
66,30,Robby Shelton,10,202,88,114,2012,total_driving,NA
T67,83,Grayson Murray,6,203,4,199,2012,total_driving,NA
T67,T73,Russell Knox,8,203,138,65,2012,total_driving,NA
69,41,Denny McCarthy,8,204,101,103,2012,total_driving,NA
70,T80,Sam Ryder,10,209,53,156,2012,total_driving,NA
71,58,Brice Garnett,8,214,150,64,2012,total_driving,NA
72,66,Michael Thompson,7,215,175,40,2012,total_driving,NA
73,76,Collin Morikawa,6,216,168,48,2012,total_driving,NA
T74,T69,Derek Ernst,4,217,80,137,2012,total_driving,NA
T74,T67,Adam Long,10,217,189,28,2012,total_driving,NA
T74,96,Andrew Landry,9,217,171,46,2012,total_driving,NA
77,T84,Akshay Bhatia,5,218,7,211,2012,total_driving,NA
78,T69,Rod Pampling,3,220,28,192,2012,total_driving,NA
79,136,Nick Watney,7,222,73,149,2012,total_driving,NA
T80,T84,Hideki Matsuyama,6,223,115,108,2012,total_driving,NA
T80,115,Doug Ghim,7,223,116,107,2012,total_driving,NA
T80,T90,Kristoffer Ventura,9,223,44,179,2012,total_driving,NA
T83,T73,Byeong Hun An,8,225,10,215,2012,total_driving,NA
T83,T90,Chandler Phillips,2,225,57,168,2012,total_driving,NA
T83,T69,Brian Stuard,10,225,215,10,2012,total_driving,NA
T83,T97,Alex Cejka,5,225,175,50,2012,total_driving,NA
T83,T80,Ryan Armour,9,225,217,8,2012,total_driving,NA
T88,T90,Graham DeLaet,5,226,36,190,2012,total_driving,NA
T88,T77,Tim Wilkinson,6,226,189,37,2012,total_driving,NA
T88,T86,Brandon Wu,2,226,188,38,2012,total_driving,NA
T91,T88,Hank Lebioda,9,228,104,124,2012,total_driving,NA
T91,79,Charles Howell III,9,228,69,159,2012,total_driving,NA
93,T67,Tyler McCumber,9,229,11,218,2012,total_driving,NA
94,T90,Fabián Gómez,9,230,167,63,2012,total_driving,NA
95,T90,Brendon Todd,11,231,228,3,2012,total_driving,NA
T96,49,Cameron Percy,8,233,61,172,2012,total_driving,NA
T96,T99,Adam Scott,4,233,46,187,2012,total_driving,NA
T96,T80,Luke List,9,233,80,153,2012,total_driving,NA
T96,T86,Russell Henley,8,233,179,54,2012,total_driving,NA
T96,T130,Mackenzie Hughes,8,233,101,132,2012,total_driving,NA
101,T109,J.T. Poston,9,234,175,59,2012,total_driving,NA
102,T64,Vince Covello,8,235,73,162,2012,total_driving,NA
103,T99,Xinjun Zhang,10,236,116,120,2012,total_driving,NA
104,105,K.J. Choi,3,237,233,4,2012,total_driving,NA
T105,107,Tim Herron,4,238,220,18,2012,total_driving,NA
T105,T109,Corey Conners,7,238,186,52,2012,total_driving,NA
T107,108,Keith Mitchell,7,239,135,104,2012,total_driving,NA
T107,T130,Cameron Davis,8,239,22,217,2012,total_driving,NA
T107,T99,Richy Werenski,4,239,45,194,2012,total_driving,NA
T107,T88,Vaughn Taylor,8,239,212,27,2012,total_driving,NA
111,168,Chris Baker,9,240,168,72,2012,total_driving,NA
T112,T112,Jim Herman,8,241,221,20,2012,total_driving,NA
T112,T127,Scott Piercy,8,241,105,136,2012,total_driving,NA
T114,T120,J.J. Henry,5,242,173,69,2012,total_driving,NA
T114,T103,Tyler Duncan,10,242,221,21,2012,total_driving,NA
116,T112,Davis Riley,2,243,83,160,2012,total_driving,NA
T117,T125,Bo Hoag,10,244,127,117,2012,total_driving,NA
T117,T116,Chez Reavie,9,244,228,16,2012,total_driving,NA
119,T116,Matt Kuchar,4,245,238,7,2012,total_driving,NA
T120,223,Paul Casey,4,247,160,87,2012,total_driving,NA
T120,T116,Satoshi Kodaira,6,247,234,13,2012,total_driving,NA
T120,T127,Shawn Stefani,6,247,73,174,2012,total_driving,NA
123,106,Carlos Ortiz,8,248,67,181,2012,total_driving,NA
124,T122,Ben Crane,6,249,207,42,2012,total_driving,NA
125,T130,Tom Lewis,3,252,5,247,2012,total_driving,NA
126,T139,Michael Gligic,9,253,73,180,2012,total_driving,NA
T127,T139,Scott Stallings,8,254,47,207,2012,total_driving,NA
T127,T137,Kyle Stanley,8,254,213,41,2012,total_driving,NA
T129,T137,Henrik Stenson,2,255,202,53,2012,total_driving,NA
T129,T125,Austin Cook,8,255,127,128,2012,total_driving,NA
T131,T120,Beau Hossler,8,256,29,227,2012,total_driving,NA
T131,T122,Patrick Rodgers,10,256,26,230,2012,total_driving,NA
T131,T143,Sebastian Cappelen,8,256,30,226,2012,total_driving,NA
T131,T133,Kurt Kitayama,2,256,3,253,2012,total_driving,NA
T131,T77,Vincent Whaley,7,256,103,153,2012,total_driving,NA
T131,T141,Ryan Brehm,10,256,6,250,2012,total_driving,NA
137,T122,Mark Hubbard,10,257,149,108,2012,total_driving,NA
T138,T163,Brandon Hagy,8,258,22,236,2012,total_driving,NA
T138,T109,Billy Horschel,6,258,196,62,2012,total_driving,NA
T140,T147,Sam Burns,6,259,20,239,2012,total_driving,NA
T140,T133,David Lingmerth,5,259,230,29,2012,total_driving,NA
T142,T187,Bud Cauley,6,262,125,137,2012,total_driving,NA
T142,T143,Cameron Tringale,7,262,55,207,2012,total_driving,NA
144,T143,Rikuya Hoshino,2,264,138,126,2012,total_driving,NA
145,T155,Jonathan Byrd,5,265,72,193,2012,total_driving,NA
T146,T116,Maverick McNealy,9,266,89,177,2012,total_driving,NA
T146,T147,Xander Schauffele,3,266,231,35,2012,total_driving,NA
T148,154,Whee Kim,2,267,180,87,2012,total_driving,NA
T148,T141,Lucas Bjerregaard,3,267,18,249,2012,total_driving,NA
150,T152,Chip McDaniel,2,268,59,209,2012,total_driving,NA
T151,T178,Max Homa,6,269,187,82,2012,total_driving,NA
T151,T112,Bill Haas,6,269,147,122,2012,total_driving,NA
T151,146,J.B. Holmes,3,269,224,45,2012,total_driving,NA
T154,129,Zack Sucher,6,270,24,246,2012,total_driving,NA
T154,T157,Roberto Castro,5,270,183,87,2012,total_driving,NA
156,151,Kevin Tway,6,271,27,244,2012,total_driving,NA
T157,T155,Kevin Chappell,6,272,43,229,2012,total_driving,NA
T157,T152,Dominic Bozzelli,7,272,38,234,2012,total_driving,NA
T159,T147,David Hearn,9,273,206,67,2012,total_driving,NA
T159,174,Jimmy Walker,4,273,92,181,2012,total_driving,NA
161,165,Sangmoon Bae,6,274,64,210,2012,total_driving,NA
162,167,Michael Gellerman,8,275,135,140,2012,total_driving,NA
163,T159,Kevin Kisner,7,277,227,50,2012,total_driving,NA
T164,T159,Justin Thomas,5,278,161,117,2012,total_driving,NA
T164,T187,Troy Merritt,7,278,182,96,2012,total_driving,NA
T164,T163,Freddie Jacobson,3,278,141,137,2012,total_driving,NA
167,T175,Talor Gooch,8,280,122,158,2012,total_driving,NA
168,T103,Andrew Putnam,6,283,181,102,2012,total_driving,NA
T169,T157,Si Woo Kim,8,284,99,185,2012,total_driving,NA
T169,T97,Charley Hoffman,7,284,87,197,2012,total_driving,NA
T169,169,Seamus Power,5,284,83,201,2012,total_driving,NA
172,T133,John Huh,5,285,166,119,2012,total_driving,NA
T173,T172,Jason Day,3,286,80,206,2012,total_driving,NA
T173,T172,Chris Kirk,3,286,199,87,2012,total_driving,NA
T173,T175,Rafael Campos,9,286,67,219,2012,total_driving,NA
176,T159,Nate Lashley,8,287,204,83,2012,total_driving,NA
177,177,Brandt Snedeker,4,288,155,133,2012,total_driving,NA
178,T178,Peter Uihlein,6,289,38,251,2012,total_driving,NA
179,150,Kevin Na,7,290,203,87,2012,total_driving,NA
180,T170,Ben Taylor,10,291,134,157,2012,total_driving,NA
181,162,Anirban Lahiri,8,292,118,174,2012,total_driving,NA
182,T208,Roger Sloan,8,293,158,135,2012,total_driving,NA
T183,182,Johnson Wagner,5,294,207,87,2012,total_driving,NA
T183,T183,Robert Garrigus,5,294,52,242,2012,total_driving,NA
T183,T187,Wes Roach,7,294,151,143,2012,total_driving,NA
186,181,Zach Johnson,7,299,216,83,2012,total_driving,NA
187,191,Mikumu Horikawa,3,303,237,66,2012,total_driving,NA
T188,194,Will Gordon,4,304,64,240,2012,total_driving,NA
T188,210,Rory Sabbatini,7,304,219,85,2012,total_driving,NA
T188,T183,Dylan Frittelli,9,304,193,111,2012,total_driving,NA
191,185,Nelson Ledesma,10,305,57,248,2012,total_driving,NA
192,192,Marc Leishman,5,306,90,216,2012,total_driving,NA
193,166,Joseph Bramlett,7,307,94,213,2012,total_driving,NA
194,195,Joaquin Niemann,8,308,164,144,2012,total_driving,NA
T195,T196,Graeme McDowell,5,311,236,75,2012,total_driving,NA
T195,T201,Bronson Burgoon,8,311,130,181,2012,total_driving,NA
197,T187,Brian Gay,9,312,162,150,2012,total_driving,NA
198,193,Rhein Gibson,9,313,90,223,2012,total_driving,NA
199,T196,Tom Hoge,8,314,185,129,2012,total_driving,NA
200,200,Mark Anderson,7,319,132,187,2012,total_driving,NA
201,204,Smylie Kaufman,3,320,64,256,2012,total_driving,NA
T202,199,Zac Blair,10,322,225,97,2012,total_driving,NA
T202,214,Francesco Molinari,3,322,125,197,2012,total_driving,NA
T204,T170,John Senden,5,324,120,204,2012,total_driving,NA
T204,180,Ben Martin,6,324,223,101,2012,total_driving,NA
T206,T205,James Hahn,6,325,163,162,2012,total_driving,NA
T206,186,Aaron Baddeley,6,325,198,127,2012,total_driving,NA
208,T211,J.J. Spaun,9,330,118,212,2012,total_driving,NA
T209,203,Robert Streb,9,332,141,191,2012,total_driving,NA
T209,T208,Robert Allenby,3,332,164,168,2012,total_driving,NA
211,T211,Martin Trainer,8,339,94,245,2012,total_driving,NA
212,T205,"Ted Potter, Jr.",7,340,151,189,2012,total_driving,NA
213,T201,Chris Stroud,6,341,194,147,2012,total_driving,NA
T214,T205,Rob Oppenheim,10,342,200,142,2012,total_driving,NA
T214,198,Matt Every,7,342,122,220,2012,total_driving,NA
T214,213,Morgan Hoffmann,4,342,143,199,2012,total_driving,NA
217,215,Roberto Díaz,2,345,110,235,2012,total_driving,NA
218,216,Stewart Cink,4,350,112,238,2012,total_driving,NA
219,217,C.T. Pan,5,353,189,164,2012,total_driving,NA
220,T218,Patton Kizzire,9,354,158,196,2012,total_driving,NA
221,222,Hudson Swafford,4,356,183,173,2012,total_driving,NA
222,T218,George McNeill,6,359,145,214,2012,total_driving,NA
223,220,Patrick Reed,4,363,239,124,2012,total_driving,NA
224,221,Jamie Lovemark,4,365,114,251,2012,total_driving,NA
225,224,Luke Donald,2,378,232,146,2012,total_driving,NA
226,226,Bo Van Pelt,7,387,155,232,2012,total_driving,NA
227,225,Davis Love III,3,400,172,228,2012,total_driving,NA
228,228,Arjun Atwal,5,404,173,231,2012,total_driving,NA
T229,231,Daniel Chopra,3,411,157,254,2012,total_driving,NA
T229,227,Kevin Stadler,6,411,217,194,2012,total_driving,NA
231,229,John Rollins,4,414,209,205,2012,total_driving,NA
232,230,Parker McLachlin,4,421,201,220,2012,total_driving,NA
233,232,Peter Malnati,9,422,197,225,2012,total_driving,NA
234,233,Michael Kim,8,435,211,224,2012,total_driving,NA
235,235,Tommy Gainey,4,442,209,233,2012,total_driving,NA
236,234,D.A. Points,4,446,226,220,2012,total_driving,NA
237,236,Ricky Barnes,6,451,214,237,2012,total_driving,NA
238,237,Brendon de Jonge,3,462,205,257,2012,total_driving,NA
239,238,Shugo Imahira,2,490,235,255,2012,total_driving,NA
1,1,Andrew Novak,2,35,17,18,2013,total_driving,NA
2,3,Viktor Hovland,4,63,16,47,2013,total_driving,NA
3,4,Chase Koepka,2,72,34,38,2013,total_driving,NA
4,5,John Oda,2,74,70,4,2013,total_driving,NA
5,6,D.J. Trahan,7,91,47,44,2013,total_driving,NA
6,8,Gary Woodland,4,98,94,4,2013,total_driving,NA
7,9,Branden Grace,4,99,21,78,2013,total_driving,NA
T8,10,Patrick Cantlay,3,103,86,17,2013,total_driving,NA
T8,7,Doc Redman,10,103,77,26,2013,total_driving,NA
10,2,Ryan Moore,5,105,94,11,2013,total_driving,NA
11,13,Scottie Scheffler,8,126,15,111,2013,total_driving,NA
12,T19,Kyoung-Hoon Lee,10,128,106,22,2013,total_driving,NA
13,14,Martin Laird,8,129,42,87,2013,total_driving,NA
14,11,Kevin Streelman,9,130,62,68,2013,total_driving,NA
15,25,Jhonattan Vegas,6,132,24,108,2013,total_driving,NA
T16,15,Nick Taylor,8,133,109,24,2013,total_driving,NA
T16,T23,Brendan Steele,8,133,63,70,2013,total_driving,NA
18,12,Harris English,7,135,36,99,2013,total_driving,NA
T19,T27,Harry Higgs,10,140,79,61,2013,total_driving,NA
T19,T27,Sung Kang,7,140,53,87,2013,total_driving,NA
T21,22,Emiliano Grillo,7,142,110,32,2013,total_driving,NA
T21,18,Bubba Watson,4,142,1,141,2013,total_driving,NA
23,T19,Bryson DeChambeau,3,144,13,131,2013,total_driving,NA
24,T52,Matthew Wolff,5,145,40,105,2013,total_driving,NA
25,29,Joel Dahmen,8,149,100,49,2013,total_driving,NA
26,16,Jason Kokrak,5,153,8,145,2013,total_driving,NA
27,17,Josh Teater,6,156,83,73,2013,total_driving,NA
28,T23,Cameron Champ,7,157,2,155,2013,total_driving,NA
29,33,Ryan Palmer,5,160,146,14,2013,total_driving,NA
30,T35,Adam Hadwin,5,164,121,43,2013,total_driving,NA
31,26,Sungjae Im,8,165,50,115,2013,total_driving,NA
32,31,Henrik Norlander,10,168,132,36,2013,total_driving,NA
T33,38,Boo Weekley,5,169,147,22,2013,total_driving,NA
T33,T35,Harold Varner III,7,169,18,151,2013,total_driving,NA
35,37,Lanto Griffin,10,170,40,130,2013,total_driving,NA
36,T19,Lucas Glover,7,174,98,76,2013,total_driving,NA
37,34,Scott Brown,9,175,151,24,2013,total_driving,NA
38,T44,Sebastián Muñoz,10,176,60,116,2013,total_driving,NA
T39,40,Daniel Berger,6,177,56,121,2013,total_driving,NA
T39,42,Keegan Bradley,7,177,71,106,2013,total_driving,NA
41,39,Chesson Hadley,7,179,106,73,2013,total_driving,NA
42,43,Webb Simpson,3,182,170,12,2013,total_driving,NA
43,48,Danny Lee,7,185,9,176,2013,total_driving,NA
44,T50,Pat Perez,6,186,130,56,2013,total_driving,NA
45,T52,Matthew NeSmith,9,188,154,34,2013,total_driving,NA
46,T99,Sepp Straka,10,191,92,99,2013,total_driving,NA
T47,T90,Isaiah Salinda,3,192,14,178,2013,total_driving,NA
T47,T56,John Merrick,4,192,135,57,2013,total_driving,NA
T49,T50,Jim Furyk,3,193,192,1,2013,total_driving,NA
T49,55,Chad Campbell,4,193,178,15,2013,total_driving,NA
T49,T44,Wyndham Clark,7,193,32,161,2013,total_driving,NA
52,32,Alex Noren,4,195,108,87,2013,total_driving,NA
53,NA,Rickie Fowler,2,196,194,2,2013,total_driving,NA
T54,T56,Tony Finau,5,198,12,186,2013,total_driving,NA
T54,T62,Phil Mickelson,5,198,31,167,2013,total_driving,NA
T54,T62,Aaron Wise,7,198,51,147,2013,total_driving,NA
T54,T69,Chase Seiffert,9,198,127,71,2013,total_driving,NA
T58,T73,Abraham Ancer,8,199,113,86,2013,total_driving,NA
T58,61,Adam Schenk,10,199,33,166,2013,total_driving,NA
T58,T64,Scott Harrington,9,199,34,165,2013,total_driving,NA
T61,T52,Brian Harman,8,200,143,57,2013,total_driving,NA
T61,47,Jason Dufner,7,200,140,60,2013,total_driving,NA
T61,59,Cameron Smith,6,200,77,123,2013,total_driving,NA
T64,46,Kramer Hickok,9,201,124,77,2013,total_driving,NA
T64,60,Matt Jones,8,201,49,152,2013,total_driving,NA
66,30,Robby Shelton,10,202,88,114,2013,total_driving,NA
T67,83,Grayson Murray,6,203,4,199,2013,total_driving,NA
T67,T73,Russell Knox,8,203,138,65,2013,total_driving,NA
69,41,Denny McCarthy,8,204,101,103,2013,total_driving,NA
70,T80,Sam Ryder,10,209,53,156,2013,total_driving,NA
71,58,Brice Garnett,8,214,150,64,2013,total_driving,NA
72,66,Michael Thompson,7,215,175,40,2013,total_driving,NA
73,76,Collin Morikawa,6,216,168,48,2013,total_driving,NA
T74,T69,Derek Ernst,4,217,80,137,2013,total_driving,NA
T74,T67,Adam Long,10,217,189,28,2013,total_driving,NA
T74,96,Andrew Landry,9,217,171,46,2013,total_driving,NA
77,T84,Akshay Bhatia,5,218,7,211,2013,total_driving,NA
78,T69,Rod Pampling,3,220,28,192,2013,total_driving,NA
79,136,Nick Watney,7,222,73,149,2013,total_driving,NA
T80,T84,Hideki Matsuyama,6,223,115,108,2013,total_driving,NA
T80,115,Doug Ghim,7,223,116,107,2013,total_driving,NA
T80,T90,Kristoffer Ventura,9,223,44,179,2013,total_driving,NA
T83,T73,Byeong Hun An,8,225,10,215,2013,total_driving,NA
T83,T90,Chandler Phillips,2,225,57,168,2013,total_driving,NA
T83,T69,Brian Stuard,10,225,215,10,2013,total_driving,NA
T83,T97,Alex Cejka,5,225,175,50,2013,total_driving,NA
T83,T80,Ryan Armour,9,225,217,8,2013,total_driving,NA
T88,T90,Graham DeLaet,5,226,36,190,2013,total_driving,NA
T88,T77,Tim Wilkinson,6,226,189,37,2013,total_driving,NA
T88,T86,Brandon Wu,2,226,188,38,2013,total_driving,NA
T91,T88,Hank Lebioda,9,228,104,124,2013,total_driving,NA
T91,79,Charles Howell III,9,228,69,159,2013,total_driving,NA
93,T67,Tyler McCumber,9,229,11,218,2013,total_driving,NA
94,T90,Fabián Gómez,9,230,167,63,2013,total_driving,NA
95,T90,Brendon Todd,11,231,228,3,2013,total_driving,NA
T96,49,Cameron Percy,8,233,61,172,2013,total_driving,NA
T96,T99,Adam Scott,4,233,46,187,2013,total_driving,NA
T96,T80,Luke List,9,233,80,153,2013,total_driving,NA
T96,T86,Russell Henley,8,233,179,54,2013,total_driving,NA
T96,T130,Mackenzie Hughes,8,233,101,132,2013,total_driving,NA
101,T109,J.T. Poston,9,234,175,59,2013,total_driving,NA
102,T64,Vince Covello,8,235,73,162,2013,total_driving,NA
103,T99,Xinjun Zhang,10,236,116,120,2013,total_driving,NA
104,105,K.J. Choi,3,237,233,4,2013,total_driving,NA
T105,107,Tim Herron,4,238,220,18,2013,total_driving,NA
T105,T109,Corey Conners,7,238,186,52,2013,total_driving,NA
T107,108,Keith Mitchell,7,239,135,104,2013,total_driving,NA
T107,T130,Cameron Davis,8,239,22,217,2013,total_driving,NA
T107,T99,Richy Werenski,4,239,45,194,2013,total_driving,NA
T107,T88,Vaughn Taylor,8,239,212,27,2013,total_driving,NA
111,168,Chris Baker,9,240,168,72,2013,total_driving,NA
T112,T112,Jim Herman,8,241,221,20,2013,total_driving,NA
T112,T127,Scott Piercy,8,241,105,136,2013,total_driving,NA
T114,T120,J.J. Henry,5,242,173,69,2013,total_driving,NA
T114,T103,Tyler Duncan,10,242,221,21,2013,total_driving,NA
116,T112,Davis Riley,2,243,83,160,2013,total_driving,NA
T117,T125,Bo Hoag,10,244,127,117,2013,total_driving,NA
T117,T116,Chez Reavie,9,244,228,16,2013,total_driving,NA
119,T116,Matt Kuchar,4,245,238,7,2013,total_driving,NA
T120,223,Paul Casey,4,247,160,87,2013,total_driving,NA
T120,T116,Satoshi Kodaira,6,247,234,13,2013,total_driving,NA
T120,T127,Shawn Stefani,6,247,73,174,2013,total_driving,NA
123,106,Carlos Ortiz,8,248,67,181,2013,total_driving,NA
124,T122,Ben Crane,6,249,207,42,2013,total_driving,NA
125,T130,Tom Lewis,3,252,5,247,2013,total_driving,NA
126,T139,Michael Gligic,9,253,73,180,2013,total_driving,NA
T127,T139,Scott Stallings,8,254,47,207,2013,total_driving,NA
T127,T137,Kyle Stanley,8,254,213,41,2013,total_driving,NA
T129,T137,Henrik Stenson,2,255,202,53,2013,total_driving,NA
T129,T125,Austin Cook,8,255,127,128,2013,total_driving,NA
T131,T120,Beau Hossler,8,256,29,227,2013,total_driving,NA
T131,T122,Patrick Rodgers,10,256,26,230,2013,total_driving,NA
T131,T143,Sebastian Cappelen,8,256,30,226,2013,total_driving,NA
T131,T133,Kurt Kitayama,2,256,3,253,2013,total_driving,NA
T131,T77,Vincent Whaley,7,256,103,153,2013,total_driving,NA
T131,T141,Ryan Brehm,10,256,6,250,2013,total_driving,NA
137,T122,Mark Hubbard,10,257,149,108,2013,total_driving,NA
T138,T163,Brandon Hagy,8,258,22,236,2013,total_driving,NA
T138,T109,Billy Horschel,6,258,196,62,2013,total_driving,NA
T140,T147,Sam Burns,6,259,20,239,2013,total_driving,NA
T140,T133,David Lingmerth,5,259,230,29,2013,total_driving,NA
T142,T187,Bud Cauley,6,262,125,137,2013,total_driving,NA
T142,T143,Cameron Tringale,7,262,55,207,2013,total_driving,NA
144,T143,Rikuya Hoshino,2,264,138,126,2013,total_driving,NA
145,T155,Jonathan Byrd,5,265,72,193,2013,total_driving,NA
T146,T116,Maverick McNealy,9,266,89,177,2013,total_driving,NA
T146,T147,Xander Schauffele,3,266,231,35,2013,total_driving,NA
T148,154,Whee Kim,2,267,180,87,2013,total_driving,NA
T148,T141,Lucas Bjerregaard,3,267,18,249,2013,total_driving,NA
150,T152,Chip McDaniel,2,268,59,209,2013,total_driving,NA
T151,T178,Max Homa,6,269,187,82,2013,total_driving,NA
T151,T112,Bill Haas,6,269,147,122,2013,total_driving,NA
T151,146,J.B. Holmes,3,269,224,45,2013,total_driving,NA
T154,129,Zack Sucher,6,270,24,246,2013,total_driving,NA
T154,T157,Roberto Castro,5,270,183,87,2013,total_driving,NA
156,151,Kevin Tway,6,271,27,244,2013,total_driving,NA
T157,T155,Kevin Chappell,6,272,43,229,2013,total_driving,NA
T157,T152,Dominic Bozzelli,7,272,38,234,2013,total_driving,NA
T159,T147,David Hearn,9,273,206,67,2013,total_driving,NA
T159,174,Jimmy Walker,4,273,92,181,2013,total_driving,NA
161,165,Sangmoon Bae,6,274,64,210,2013,total_driving,NA
162,167,Michael Gellerman,8,275,135,140,2013,total_driving,NA
163,T159,Kevin Kisner,7,277,227,50,2013,total_driving,NA
T164,T159,Justin Thomas,5,278,161,117,2013,total_driving,NA
T164,T187,Troy Merritt,7,278,182,96,2013,total_driving,NA
T164,T163,Freddie Jacobson,3,278,141,137,2013,total_driving,NA
167,T175,Talor Gooch,8,280,122,158,2013,total_driving,NA
168,T103,Andrew Putnam,6,283,181,102,2013,total_driving,NA
T169,T157,Si Woo Kim,8,284,99,185,2013,total_driving,NA
T169,T97,Charley Hoffman,7,284,87,197,2013,total_driving,NA
T169,169,Seamus Power,5,284,83,201,2013,total_driving,NA
172,T133,John Huh,5,285,166,119,2013,total_driving,NA
T173,T172,Jason Day,3,286,80,206,2013,total_driving,NA
T173,T172,Chris Kirk,3,286,199,87,2013,total_driving,NA
T173,T175,Rafael Campos,9,286,67,219,2013,total_driving,NA
176,T159,Nate Lashley,8,287,204,83,2013,total_driving,NA
177,177,Brandt Snedeker,4,288,155,133,2013,total_driving,NA
178,T178,Peter Uihlein,6,289,38,251,2013,total_driving,NA
179,150,Kevin Na,7,290,203,87,2013,total_driving,NA
180,T170,Ben Taylor,10,291,134,157,2013,total_driving,NA
181,162,Anirban Lahiri,8,292,118,174,2013,total_driving,NA
182,T208,Roger Sloan,8,293,158,135,2013,total_driving,NA
T183,182,Johnson Wagner,5,294,207,87,2013,total_driving,NA
T183,T183,Robert Garrigus,5,294,52,242,2013,total_driving,NA
T183,T187,Wes Roach,7,294,151,143,2013,total_driving,NA
186,181,Zach Johnson,7,299,216,83,2013,total_driving,NA
187,191,Mikumu Horikawa,3,303,237,66,2013,total_driving,NA
T188,194,Will Gordon,4,304,64,240,2013,total_driving,NA
T188,210,Rory Sabbatini,7,304,219,85,2013,total_driving,NA
T188,T183,Dylan Frittelli,9,304,193,111,2013,total_driving,NA
191,185,Nelson Ledesma,10,305,57,248,2013,total_driving,NA
192,192,Marc Leishman,5,306,90,216,2013,total_driving,NA
193,166,Joseph Bramlett,7,307,94,213,2013,total_driving,NA
194,195,Joaquin Niemann,8,308,164,144,2013,total_driving,NA
T195,T196,Graeme McDowell,5,311,236,75,2013,total_driving,NA
T195,T201,Bronson Burgoon,8,311,130,181,2013,total_driving,NA
197,T187,Brian Gay,9,312,162,150,2013,total_driving,NA
198,193,Rhein Gibson,9,313,90,223,2013,total_driving,NA
199,T196,Tom Hoge,8,314,185,129,2013,total_driving,NA
200,200,Mark Anderson,7,319,132,187,2013,total_driving,NA
201,204,Smylie Kaufman,3,320,64,256,2013,total_driving,NA
T202,199,Zac Blair,10,322,225,97,2013,total_driving,NA
T202,214,Francesco Molinari,3,322,125,197,2013,total_driving,NA
T204,T170,John Senden,5,324,120,204,2013,total_driving,NA
T204,180,Ben Martin,6,324,223,101,2013,total_driving,NA
T206,T205,James Hahn,6,325,163,162,2013,total_driving,NA
T206,186,Aaron Baddeley,6,325,198,127,2013,total_driving,NA
208,T211,J.J. Spaun,9,330,118,212,2013,total_driving,NA
T209,203,Robert Streb,9,332,141,191,2013,total_driving,NA
T209,T208,Robert Allenby,3,332,164,168,2013,total_driving,NA
211,T211,Martin Trainer,8,339,94,245,2013,total_driving,NA
212,T205,"Ted Potter, Jr.",7,340,151,189,2013,total_driving,NA
213,T201,Chris Stroud,6,341,194,147,2013,total_driving,NA
T214,T205,Rob Oppenheim,10,342,200,142,2013,total_driving,NA
T214,198,Matt Every,7,342,122,220,2013,total_driving,NA
T214,213,Morgan Hoffmann,4,342,143,199,2013,total_driving,NA
217,215,Roberto Díaz,2,345,110,235,2013,total_driving,NA
218,216,Stewart Cink,4,350,112,238,2013,total_driving,NA
219,217,C.T. Pan,5,353,189,164,2013,total_driving,NA
220,T218,Patton Kizzire,9,354,158,196,2013,total_driving,NA
221,222,Hudson Swafford,4,356,183,173,2013,total_driving,NA
222,T218,George McNeill,6,359,145,214,2013,total_driving,NA
223,220,Patrick Reed,4,363,239,124,2013,total_driving,NA
224,221,Jamie Lovemark,4,365,114,251,2013,total_driving,NA
225,224,Luke Donald,2,378,232,146,2013,total_driving,NA
226,226,Bo Van Pelt,7,387,155,232,2013,total_driving,NA
227,225,Davis Love III,3,400,172,228,2013,total_driving,NA
228,228,Arjun Atwal,5,404,173,231,2013,total_driving,NA
T229,231,Daniel Chopra,3,411,157,254,2013,total_driving,NA
T229,227,Kevin Stadler,6,411,217,194,2013,total_driving,NA
231,229,John Rollins,4,414,209,205,2013,total_driving,NA
232,230,Parker McLachlin,4,421,201,220,2013,total_driving,NA
233,232,Peter Malnati,9,422,197,225,2013,total_driving,NA
234,233,Michael Kim,8,435,211,224,2013,total_driving,NA
235,235,Tommy Gainey,4,442,209,233,2013,total_driving,NA
236,234,D.A. Points,4,446,226,220,2013,total_driving,NA
237,236,Ricky Barnes,6,451,214,237,2013,total_driving,NA
238,237,Brendon de Jonge,3,462,205,257,2013,total_driving,NA
239,238,Shugo Imahira,2,490,235,255,2013,total_driving,NA
1,1,Andrew Novak,2,35,17,18,2014,total_driving,NA
2,3,Viktor Hovland,4,63,16,47,2014,total_driving,NA
3,4,Chase Koepka,2,72,34,38,2014,total_driving,NA
4,5,John Oda,2,74,70,4,2014,total_driving,NA
5,6,D.J. Trahan,7,91,47,44,2014,total_driving,NA
6,8,Gary Woodland,4,98,94,4,2014,total_driving,NA
7,9,Branden Grace,4,99,21,78,2014,total_driving,NA
T8,10,Patrick Cantlay,3,103,86,17,2014,total_driving,NA
T8,7,Doc Redman,10,103,77,26,2014,total_driving,NA
10,2,Ryan Moore,5,105,94,11,2014,total_driving,NA
11,13,Scottie Scheffler,8,126,15,111,2014,total_driving,NA
12,T19,Kyoung-Hoon Lee,10,128,106,22,2014,total_driving,NA
13,14,Martin Laird,8,129,42,87,2014,total_driving,NA
14,11,Kevin Streelman,9,130,62,68,2014,total_driving,NA
15,25,Jhonattan Vegas,6,132,24,108,2014,total_driving,NA
T16,15,Nick Taylor,8,133,109,24,2014,total_driving,NA
T16,T23,Brendan Steele,8,133,63,70,2014,total_driving,NA
18,12,Harris English,7,135,36,99,2014,total_driving,NA
T19,T27,Harry Higgs,10,140,79,61,2014,total_driving,NA
T19,T27,Sung Kang,7,140,53,87,2014,total_driving,NA
T21,22,Emiliano Grillo,7,142,110,32,2014,total_driving,NA
T21,18,Bubba Watson,4,142,1,141,2014,total_driving,NA
23,T19,Bryson DeChambeau,3,144,13,131,2014,total_driving,NA
24,T52,Matthew Wolff,5,145,40,105,2014,total_driving,NA
25,29,Joel Dahmen,8,149,100,49,2014,total_driving,NA
26,16,Jason Kokrak,5,153,8,145,2014,total_driving,NA
27,17,Josh Teater,6,156,83,73,2014,total_driving,NA
28,T23,Cameron Champ,7,157,2,155,2014,total_driving,NA
29,33,Ryan Palmer,5,160,146,14,2014,total_driving,NA
30,T35,Adam Hadwin,5,164,121,43,2014,total_driving,NA
31,26,Sungjae Im,8,165,50,115,2014,total_driving,NA
32,31,Henrik Norlander,10,168,132,36,2014,total_driving,NA
T33,38,Boo Weekley,5,169,147,22,2014,total_driving,NA
T33,T35,Harold Varner III,7,169,18,151,2014,total_driving,NA
35,37,Lanto Griffin,10,170,40,130,2014,total_driving,NA
36,T19,Lucas Glover,7,174,98,76,2014,total_driving,NA
37,34,Scott Brown,9,175,151,24,2014,total_driving,NA
38,T44,Sebastián Muñoz,10,176,60,116,2014,total_driving,NA
T39,40,Daniel Berger,6,177,56,121,2014,total_driving,NA
T39,42,Keegan Bradley,7,177,71,106,2014,total_driving,NA
41,39,Chesson Hadley,7,179,106,73,2014,total_driving,NA
42,43,Webb Simpson,3,182,170,12,2014,total_driving,NA
43,48,Danny Lee,7,185,9,176,2014,total_driving,NA
44,T50,Pat Perez,6,186,130,56,2014,total_driving,NA
45,T52,Matthew NeSmith,9,188,154,34,2014,total_driving,NA
46,T99,Sepp Straka,10,191,92,99,2014,total_driving,NA
T47,T90,Isaiah Salinda,3,192,14,178,2014,total_driving,NA
T47,T56,John Merrick,4,192,135,57,2014,total_driving,NA
T49,T50,Jim Furyk,3,193,192,1,2014,total_driving,NA
T49,55,Chad Campbell,4,193,178,15,2014,total_driving,NA
T49,T44,Wyndham Clark,7,193,32,161,2014,total_driving,NA
52,32,Alex Noren,4,195,108,87,2014,total_driving,NA
53,NA,Rickie Fowler,2,196,194,2,2014,total_driving,NA
T54,T56,Tony Finau,5,198,12,186,2014,total_driving,NA
T54,T62,Phil Mickelson,5,198,31,167,2014,total_driving,NA
T54,T62,Aaron Wise,7,198,51,147,2014,total_driving,NA
T54,T69,Chase Seiffert,9,198,127,71,2014,total_driving,NA
T58,T73,Abraham Ancer,8,199,113,86,2014,total_driving,NA
T58,61,Adam Schenk,10,199,33,166,2014,total_driving,NA
T58,T64,Scott Harrington,9,199,34,165,2014,total_driving,NA
T61,T52,Brian Harman,8,200,143,57,2014,total_driving,NA
T61,47,Jason Dufner,7,200,140,60,2014,total_driving,NA
T61,59,Cameron Smith,6,200,77,123,2014,total_driving,NA
T64,46,Kramer Hickok,9,201,124,77,2014,total_driving,NA
T64,60,Matt Jones,8,201,49,152,2014,total_driving,NA
66,30,Robby Shelton,10,202,88,114,2014,total_driving,NA
T67,83,Grayson Murray,6,203,4,199,2014,total_driving,NA
T67,T73,Russell Knox,8,203,138,65,2014,total_driving,NA
69,41,Denny McCarthy,8,204,101,103,2014,total_driving,NA
70,T80,Sam Ryder,10,209,53,156,2014,total_driving,NA
71,58,Brice Garnett,8,214,150,64,2014,total_driving,NA
72,66,Michael Thompson,7,215,175,40,2014,total_driving,NA
73,76,Collin Morikawa,6,216,168,48,2014,total_driving,NA
T74,T69,Derek Ernst,4,217,80,137,2014,total_driving,NA
T74,T67,Adam Long,10,217,189,28,2014,total_driving,NA
T74,96,Andrew Landry,9,217,171,46,2014,total_driving,NA
77,T84,Akshay Bhatia,5,218,7,211,2014,total_driving,NA
78,T69,Rod Pampling,3,220,28,192,2014,total_driving,NA
79,136,Nick Watney,7,222,73,149,2014,total_driving,NA
T80,T84,Hideki Matsuyama,6,223,115,108,2014,total_driving,NA
T80,115,Doug Ghim,7,223,116,107,2014,total_driving,NA
T80,T90,Kristoffer Ventura,9,223,44,179,2014,total_driving,NA
T83,T73,Byeong Hun An,8,225,10,215,2014,total_driving,NA
T83,T90,Chandler Phillips,2,225,57,168,2014,total_driving,NA
T83,T69,Brian Stuard,10,225,215,10,2014,total_driving,NA
T83,T97,Alex Cejka,5,225,175,50,2014,total_driving,NA
T83,T80,Ryan Armour,9,225,217,8,2014,total_driving,NA
T88,T90,Graham DeLaet,5,226,36,190,2014,total_driving,NA
T88,T77,Tim Wilkinson,6,226,189,37,2014,total_driving,NA
T88,T86,Brandon Wu,2,226,188,38,2014,total_driving,NA
T91,T88,Hank Lebioda,9,228,104,124,2014,total_driving,NA
T91,79,Charles Howell III,9,228,69,159,2014,total_driving,NA
93,T67,Tyler McCumber,9,229,11,218,2014,total_driving,NA
94,T90,Fabián Gómez,9,230,167,63,2014,total_driving,NA
95,T90,Brendon Todd,11,231,228,3,2014,total_driving,NA
T96,49,Cameron Percy,8,233,61,172,2014,total_driving,NA
T96,T99,Adam Scott,4,233,46,187,2014,total_driving,NA
T96,T80,Luke List,9,233,80,153,2014,total_driving,NA
T96,T86,Russell Henley,8,233,179,54,2014,total_driving,NA
T96,T130,Mackenzie Hughes,8,233,101,132,2014,total_driving,NA
101,T109,J.T. Poston,9,234,175,59,2014,total_driving,NA
102,T64,Vince Covello,8,235,73,162,2014,total_driving,NA
103,T99,Xinjun Zhang,10,236,116,120,2014,total_driving,NA
104,105,K.J. Choi,3,237,233,4,2014,total_driving,NA
T105,107,Tim Herron,4,238,220,18,2014,total_driving,NA
T105,T109,Corey Conners,7,238,186,52,2014,total_driving,NA
T107,108,Keith Mitchell,7,239,135,104,2014,total_driving,NA
T107,T130,Cameron Davis,8,239,22,217,2014,total_driving,NA
T107,T99,Richy Werenski,4,239,45,194,2014,total_driving,NA
T107,T88,Vaughn Taylor,8,239,212,27,2014,total_driving,NA
111,168,Chris Baker,9,240,168,72,2014,total_driving,NA
T112,T112,Jim Herman,8,241,221,20,2014,total_driving,NA
T112,T127,Scott Piercy,8,241,105,136,2014,total_driving,NA
T114,T120,J.J. Henry,5,242,173,69,2014,total_driving,NA
T114,T103,Tyler Duncan,10,242,221,21,2014,total_driving,NA
116,T112,Davis Riley,2,243,83,160,2014,total_driving,NA
T117,T125,Bo Hoag,10,244,127,117,2014,total_driving,NA
T117,T116,Chez Reavie,9,244,228,16,2014,total_driving,NA
119,T116,Matt Kuchar,4,245,238,7,2014,total_driving,NA
T120,223,Paul Casey,4,247,160,87,2014,total_driving,NA
T120,T116,Satoshi Kodaira,6,247,234,13,2014,total_driving,NA
T120,T127,Shawn Stefani,6,247,73,174,2014,total_driving,NA
123,106,Carlos Ortiz,8,248,67,181,2014,total_driving,NA
124,T122,Ben Crane,6,249,207,42,2014,total_driving,NA
125,T130,Tom Lewis,3,252,5,247,2014,total_driving,NA
126,T139,Michael Gligic,9,253,73,180,2014,total_driving,NA
T127,T139,Scott Stallings,8,254,47,207,2014,total_driving,NA
T127,T137,Kyle Stanley,8,254,213,41,2014,total_driving,NA
T129,T137,Henrik Stenson,2,255,202,53,2014,total_driving,NA
T129,T125,Austin Cook,8,255,127,128,2014,total_driving,NA
T131,T120,Beau Hossler,8,256,29,227,2014,total_driving,NA
T131,T122,Patrick Rodgers,10,256,26,230,2014,total_driving,NA
T131,T143,Sebastian Cappelen,8,256,30,226,2014,total_driving,NA
T131,T133,Kurt Kitayama,2,256,3,253,2014,total_driving,NA
T131,T77,Vincent Whaley,7,256,103,153,2014,total_driving,NA
T131,T141,Ryan Brehm,10,256,6,250,2014,total_driving,NA
137,T122,Mark Hubbard,10,257,149,108,2014,total_driving,NA
T138,T163,Brandon Hagy,8,258,22,236,2014,total_driving,NA
T138,T109,Billy Horschel,6,258,196,62,2014,total_driving,NA
T140,T147,Sam Burns,6,259,20,239,2014,total_driving,NA
T140,T133,David Lingmerth,5,259,230,29,2014,total_driving,NA
T142,T187,Bud Cauley,6,262,125,137,2014,total_driving,NA
T142,T143,Cameron Tringale,7,262,55,207,2014,total_driving,NA
144,T143,Rikuya Hoshino,2,264,138,126,2014,total_driving,NA
145,T155,Jonathan Byrd,5,265,72,193,2014,total_driving,NA
T146,T116,Maverick McNealy,9,266,89,177,2014,total_driving,NA
T146,T147,Xander Schauffele,3,266,231,35,2014,total_driving,NA
T148,154,Whee Kim,2,267,180,87,2014,total_driving,NA
T148,T141,Lucas Bjerregaard,3,267,18,249,2014,total_driving,NA
150,T152,Chip McDaniel,2,268,59,209,2014,total_driving,NA
T151,T178,Max Homa,6,269,187,82,2014,total_driving,NA
T151,T112,Bill Haas,6,269,147,122,2014,total_driving,NA
T151,146,J.B. Holmes,3,269,224,45,2014,total_driving,NA
T154,129,Zack Sucher,6,270,24,246,2014,total_driving,NA
T154,T157,Roberto Castro,5,270,183,87,2014,total_driving,NA
156,151,Kevin Tway,6,271,27,244,2014,total_driving,NA
T157,T155,Kevin Chappell,6,272,43,229,2014,total_driving,NA
T157,T152,Dominic Bozzelli,7,272,38,234,2014,total_driving,NA
T159,T147,David Hearn,9,273,206,67,2014,total_driving,NA
T159,174,Jimmy Walker,4,273,92,181,2014,total_driving,NA
161,165,Sangmoon Bae,6,274,64,210,2014,total_driving,NA
162,167,Michael Gellerman,8,275,135,140,2014,total_driving,NA
163,T159,Kevin Kisner,7,277,227,50,2014,total_driving,NA
T164,T159,Justin Thomas,5,278,161,117,2014,total_driving,NA
T164,T187,Troy Merritt,7,278,182,96,2014,total_driving,NA
T164,T163,Freddie Jacobson,3,278,141,137,2014,total_driving,NA
167,T175,Talor Gooch,8,280,122,158,2014,total_driving,NA
168,T103,Andrew Putnam,6,283,181,102,2014,total_driving,NA
T169,T157,Si Woo Kim,8,284,99,185,2014,total_driving,NA
T169,T97,Charley Hoffman,7,284,87,197,2014,total_driving,NA
T169,169,Seamus Power,5,284,83,201,2014,total_driving,NA
172,T133,John Huh,5,285,166,119,2014,total_driving,NA
T173,T172,Jason Day,3,286,80,206,2014,total_driving,NA
T173,T172,Chris Kirk,3,286,199,87,2014,total_driving,NA
T173,T175,Rafael Campos,9,286,67,219,2014,total_driving,NA
176,T159,Nate Lashley,8,287,204,83,2014,total_driving,NA
177,177,Brandt Snedeker,4,288,155,133,2014,total_driving,NA
178,T178,Peter Uihlein,6,289,38,251,2014,total_driving,NA
179,150,Kevin Na,7,290,203,87,2014,total_driving,NA
180,T170,Ben Taylor,10,291,134,157,2014,total_driving,NA
181,162,Anirban Lahiri,8,292,118,174,2014,total_driving,NA
182,T208,Roger Sloan,8,293,158,135,2014,total_driving,NA
T183,182,Johnson Wagner,5,294,207,87,2014,total_driving,NA
T183,T183,Robert Garrigus,5,294,52,242,2014,total_driving,NA
T183,T187,Wes Roach,7,294,151,143,2014,total_driving,NA
186,181,Zach Johnson,7,299,216,83,2014,total_driving,NA
187,191,Mikumu Horikawa,3,303,237,66,2014,total_driving,NA
T188,194,Will Gordon,4,304,64,240,2014,total_driving,NA
T188,210,Rory Sabbatini,7,304,219,85,2014,total_driving,NA
T188,T183,Dylan Frittelli,9,304,193,111,2014,total_driving,NA
191,185,Nelson Ledesma,10,305,57,248,2014,total_driving,NA
192,192,Marc Leishman,5,306,90,216,2014,total_driving,NA
193,166,Joseph Bramlett,7,307,94,213,2014,total_driving,NA
194,195,Joaquin Niemann,8,308,164,144,2014,total_driving,NA
T195,T196,Graeme McDowell,5,311,236,75,2014,total_driving,NA
T195,T201,Bronson Burgoon,8,311,130,181,2014,total_driving,NA
197,T187,Brian Gay,9,312,162,150,2014,total_driving,NA
198,193,Rhein Gibson,9,313,90,223,2014,total_driving,NA
199,T196,Tom Hoge,8,314,185,129,2014,total_driving,NA
200,200,Mark Anderson,7,319,132,187,2014,total_driving,NA
201,204,Smylie Kaufman,3,320,64,256,2014,total_driving,NA
T202,199,Zac Blair,10,322,225,97,2014,total_driving,NA
T202,214,Francesco Molinari,3,322,125,197,2014,total_driving,NA
T204,T170,John Senden,5,324,120,204,2014,total_driving,NA
T204,180,Ben Martin,6,324,223,101,2014,total_driving,NA
T206,T205,James Hahn,6,325,163,162,2014,total_driving,NA
T206,186,Aaron Baddeley,6,325,198,127,2014,total_driving,NA
208,T211,J.J. Spaun,9,330,118,212,2014,total_driving,NA
T209,203,Robert Streb,9,332,141,191,2014,total_driving,NA
T209,T208,Robert Allenby,3,332,164,168,2014,total_driving,NA
211,T211,Martin Trainer,8,339,94,245,2014,total_driving,NA
212,T205,"Ted Potter, Jr.",7,340,151,189,2014,total_driving,NA
213,T201,Chris Stroud,6,341,194,147,2014,total_driving,NA
T214,T205,Rob Oppenheim,10,342,200,142,2014,total_driving,NA
T214,198,Matt Every,7,342,122,220,2014,total_driving,NA
T214,213,Morgan Hoffmann,4,342,143,199,2014,total_driving,NA
217,215,Roberto Díaz,2,345,110,235,2014,total_driving,NA
218,216,Stewart Cink,4,350,112,238,2014,total_driving,NA
219,217,C.T. Pan,5,353,189,164,2014,total_driving,NA
220,T218,Patton Kizzire,9,354,158,196,2014,total_driving,NA
221,222,Hudson Swafford,4,356,183,173,2014,total_driving,NA
222,T218,George McNeill,6,359,145,214,2014,total_driving,NA
223,220,Patrick Reed,4,363,239,124,2014,total_driving,NA
224,221,Jamie Lovemark,4,365,114,251,2014,total_driving,NA
225,224,Luke Donald,2,378,232,146,2014,total_driving,NA
226,226,Bo Van Pelt,7,387,155,232,2014,total_driving,NA
227,225,Davis Love III,3,400,172,228,2014,total_driving,NA
228,228,Arjun Atwal,5,404,173,231,2014,total_driving,NA
T229,231,Daniel Chopra,3,411,157,254,2014,total_driving,NA
T229,227,Kevin Stadler,6,411,217,194,2014,total_driving,NA
231,229,John Rollins,4,414,209,205,2014,total_driving,NA
232,230,Parker McLachlin,4,421,201,220,2014,total_driving,NA
233,232,Peter Malnati,9,422,197,225,2014,total_driving,NA
234,233,Michael Kim,8,435,211,224,2014,total_driving,NA
235,235,Tommy Gainey,4,442,209,233,2014,total_driving,NA
236,234,D.A. Points,4,446,226,220,2014,total_driving,NA
237,236,Ricky Barnes,6,451,214,237,2014,total_driving,NA
238,237,Brendon de Jonge,3,462,205,257,2014,total_driving,NA
239,238,Shugo Imahira,2,490,235,255,2014,total_driving,NA
1,1,Andrew Novak,2,35,17,18,2015,total_driving,NA
2,3,Viktor Hovland,4,63,16,47,2015,total_driving,NA
3,4,Chase Koepka,2,72,34,38,2015,total_driving,NA
4,5,John Oda,2,74,70,4,2015,total_driving,NA
5,6,D.J. Trahan,7,91,47,44,2015,total_driving,NA
6,8,Gary Woodland,4,98,94,4,2015,total_driving,NA
7,9,Branden Grace,4,99,21,78,2015,total_driving,NA
T8,10,Patrick Cantlay,3,103,86,17,2015,total_driving,NA
T8,7,Doc Redman,10,103,77,26,2015,total_driving,NA
10,2,Ryan Moore,5,105,94,11,2015,total_driving,NA
11,13,Scottie Scheffler,8,126,15,111,2015,total_driving,NA
12,T19,Kyoung-Hoon Lee,10,128,106,22,2015,total_driving,NA
13,14,Martin Laird,8,129,42,87,2015,total_driving,NA
14,11,Kevin Streelman,9,130,62,68,2015,total_driving,NA
15,25,Jhonattan Vegas,6,132,24,108,2015,total_driving,NA
T16,15,Nick Taylor,8,133,109,24,2015,total_driving,NA
T16,T23,Brendan Steele,8,133,63,70,2015,total_driving,NA
18,12,Harris English,7,135,36,99,2015,total_driving,NA
T19,T27,Harry Higgs,10,140,79,61,2015,total_driving,NA
T19,T27,Sung Kang,7,140,53,87,2015,total_driving,NA
T21,22,Emiliano Grillo,7,142,110,32,2015,total_driving,NA
T21,18,Bubba Watson,4,142,1,141,2015,total_driving,NA
23,T19,Bryson DeChambeau,3,144,13,131,2015,total_driving,NA
24,T52,Matthew Wolff,5,145,40,105,2015,total_driving,NA
25,29,Joel Dahmen,8,149,100,49,2015,total_driving,NA
26,16,Jason Kokrak,5,153,8,145,2015,total_driving,NA
27,17,Josh Teater,6,156,83,73,2015,total_driving,NA
28,T23,Cameron Champ,7,157,2,155,2015,total_driving,NA
29,33,Ryan Palmer,5,160,146,14,2015,total_driving,NA
30,T35,Adam Hadwin,5,164,121,43,2015,total_driving,NA
31,26,Sungjae Im,8,165,50,115,2015,total_driving,NA
32,31,Henrik Norlander,10,168,132,36,2015,total_driving,NA
T33,38,Boo Weekley,5,169,147,22,2015,total_driving,NA
T33,T35,Harold Varner III,7,169,18,151,2015,total_driving,NA
35,37,Lanto Griffin,10,170,40,130,2015,total_driving,NA
36,T19,Lucas Glover,7,174,98,76,2015,total_driving,NA
37,34,Scott Brown,9,175,151,24,2015,total_driving,NA
38,T44,Sebastián Muñoz,10,176,60,116,2015,total_driving,NA
T39,40,Daniel Berger,6,177,56,121,2015,total_driving,NA
T39,42,Keegan Bradley,7,177,71,106,2015,total_driving,NA
41,39,Chesson Hadley,7,179,106,73,2015,total_driving,NA
42,43,Webb Simpson,3,182,170,12,2015,total_driving,NA
43,48,Danny Lee,7,185,9,176,2015,total_driving,NA
44,T50,Pat Perez,6,186,130,56,2015,total_driving,NA
45,T52,Matthew NeSmith,9,188,154,34,2015,total_driving,NA
46,T99,Sepp Straka,10,191,92,99,2015,total_driving,NA
T47,T90,Isaiah Salinda,3,192,14,178,2015,total_driving,NA
T47,T56,John Merrick,4,192,135,57,2015,total_driving,NA
T49,T50,Jim Furyk,3,193,192,1,2015,total_driving,NA
T49,55,Chad Campbell,4,193,178,15,2015,total_driving,NA
T49,T44,Wyndham Clark,7,193,32,161,2015,total_driving,NA
52,32,Alex Noren,4,195,108,87,2015,total_driving,NA
53,NA,Rickie Fowler,2,196,194,2,2015,total_driving,NA
T54,T56,Tony Finau,5,198,12,186,2015,total_driving,NA
T54,T62,Phil Mickelson,5,198,31,167,2015,total_driving,NA
T54,T62,Aaron Wise,7,198,51,147,2015,total_driving,NA
T54,T69,Chase Seiffert,9,198,127,71,2015,total_driving,NA
T58,T73,Abraham Ancer,8,199,113,86,2015,total_driving,NA
T58,61,Adam Schenk,10,199,33,166,2015,total_driving,NA
T58,T64,Scott Harrington,9,199,34,165,2015,total_driving,NA
T61,T52,Brian Harman,8,200,143,57,2015,total_driving,NA
T61,47,Jason Dufner,7,200,140,60,2015,total_driving,NA
T61,59,Cameron Smith,6,200,77,123,2015,total_driving,NA
T64,46,Kramer Hickok,9,201,124,77,2015,total_driving,NA
T64,60,Matt Jones,8,201,49,152,2015,total_driving,NA
66,30,Robby Shelton,10,202,88,114,2015,total_driving,NA
T67,83,Grayson Murray,6,203,4,199,2015,total_driving,NA
T67,T73,Russell Knox,8,203,138,65,2015,total_driving,NA
69,41,Denny McCarthy,8,204,101,103,2015,total_driving,NA
70,T80,Sam Ryder,10,209,53,156,2015,total_driving,NA
71,58,Brice Garnett,8,214,150,64,2015,total_driving,NA
72,66,Michael Thompson,7,215,175,40,2015,total_driving,NA
73,76,Collin Morikawa,6,216,168,48,2015,total_driving,NA
T74,T69,Derek Ernst,4,217,80,137,2015,total_driving,NA
T74,T67,Adam Long,10,217,189,28,2015,total_driving,NA
T74,96,Andrew Landry,9,217,171,46,2015,total_driving,NA
77,T84,Akshay Bhatia,5,218,7,211,2015,total_driving,NA
78,T69,Rod Pampling,3,220,28,192,2015,total_driving,NA
79,136,Nick Watney,7,222,73,149,2015,total_driving,NA
T80,T84,Hideki Matsuyama,6,223,115,108,2015,total_driving,NA
T80,115,Doug Ghim,7,223,116,107,2015,total_driving,NA
T80,T90,Kristoffer Ventura,9,223,44,179,2015,total_driving,NA
T83,T73,Byeong Hun An,8,225,10,215,2015,total_driving,NA
T83,T90,Chandler Phillips,2,225,57,168,2015,total_driving,NA
T83,T69,Brian Stuard,10,225,215,10,2015,total_driving,NA
T83,T97,Alex Cejka,5,225,175,50,2015,total_driving,NA
T83,T80,Ryan Armour,9,225,217,8,2015,total_driving,NA
T88,T90,Graham DeLaet,5,226,36,190,2015,total_driving,NA
T88,T77,Tim Wilkinson,6,226,189,37,2015,total_driving,NA
T88,T86,Brandon Wu,2,226,188,38,2015,total_driving,NA
T91,T88,Hank Lebioda,9,228,104,124,2015,total_driving,NA
T91,79,Charles Howell III,9,228,69,159,2015,total_driving,NA
93,T67,Tyler McCumber,9,229,11,218,2015,total_driving,NA
94,T90,Fabián Gómez,9,230,167,63,2015,total_driving,NA
95,T90,Brendon Todd,11,231,228,3,2015,total_driving,NA
T96,49,Cameron Percy,8,233,61,172,2015,total_driving,NA
T96,T99,Adam Scott,4,233,46,187,2015,total_driving,NA
T96,T80,Luke List,9,233,80,153,2015,total_driving,NA
T96,T86,Russell Henley,8,233,179,54,2015,total_driving,NA
T96,T130,Mackenzie Hughes,8,233,101,132,2015,total_driving,NA
101,T109,J.T. Poston,9,234,175,59,2015,total_driving,NA
102,T64,Vince Covello,8,235,73,162,2015,total_driving,NA
103,T99,Xinjun Zhang,10,236,116,120,2015,total_driving,NA
104,105,K.J. Choi,3,237,233,4,2015,total_driving,NA
T105,107,Tim Herron,4,238,220,18,2015,total_driving,NA
T105,T109,Corey Conners,7,238,186,52,2015,total_driving,NA
T107,108,Keith Mitchell,7,239,135,104,2015,total_driving,NA
T107,T130,Cameron Davis,8,239,22,217,2015,total_driving,NA
T107,T99,Richy Werenski,4,239,45,194,2015,total_driving,NA
T107,T88,Vaughn Taylor,8,239,212,27,2015,total_driving,NA
111,168,Chris Baker,9,240,168,72,2015,total_driving,NA
T112,T112,Jim Herman,8,241,221,20,2015,total_driving,NA
T112,T127,Scott Piercy,8,241,105,136,2015,total_driving,NA
T114,T120,J.J. Henry,5,242,173,69,2015,total_driving,NA
T114,T103,Tyler Duncan,10,242,221,21,2015,total_driving,NA
116,T112,Davis Riley,2,243,83,160,2015,total_driving,NA
T117,T125,Bo Hoag,10,244,127,117,2015,total_driving,NA
T117,T116,Chez Reavie,9,244,228,16,2015,total_driving,NA
119,T116,Matt Kuchar,4,245,238,7,2015,total_driving,NA
T120,223,Paul Casey,4,247,160,87,2015,total_driving,NA
T120,T116,Satoshi Kodaira,6,247,234,13,2015,total_driving,NA
T120,T127,Shawn Stefani,6,247,73,174,2015,total_driving,NA
123,106,Carlos Ortiz,8,248,67,181,2015,total_driving,NA
124,T122,Ben Crane,6,249,207,42,2015,total_driving,NA
125,T130,Tom Lewis,3,252,5,247,2015,total_driving,NA
126,T139,Michael Gligic,9,253,73,180,2015,total_driving,NA
T127,T139,Scott Stallings,8,254,47,207,2015,total_driving,NA
T127,T137,Kyle Stanley,8,254,213,41,2015,total_driving,NA
T129,T137,Henrik Stenson,2,255,202,53,2015,total_driving,NA
T129,T125,Austin Cook,8,255,127,128,2015,total_driving,NA
T131,T120,Beau Hossler,8,256,29,227,2015,total_driving,NA
T131,T122,Patrick Rodgers,10,256,26,230,2015,total_driving,NA
T131,T143,Sebastian Cappelen,8,256,30,226,2015,total_driving,NA
T131,T133,Kurt Kitayama,2,256,3,253,2015,total_driving,NA
T131,T77,Vincent Whaley,7,256,103,153,2015,total_driving,NA
T131,T141,Ryan Brehm,10,256,6,250,2015,total_driving,NA
137,T122,Mark Hubbard,10,257,149,108,2015,total_driving,NA
T138,T163,Brandon Hagy,8,258,22,236,2015,total_driving,NA
T138,T109,Billy Horschel,6,258,196,62,2015,total_driving,NA
T140,T147,Sam Burns,6,259,20,239,2015,total_driving,NA
T140,T133,David Lingmerth,5,259,230,29,2015,total_driving,NA
T142,T187,Bud Cauley,6,262,125,137,2015,total_driving,NA
T142,T143,Cameron Tringale,7,262,55,207,2015,total_driving,NA
144,T143,Rikuya Hoshino,2,264,138,126,2015,total_driving,NA
145,T155,Jonathan Byrd,5,265,72,193,2015,total_driving,NA
T146,T116,Maverick McNealy,9,266,89,177,2015,total_driving,NA
T146,T147,Xander Schauffele,3,266,231,35,2015,total_driving,NA
T148,154,Whee Kim,2,267,180,87,2015,total_driving,NA
T148,T141,Lucas Bjerregaard,3,267,18,249,2015,total_driving,NA
150,T152,Chip McDaniel,2,268,59,209,2015,total_driving,NA
T151,T178,Max Homa,6,269,187,82,2015,total_driving,NA
T151,T112,Bill Haas,6,269,147,122,2015,total_driving,NA
T151,146,J.B. Holmes,3,269,224,45,2015,total_driving,NA
T154,129,Zack Sucher,6,270,24,246,2015,total_driving,NA
T154,T157,Roberto Castro,5,270,183,87,2015,total_driving,NA
156,151,Kevin Tway,6,271,27,244,2015,total_driving,NA
T157,T155,Kevin Chappell,6,272,43,229,2015,total_driving,NA
T157,T152,Dominic Bozzelli,7,272,38,234,2015,total_driving,NA
T159,T147,David Hearn,9,273,206,67,2015,total_driving,NA
T159,174,Jimmy Walker,4,273,92,181,2015,total_driving,NA
161,165,Sangmoon Bae,6,274,64,210,2015,total_driving,NA
162,167,Michael Gellerman,8,275,135,140,2015,total_driving,NA
163,T159,Kevin Kisner,7,277,227,50,2015,total_driving,NA
T164,T159,Justin Thomas,5,278,161,117,2015,total_driving,NA
T164,T187,Troy Merritt,7,278,182,96,2015,total_driving,NA
T164,T163,Freddie Jacobson,3,278,141,137,2015,total_driving,NA
167,T175,Talor Gooch,8,280,122,158,2015,total_driving,NA
168,T103,Andrew Putnam,6,283,181,102,2015,total_driving,NA
T169,T157,Si Woo Kim,8,284,99,185,2015,total_driving,NA
T169,T97,Charley Hoffman,7,284,87,197,2015,total_driving,NA
T169,169,Seamus Power,5,284,83,201,2015,total_driving,NA
172,T133,John Huh,5,285,166,119,2015,total_driving,NA
T173,T172,Jason Day,3,286,80,206,2015,total_driving,NA
T173,T172,Chris Kirk,3,286,199,87,2015,total_driving,NA
T173,T175,Rafael Campos,9,286,67,219,2015,total_driving,NA
176,T159,Nate Lashley,8,287,204,83,2015,total_driving,NA
177,177,Brandt Snedeker,4,288,155,133,2015,total_driving,NA
178,T178,Peter Uihlein,6,289,38,251,2015,total_driving,NA
179,150,Kevin Na,7,290,203,87,2015,total_driving,NA
180,T170,Ben Taylor,10,291,134,157,2015,total_driving,NA
181,162,Anirban Lahiri,8,292,118,174,2015,total_driving,NA
182,T208,Roger Sloan,8,293,158,135,2015,total_driving,NA
T183,182,Johnson Wagner,5,294,207,87,2015,total_driving,NA
T183,T183,Robert Garrigus,5,294,52,242,2015,total_driving,NA
T183,T187,Wes Roach,7,294,151,143,2015,total_driving,NA
186,181,Zach Johnson,7,299,216,83,2015,total_driving,NA
187,191,Mikumu Horikawa,3,303,237,66,2015,total_driving,NA
T188,194,Will Gordon,4,304,64,240,2015,total_driving,NA
T188,210,Rory Sabbatini,7,304,219,85,2015,total_driving,NA
T188,T183,Dylan Frittelli,9,304,193,111,2015,total_driving,NA
191,185,Nelson Ledesma,10,305,57,248,2015,total_driving,NA
192,192,Marc Leishman,5,306,90,216,2015,total_driving,NA
193,166,Joseph Bramlett,7,307,94,213,2015,total_driving,NA
194,195,Joaquin Niemann,8,308,164,144,2015,total_driving,NA
T195,T196,Graeme McDowell,5,311,236,75,2015,total_driving,NA
T195,T201,Bronson Burgoon,8,311,130,181,2015,total_driving,NA
197,T187,Brian Gay,9,312,162,150,2015,total_driving,NA
198,193,Rhein Gibson,9,313,90,223,2015,total_driving,NA
199,T196,Tom Hoge,8,314,185,129,2015,total_driving,NA
200,200,Mark Anderson,7,319,132,187,2015,total_driving,NA
201,204,Smylie Kaufman,3,320,64,256,2015,total_driving,NA
T202,199,Zac Blair,10,322,225,97,2015,total_driving,NA
T202,214,Francesco Molinari,3,322,125,197,2015,total_driving,NA
T204,T170,John Senden,5,324,120,204,2015,total_driving,NA
T204,180,Ben Martin,6,324,223,101,2015,total_driving,NA
T206,T205,James Hahn,6,325,163,162,2015,total_driving,NA
T206,186,Aaron Baddeley,6,325,198,127,2015,total_driving,NA
208,T211,J.J. Spaun,9,330,118,212,2015,total_driving,NA
T209,203,Robert Streb,9,332,141,191,2015,total_driving,NA
T209,T208,Robert Allenby,3,332,164,168,2015,total_driving,NA
211,T211,Martin Trainer,8,339,94,245,2015,total_driving,NA
212,T205,"Ted Potter, Jr.",7,340,151,189,2015,total_driving,NA
213,T201,Chris Stroud,6,341,194,147,2015,total_driving,NA
T214,T205,Rob Oppenheim,10,342,200,142,2015,total_driving,NA
T214,198,Matt Every,7,342,122,220,2015,total_driving,NA
T214,213,Morgan Hoffmann,4,342,143,199,2015,total_driving,NA
217,215,Roberto Díaz,2,345,110,235,2015,total_driving,NA
218,216,Stewart Cink,4,350,112,238,2015,total_driving,NA
219,217,C.T. Pan,5,353,189,164,2015,total_driving,NA
220,T218,Patton Kizzire,9,354,158,196,2015,total_driving,NA
221,222,Hudson Swafford,4,356,183,173,2015,total_driving,NA
222,T218,George McNeill,6,359,145,214,2015,total_driving,NA
223,220,Patrick Reed,4,363,239,124,2015,total_driving,NA
224,221,Jamie Lovemark,4,365,114,251,2015,total_driving,NA
225,224,Luke Donald,2,378,232,146,2015,total_driving,NA
226,226,Bo Van Pelt,7,387,155,232,2015,total_driving,NA
227,225,Davis Love III,3,400,172,228,2015,total_driving,NA
228,228,Arjun Atwal,5,404,173,231,2015,total_driving,NA
T229,231,Daniel Chopra,3,411,157,254,2015,total_driving,NA
T229,227,Kevin Stadler,6,411,217,194,2015,total_driving,NA
231,229,John Rollins,4,414,209,205,2015,total_driving,NA
232,230,Parker McLachlin,4,421,201,220,2015,total_driving,NA
233,232,Peter Malnati,9,422,197,225,2015,total_driving,NA
234,233,Michael Kim,8,435,211,224,2015,total_driving,NA
235,235,Tommy Gainey,4,442,209,233,2015,total_driving,NA
236,234,D.A. Points,4,446,226,220,2015,total_driving,NA
237,236,Ricky Barnes,6,451,214,237,2015,total_driving,NA
238,237,Brendon de Jonge,3,462,205,257,2015,total_driving,NA
239,238,Shugo Imahira,2,490,235,255,2015,total_driving,NA
1,1,Andrew Novak,2,35,17,18,2016,total_driving,NA
2,3,Viktor Hovland,4,63,16,47,2016,total_driving,NA
3,4,Chase Koepka,2,72,34,38,2016,total_driving,NA
4,5,John Oda,2,74,70,4,2016,total_driving,NA
5,6,D.J. Trahan,7,91,47,44,2016,total_driving,NA
6,8,Gary Woodland,4,98,94,4,2016,total_driving,NA
7,9,Branden Grace,4,99,21,78,2016,total_driving,NA
T8,10,Patrick Cantlay,3,103,86,17,2016,total_driving,NA
T8,7,Doc Redman,10,103,77,26,2016,total_driving,NA
10,2,Ryan Moore,5,105,94,11,2016,total_driving,NA
11,13,Scottie Scheffler,8,126,15,111,2016,total_driving,NA
12,T19,Kyoung-Hoon Lee,10,128,106,22,2016,total_driving,NA
13,14,Martin Laird,8,129,42,87,2016,total_driving,NA
14,11,Kevin Streelman,9,130,62,68,2016,total_driving,NA
15,25,Jhonattan Vegas,6,132,24,108,2016,total_driving,NA
T16,15,Nick Taylor,8,133,109,24,2016,total_driving,NA
T16,T23,Brendan Steele,8,133,63,70,2016,total_driving,NA
18,12,Harris English,7,135,36,99,2016,total_driving,NA
T19,T27,Harry Higgs,10,140,79,61,2016,total_driving,NA
T19,T27,Sung Kang,7,140,53,87,2016,total_driving,NA
T21,22,Emiliano Grillo,7,142,110,32,2016,total_driving,NA
T21,18,Bubba Watson,4,142,1,141,2016,total_driving,NA
23,T19,Bryson DeChambeau,3,144,13,131,2016,total_driving,NA
24,T52,Matthew Wolff,5,145,40,105,2016,total_driving,NA
25,29,Joel Dahmen,8,149,100,49,2016,total_driving,NA
26,16,Jason Kokrak,5,153,8,145,2016,total_driving,NA
27,17,Josh Teater,6,156,83,73,2016,total_driving,NA
28,T23,Cameron Champ,7,157,2,155,2016,total_driving,NA
29,33,Ryan Palmer,5,160,146,14,2016,total_driving,NA
30,T35,Adam Hadwin,5,164,121,43,2016,total_driving,NA
31,26,Sungjae Im,8,165,50,115,2016,total_driving,NA
32,31,Henrik Norlander,10,168,132,36,2016,total_driving,NA
T33,38,Boo Weekley,5,169,147,22,2016,total_driving,NA
T33,T35,Harold Varner III,7,169,18,151,2016,total_driving,NA
35,37,Lanto Griffin,10,170,40,130,2016,total_driving,NA
36,T19,Lucas Glover,7,174,98,76,2016,total_driving,NA
37,34,Scott Brown,9,175,151,24,2016,total_driving,NA
38,T44,Sebastián Muñoz,10,176,60,116,2016,total_driving,NA
T39,40,Daniel Berger,6,177,56,121,2016,total_driving,NA
T39,42,Keegan Bradley,7,177,71,106,2016,total_driving,NA
41,39,Chesson Hadley,7,179,106,73,2016,total_driving,NA
42,43,Webb Simpson,3,182,170,12,2016,total_driving,NA
43,48,Danny Lee,7,185,9,176,2016,total_driving,NA
44,T50,Pat Perez,6,186,130,56,2016,total_driving,NA
45,T52,Matthew NeSmith,9,188,154,34,2016,total_driving,NA
46,T99,Sepp Straka,10,191,92,99,2016,total_driving,NA
T47,T90,Isaiah Salinda,3,192,14,178,2016,total_driving,NA
T47,T56,John Merrick,4,192,135,57,2016,total_driving,NA
T49,T50,Jim Furyk,3,193,192,1,2016,total_driving,NA
T49,55,Chad Campbell,4,193,178,15,2016,total_driving,NA
T49,T44,Wyndham Clark,7,193,32,161,2016,total_driving,NA
52,32,Alex Noren,4,195,108,87,2016,total_driving,NA
53,NA,Rickie Fowler,2,196,194,2,2016,total_driving,NA
T54,T56,Tony Finau,5,198,12,186,2016,total_driving,NA
T54,T62,Phil Mickelson,5,198,31,167,2016,total_driving,NA
T54,T62,Aaron Wise,7,198,51,147,2016,total_driving,NA
T54,T69,Chase Seiffert,9,198,127,71,2016,total_driving,NA
T58,T73,Abraham Ancer,8,199,113,86,2016,total_driving,NA
T58,61,Adam Schenk,10,199,33,166,2016,total_driving,NA
T58,T64,Scott Harrington,9,199,34,165,2016,total_driving,NA
T61,T52,Brian Harman,8,200,143,57,2016,total_driving,NA
T61,47,Jason Dufner,7,200,140,60,2016,total_driving,NA
T61,59,Cameron Smith,6,200,77,123,2016,total_driving,NA
T64,46,Kramer Hickok,9,201,124,77,2016,total_driving,NA
T64,60,Matt Jones,8,201,49,152,2016,total_driving,NA
66,30,Robby Shelton,10,202,88,114,2016,total_driving,NA
T67,83,Grayson Murray,6,203,4,199,2016,total_driving,NA
T67,T73,Russell Knox,8,203,138,65,2016,total_driving,NA
69,41,Denny McCarthy,8,204,101,103,2016,total_driving,NA
70,T80,Sam Ryder,10,209,53,156,2016,total_driving,NA
71,58,Brice Garnett,8,214,150,64,2016,total_driving,NA
72,66,Michael Thompson,7,215,175,40,2016,total_driving,NA
73,76,Collin Morikawa,6,216,168,48,2016,total_driving,NA
T74,T69,Derek Ernst,4,217,80,137,2016,total_driving,NA
T74,T67,Adam Long,10,217,189,28,2016,total_driving,NA
T74,96,Andrew Landry,9,217,171,46,2016,total_driving,NA
77,T84,Akshay Bhatia,5,218,7,211,2016,total_driving,NA
78,T69,Rod Pampling,3,220,28,192,2016,total_driving,NA
79,136,Nick Watney,7,222,73,149,2016,total_driving,NA
T80,T84,Hideki Matsuyama,6,223,115,108,2016,total_driving,NA
T80,115,Doug Ghim,7,223,116,107,2016,total_driving,NA
T80,T90,Kristoffer Ventura,9,223,44,179,2016,total_driving,NA
T83,T73,Byeong Hun An,8,225,10,215,2016,total_driving,NA
T83,T90,Chandler Phillips,2,225,57,168,2016,total_driving,NA
T83,T69,Brian Stuard,10,225,215,10,2016,total_driving,NA
T83,T97,Alex Cejka,5,225,175,50,2016,total_driving,NA
T83,T80,Ryan Armour,9,225,217,8,2016,total_driving,NA
T88,T90,Graham DeLaet,5,226,36,190,2016,total_driving,NA
T88,T77,Tim Wilkinson,6,226,189,37,2016,total_driving,NA
T88,T86,Brandon Wu,2,226,188,38,2016,total_driving,NA
T91,T88,Hank Lebioda,9,228,104,124,2016,total_driving,NA
T91,79,Charles Howell III,9,228,69,159,2016,total_driving,NA
93,T67,Tyler McCumber,9,229,11,218,2016,total_driving,NA
94,T90,Fabián Gómez,9,230,167,63,2016,total_driving,NA
95,T90,Brendon Todd,11,231,228,3,2016,total_driving,NA
T96,49,Cameron Percy,8,233,61,172,2016,total_driving,NA
T96,T99,Adam Scott,4,233,46,187,2016,total_driving,NA
T96,T80,Luke List,9,233,80,153,2016,total_driving,NA
T96,T86,Russell Henley,8,233,179,54,2016,total_driving,NA
T96,T130,Mackenzie Hughes,8,233,101,132,2016,total_driving,NA
101,T109,J.T. Poston,9,234,175,59,2016,total_driving,NA
102,T64,Vince Covello,8,235,73,162,2016,total_driving,NA
103,T99,Xinjun Zhang,10,236,116,120,2016,total_driving,NA
104,105,K.J. Choi,3,237,233,4,2016,total_driving,NA
T105,107,Tim Herron,4,238,220,18,2016,total_driving,NA
T105,T109,Corey Conners,7,238,186,52,2016,total_driving,NA
T107,108,Keith Mitchell,7,239,135,104,2016,total_driving,NA
T107,T130,Cameron Davis,8,239,22,217,2016,total_driving,NA
T107,T99,Richy Werenski,4,239,45,194,2016,total_driving,NA
T107,T88,Vaughn Taylor,8,239,212,27,2016,total_driving,NA
111,168,Chris Baker,9,240,168,72,2016,total_driving,NA
T112,T112,Jim Herman,8,241,221,20,2016,total_driving,NA
T112,T127,Scott Piercy,8,241,105,136,2016,total_driving,NA
T114,T120,J.J. Henry,5,242,173,69,2016,total_driving,NA
T114,T103,Tyler Duncan,10,242,221,21,2016,total_driving,NA
116,T112,Davis Riley,2,243,83,160,2016,total_driving,NA
T117,T125,Bo Hoag,10,244,127,117,2016,total_driving,NA
T117,T116,Chez Reavie,9,244,228,16,2016,total_driving,NA
119,T116,Matt Kuchar,4,245,238,7,2016,total_driving,NA
T120,223,Paul Casey,4,247,160,87,2016,total_driving,NA
T120,T116,Satoshi Kodaira,6,247,234,13,2016,total_driving,NA
T120,T127,Shawn Stefani,6,247,73,174,2016,total_driving,NA
123,106,Carlos Ortiz,8,248,67,181,2016,total_driving,NA
124,T122,Ben Crane,6,249,207,42,2016,total_driving,NA
125,T130,Tom Lewis,3,252,5,247,2016,total_driving,NA
126,T139,Michael Gligic,9,253,73,180,2016,total_driving,NA
T127,T139,Scott Stallings,8,254,47,207,2016,total_driving,NA
T127,T137,Kyle Stanley,8,254,213,41,2016,total_driving,NA
T129,T137,Henrik Stenson,2,255,202,53,2016,total_driving,NA
T129,T125,Austin Cook,8,255,127,128,2016,total_driving,NA
T131,T120,Beau Hossler,8,256,29,227,2016,total_driving,NA
T131,T122,Patrick Rodgers,10,256,26,230,2016,total_driving,NA
T131,T143,Sebastian Cappelen,8,256,30,226,2016,total_driving,NA
T131,T133,Kurt Kitayama,2,256,3,253,2016,total_driving,NA
T131,T77,Vincent Whaley,7,256,103,153,2016,total_driving,NA
T131,T141,Ryan Brehm,10,256,6,250,2016,total_driving,NA
137,T122,Mark Hubbard,10,257,149,108,2016,total_driving,NA
T138,T163,Brandon Hagy,8,258,22,236,2016,total_driving,NA
T138,T109,Billy Horschel,6,258,196,62,2016,total_driving,NA
T140,T147,Sam Burns,6,259,20,239,2016,total_driving,NA
T140,T133,David Lingmerth,5,259,230,29,2016,total_driving,NA
T142,T187,Bud Cauley,6,262,125,137,2016,total_driving,NA
T142,T143,Cameron Tringale,7,262,55,207,2016,total_driving,NA
144,T143,Rikuya Hoshino,2,264,138,126,2016,total_driving,NA
145,T155,Jonathan Byrd,5,265,72,193,2016,total_driving,NA
T146,T116,Maverick McNealy,9,266,89,177,2016,total_driving,NA
T146,T147,Xander Schauffele,3,266,231,35,2016,total_driving,NA
T148,154,Whee Kim,2,267,180,87,2016,total_driving,NA
T148,T141,Lucas Bjerregaard,3,267,18,249,2016,total_driving,NA
150,T152,Chip McDaniel,2,268,59,209,2016,total_driving,NA
T151,T178,Max Homa,6,269,187,82,2016,total_driving,NA
T151,T112,Bill Haas,6,269,147,122,2016,total_driving,NA
T151,146,J.B. Holmes,3,269,224,45,2016,total_driving,NA
T154,129,Zack Sucher,6,270,24,246,2016,total_driving,NA
T154,T157,Roberto Castro,5,270,183,87,2016,total_driving,NA
156,151,Kevin Tway,6,271,27,244,2016,total_driving,NA
T157,T155,Kevin Chappell,6,272,43,229,2016,total_driving,NA
T157,T152,Dominic Bozzelli,7,272,38,234,2016,total_driving,NA
T159,T147,David Hearn,9,273,206,67,2016,total_driving,NA
T159,174,Jimmy Walker,4,273,92,181,2016,total_driving,NA
161,165,Sangmoon Bae,6,274,64,210,2016,total_driving,NA
162,167,Michael Gellerman,8,275,135,140,2016,total_driving,NA
163,T159,Kevin Kisner,7,277,227,50,2016,total_driving,NA
T164,T159,Justin Thomas,5,278,161,117,2016,total_driving,NA
T164,T187,Troy Merritt,7,278,182,96,2016,total_driving,NA
T164,T163,Freddie Jacobson,3,278,141,137,2016,total_driving,NA
167,T175,Talor Gooch,8,280,122,158,2016,total_driving,NA
168,T103,Andrew Putnam,6,283,181,102,2016,total_driving,NA
T169,T157,Si Woo Kim,8,284,99,185,2016,total_driving,NA
T169,T97,Charley Hoffman,7,284,87,197,2016,total_driving,NA
T169,169,Seamus Power,5,284,83,201,2016,total_driving,NA
172,T133,John Huh,5,285,166,119,2016,total_driving,NA
T173,T172,Jason Day,3,286,80,206,2016,total_driving,NA
T173,T172,Chris Kirk,3,286,199,87,2016,total_driving,NA
T173,T175,Rafael Campos,9,286,67,219,2016,total_driving,NA
176,T159,Nate Lashley,8,287,204,83,2016,total_driving,NA
177,177,Brandt Snedeker,4,288,155,133,2016,total_driving,NA
178,T178,Peter Uihlein,6,289,38,251,2016,total_driving,NA
179,150,Kevin Na,7,290,203,87,2016,total_driving,NA
180,T170,Ben Taylor,10,291,134,157,2016,total_driving,NA
181,162,Anirban Lahiri,8,292,118,174,2016,total_driving,NA
182,T208,Roger Sloan,8,293,158,135,2016,total_driving,NA
T183,182,Johnson Wagner,5,294,207,87,2016,total_driving,NA
T183,T183,Robert Garrigus,5,294,52,242,2016,total_driving,NA
T183,T187,Wes Roach,7,294,151,143,2016,total_driving,NA
186,181,Zach Johnson,7,299,216,83,2016,total_driving,NA
187,191,Mikumu Horikawa,3,303,237,66,2016,total_driving,NA
T188,194,Will Gordon,4,304,64,240,2016,total_driving,NA
T188,210,Rory Sabbatini,7,304,219,85,2016,total_driving,NA
T188,T183,Dylan Frittelli,9,304,193,111,2016,total_driving,NA
191,185,Nelson Ledesma,10,305,57,248,2016,total_driving,NA
192,192,Marc Leishman,5,306,90,216,2016,total_driving,NA
193,166,Joseph Bramlett,7,307,94,213,2016,total_driving,NA
194,195,Joaquin Niemann,8,308,164,144,2016,total_driving,NA
T195,T196,Graeme McDowell,5,311,236,75,2016,total_driving,NA
T195,T201,Bronson Burgoon,8,311,130,181,2016,total_driving,NA
197,T187,Brian Gay,9,312,162,150,2016,total_driving,NA
198,193,Rhein Gibson,9,313,90,223,2016,total_driving,NA
199,T196,Tom Hoge,8,314,185,129,2016,total_driving,NA
200,200,Mark Anderson,7,319,132,187,2016,total_driving,NA
201,204,Smylie Kaufman,3,320,64,256,2016,total_driving,NA
T202,199,Zac Blair,10,322,225,97,2016,total_driving,NA
T202,214,Francesco Molinari,3,322,125,197,2016,total_driving,NA
T204,T170,John Senden,5,324,120,204,2016,total_driving,NA
T204,180,Ben Martin,6,324,223,101,2016,total_driving,NA
T206,T205,James Hahn,6,325,163,162,2016,total_driving,NA
T206,186,Aaron Baddeley,6,325,198,127,2016,total_driving,NA
208,T211,J.J. Spaun,9,330,118,212,2016,total_driving,NA
T209,203,Robert Streb,9,332,141,191,2016,total_driving,NA
T209,T208,Robert Allenby,3,332,164,168,2016,total_driving,NA
211,T211,Martin Trainer,8,339,94,245,2016,total_driving,NA
212,T205,"Ted Potter, Jr.",7,340,151,189,2016,total_driving,NA
213,T201,Chris Stroud,6,341,194,147,2016,total_driving,NA
T214,T205,Rob Oppenheim,10,342,200,142,2016,total_driving,NA
T214,198,Matt Every,7,342,122,220,2016,total_driving,NA
T214,213,Morgan Hoffmann,4,342,143,199,2016,total_driving,NA
217,215,Roberto Díaz,2,345,110,235,2016,total_driving,NA
218,216,Stewart Cink,4,350,112,238,2016,total_driving,NA
219,217,C.T. Pan,5,353,189,164,2016,total_driving,NA
220,T218,Patton Kizzire,9,354,158,196,2016,total_driving,NA
221,222,Hudson Swafford,4,356,183,173,2016,total_driving,NA
222,T218,George McNeill,6,359,145,214,2016,total_driving,NA
223,220,Patrick Reed,4,363,239,124,2016,total_driving,NA
224,221,Jamie Lovemark,4,365,114,251,2016,total_driving,NA
225,224,Luke Donald,2,378,232,146,2016,total_driving,NA
226,226,Bo Van Pelt,7,387,155,232,2016,total_driving,NA
227,225,Davis Love III,3,400,172,228,2016,total_driving,NA
228,228,Arjun Atwal,5,404,173,231,2016,total_driving,NA
T229,231,Daniel Chopra,3,411,157,254,2016,total_driving,NA
T229,227,Kevin Stadler,6,411,217,194,2016,total_driving,NA
231,229,John Rollins,4,414,209,205,2016,total_driving,NA
232,230,Parker McLachlin,4,421,201,220,2016,total_driving,NA
233,232,Peter Malnati,9,422,197,225,2016,total_driving,NA
234,233,Michael Kim,8,435,211,224,2016,total_driving,NA
235,235,Tommy Gainey,4,442,209,233,2016,total_driving,NA
236,234,D.A. Points,4,446,226,220,2016,total_driving,NA
237,236,Ricky Barnes,6,451,214,237,2016,total_driving,NA
238,237,Brendon de Jonge,3,462,205,257,2016,total_driving,NA
239,238,Shugo Imahira,2,490,235,255,2016,total_driving,NA
1,1,Andrew Novak,2,35,17,18,2017,total_driving,NA
2,3,Viktor Hovland,4,63,16,47,2017,total_driving,NA
3,4,Chase Koepka,2,72,34,38,2017,total_driving,NA
4,5,John Oda,2,74,70,4,2017,total_driving,NA
5,6,D.J. Trahan,7,91,47,44,2017,total_driving,NA
6,8,Gary Woodland,4,98,94,4,2017,total_driving,NA
7,9,Branden Grace,4,99,21,78,2017,total_driving,NA
T8,10,Patrick Cantlay,3,103,86,17,2017,total_driving,NA
T8,7,Doc Redman,10,103,77,26,2017,total_driving,NA
10,2,Ryan Moore,5,105,94,11,2017,total_driving,NA
11,13,Scottie Scheffler,8,126,15,111,2017,total_driving,NA
12,T19,Kyoung-Hoon Lee,10,128,106,22,2017,total_driving,NA
13,14,Martin Laird,8,129,42,87,2017,total_driving,NA
14,11,Kevin Streelman,9,130,62,68,2017,total_driving,NA
15,25,Jhonattan Vegas,6,132,24,108,2017,total_driving,NA
T16,15,Nick Taylor,8,133,109,24,2017,total_driving,NA
T16,T23,Brendan Steele,8,133,63,70,2017,total_driving,NA
18,12,Harris English,7,135,36,99,2017,total_driving,NA
T19,T27,Harry Higgs,10,140,79,61,2017,total_driving,NA
T19,T27,Sung Kang,7,140,53,87,2017,total_driving,NA
T21,22,Emiliano Grillo,7,142,110,32,2017,total_driving,NA
T21,18,Bubba Watson,4,142,1,141,2017,total_driving,NA
23,T19,Bryson DeChambeau,3,144,13,131,2017,total_driving,NA
24,T52,Matthew Wolff,5,145,40,105,2017,total_driving,NA
25,29,Joel Dahmen,8,149,100,49,2017,total_driving,NA
26,16,Jason Kokrak,5,153,8,145,2017,total_driving,NA
27,17,Josh Teater,6,156,83,73,2017,total_driving,NA
28,T23,Cameron Champ,7,157,2,155,2017,total_driving,NA
29,33,Ryan Palmer,5,160,146,14,2017,total_driving,NA
30,T35,Adam Hadwin,5,164,121,43,2017,total_driving,NA
31,26,Sungjae Im,8,165,50,115,2017,total_driving,NA
32,31,Henrik Norlander,10,168,132,36,2017,total_driving,NA
T33,38,Boo Weekley,5,169,147,22,2017,total_driving,NA
T33,T35,Harold Varner III,7,169,18,151,2017,total_driving,NA
35,37,Lanto Griffin,10,170,40,130,2017,total_driving,NA
36,T19,Lucas Glover,7,174,98,76,2017,total_driving,NA
37,34,Scott Brown,9,175,151,24,2017,total_driving,NA
38,T44,Sebastián Muñoz,10,176,60,116,2017,total_driving,NA
T39,40,Daniel Berger,6,177,56,121,2017,total_driving,NA
T39,42,Keegan Bradley,7,177,71,106,2017,total_driving,NA
41,39,Chesson Hadley,7,179,106,73,2017,total_driving,NA
42,43,Webb Simpson,3,182,170,12,2017,total_driving,NA
43,48,Danny Lee,7,185,9,176,2017,total_driving,NA
44,T50,Pat Perez,6,186,130,56,2017,total_driving,NA
45,T52,Matthew NeSmith,9,188,154,34,2017,total_driving,NA
46,T99,Sepp Straka,10,191,92,99,2017,total_driving,NA
T47,T90,Isaiah Salinda,3,192,14,178,2017,total_driving,NA
T47,T56,John Merrick,4,192,135,57,2017,total_driving,NA
T49,T50,Jim Furyk,3,193,192,1,2017,total_driving,NA
T49,55,Chad Campbell,4,193,178,15,2017,total_driving,NA
T49,T44,Wyndham Clark,7,193,32,161,2017,total_driving,NA
52,32,Alex Noren,4,195,108,87,2017,total_driving,NA
53,NA,Rickie Fowler,2,196,194,2,2017,total_driving,NA
T54,T56,Tony Finau,5,198,12,186,2017,total_driving,NA
T54,T62,Phil Mickelson,5,198,31,167,2017,total_driving,NA
T54,T62,Aaron Wise,7,198,51,147,2017,total_driving,NA
T54,T69,Chase Seiffert,9,198,127,71,2017,total_driving,NA
T58,T73,Abraham Ancer,8,199,113,86,2017,total_driving,NA
T58,61,Adam Schenk,10,199,33,166,2017,total_driving,NA
T58,T64,Scott Harrington,9,199,34,165,2017,total_driving,NA
T61,T52,Brian Harman,8,200,143,57,2017,total_driving,NA
T61,47,Jason Dufner,7,200,140,60,2017,total_driving,NA
T61,59,Cameron Smith,6,200,77,123,2017,total_driving,NA
T64,46,Kramer Hickok,9,201,124,77,2017,total_driving,NA
T64,60,Matt Jones,8,201,49,152,2017,total_driving,NA
66,30,Robby Shelton,10,202,88,114,2017,total_driving,NA
T67,83,Grayson Murray,6,203,4,199,2017,total_driving,NA
T67,T73,Russell Knox,8,203,138,65,2017,total_driving,NA
69,41,Denny McCarthy,8,204,101,103,2017,total_driving,NA
70,T80,Sam Ryder,10,209,53,156,2017,total_driving,NA
71,58,Brice Garnett,8,214,150,64,2017,total_driving,NA
72,66,Michael Thompson,7,215,175,40,2017,total_driving,NA
73,76,Collin Morikawa,6,216,168,48,2017,total_driving,NA
T74,T69,Derek Ernst,4,217,80,137,2017,total_driving,NA
T74,T67,Adam Long,10,217,189,28,2017,total_driving,NA
T74,96,Andrew Landry,9,217,171,46,2017,total_driving,NA
77,T84,Akshay Bhatia,5,218,7,211,2017,total_driving,NA
78,T69,Rod Pampling,3,220,28,192,2017,total_driving,NA
79,136,Nick Watney,7,222,73,149,2017,total_driving,NA
T80,T84,Hideki Matsuyama,6,223,115,108,2017,total_driving,NA
T80,115,Doug Ghim,7,223,116,107,2017,total_driving,NA
T80,T90,Kristoffer Ventura,9,223,44,179,2017,total_driving,NA
T83,T73,Byeong Hun An,8,225,10,215,2017,total_driving,NA
T83,T90,Chandler Phillips,2,225,57,168,2017,total_driving,NA
T83,T69,Brian Stuard,10,225,215,10,2017,total_driving,NA
T83,T97,Alex Cejka,5,225,175,50,2017,total_driving,NA
T83,T80,Ryan Armour,9,225,217,8,2017,total_driving,NA
T88,T90,Graham DeLaet,5,226,36,190,2017,total_driving,NA
T88,T77,Tim Wilkinson,6,226,189,37,2017,total_driving,NA
T88,T86,Brandon Wu,2,226,188,38,2017,total_driving,NA
T91,T88,Hank Lebioda,9,228,104,124,2017,total_driving,NA
T91,79,Charles Howell III,9,228,69,159,2017,total_driving,NA
93,T67,Tyler McCumber,9,229,11,218,2017,total_driving,NA
94,T90,Fabián Gómez,9,230,167,63,2017,total_driving,NA
95,T90,Brendon Todd,11,231,228,3,2017,total_driving,NA
T96,49,Cameron Percy,8,233,61,172,2017,total_driving,NA
T96,T99,Adam Scott,4,233,46,187,2017,total_driving,NA
T96,T80,Luke List,9,233,80,153,2017,total_driving,NA
T96,T86,Russell Henley,8,233,179,54,2017,total_driving,NA
T96,T130,Mackenzie Hughes,8,233,101,132,2017,total_driving,NA
101,T109,J.T. Poston,9,234,175,59,2017,total_driving,NA
102,T64,Vince Covello,8,235,73,162,2017,total_driving,NA
103,T99,Xinjun Zhang,10,236,116,120,2017,total_driving,NA
104,105,K.J. Choi,3,237,233,4,2017,total_driving,NA
T105,107,Tim Herron,4,238,220,18,2017,total_driving,NA
T105,T109,Corey Conners,7,238,186,52,2017,total_driving,NA
T107,108,Keith Mitchell,7,239,135,104,2017,total_driving,NA
T107,T130,Cameron Davis,8,239,22,217,2017,total_driving,NA
T107,T99,Richy Werenski,4,239,45,194,2017,total_driving,NA
T107,T88,Vaughn Taylor,8,239,212,27,2017,total_driving,NA
111,168,Chris Baker,9,240,168,72,2017,total_driving,NA
T112,T112,Jim Herman,8,241,221,20,2017,total_driving,NA
T112,T127,Scott Piercy,8,241,105,136,2017,total_driving,NA
T114,T120,J.J. Henry,5,242,173,69,2017,total_driving,NA
T114,T103,Tyler Duncan,10,242,221,21,2017,total_driving,NA
116,T112,Davis Riley,2,243,83,160,2017,total_driving,NA
T117,T125,Bo Hoag,10,244,127,117,2017,total_driving,NA
T117,T116,Chez Reavie,9,244,228,16,2017,total_driving,NA
119,T116,Matt Kuchar,4,245,238,7,2017,total_driving,NA
T120,223,Paul Casey,4,247,160,87,2017,total_driving,NA
T120,T116,Satoshi Kodaira,6,247,234,13,2017,total_driving,NA
T120,T127,Shawn Stefani,6,247,73,174,2017,total_driving,NA
123,106,Carlos Ortiz,8,248,67,181,2017,total_driving,NA
124,T122,Ben Crane,6,249,207,42,2017,total_driving,NA
125,T130,Tom Lewis,3,252,5,247,2017,total_driving,NA
126,T139,Michael Gligic,9,253,73,180,2017,total_driving,NA
T127,T139,Scott Stallings,8,254,47,207,2017,total_driving,NA
T127,T137,Kyle Stanley,8,254,213,41,2017,total_driving,NA
T129,T137,Henrik Stenson,2,255,202,53,2017,total_driving,NA
T129,T125,Austin Cook,8,255,127,128,2017,total_driving,NA
T131,T120,Beau Hossler,8,256,29,227,2017,total_driving,NA
T131,T122,Patrick Rodgers,10,256,26,230,2017,total_driving,NA
T131,T143,Sebastian Cappelen,8,256,30,226,2017,total_driving,NA
T131,T133,Kurt Kitayama,2,256,3,253,2017,total_driving,NA
T131,T77,Vincent Whaley,7,256,103,153,2017,total_driving,NA
T131,T141,Ryan Brehm,10,256,6,250,2017,total_driving,NA
137,T122,Mark Hubbard,10,257,149,108,2017,total_driving,NA
T138,T163,Brandon Hagy,8,258,22,236,2017,total_driving,NA
T138,T109,Billy Horschel,6,258,196,62,2017,total_driving,NA
T140,T147,Sam Burns,6,259,20,239,2017,total_driving,NA
T140,T133,David Lingmerth,5,259,230,29,2017,total_driving,NA
T142,T187,Bud Cauley,6,262,125,137,2017,total_driving,NA
T142,T143,Cameron Tringale,7,262,55,207,2017,total_driving,NA
144,T143,Rikuya Hoshino,2,264,138,126,2017,total_driving,NA
145,T155,Jonathan Byrd,5,265,72,193,2017,total_driving,NA
T146,T116,Maverick McNealy,9,266,89,177,2017,total_driving,NA
T146,T147,Xander Schauffele,3,266,231,35,2017,total_driving,NA
T148,154,Whee Kim,2,267,180,87,2017,total_driving,NA
T148,T141,Lucas Bjerregaard,3,267,18,249,2017,total_driving,NA
150,T152,Chip McDaniel,2,268,59,209,2017,total_driving,NA
T151,T178,Max Homa,6,269,187,82,2017,total_driving,NA
T151,T112,Bill Haas,6,269,147,122,2017,total_driving,NA
T151,146,J.B. Holmes,3,269,224,45,2017,total_driving,NA
T154,129,Zack Sucher,6,270,24,246,2017,total_driving,NA
T154,T157,Roberto Castro,5,270,183,87,2017,total_driving,NA
156,151,Kevin Tway,6,271,27,244,2017,total_driving,NA
T157,T155,Kevin Chappell,6,272,43,229,2017,total_driving,NA
T157,T152,Dominic Bozzelli,7,272,38,234,2017,total_driving,NA
T159,T147,David Hearn,9,273,206,67,2017,total_driving,NA
T159,174,Jimmy Walker,4,273,92,181,2017,total_driving,NA
161,165,Sangmoon Bae,6,274,64,210,2017,total_driving,NA
162,167,Michael Gellerman,8,275,135,140,2017,total_driving,NA
163,T159,Kevin Kisner,7,277,227,50,2017,total_driving,NA
T164,T159,Justin Thomas,5,278,161,117,2017,total_driving,NA
T164,T187,Troy Merritt,7,278,182,96,2017,total_driving,NA
T164,T163,Freddie Jacobson,3,278,141,137,2017,total_driving,NA
167,T175,Talor Gooch,8,280,122,158,2017,total_driving,NA
168,T103,Andrew Putnam,6,283,181,102,2017,total_driving,NA
T169,T157,Si Woo Kim,8,284,99,185,2017,total_driving,NA
T169,T97,Charley Hoffman,7,284,87,197,2017,total_driving,NA
T169,169,Seamus Power,5,284,83,201,2017,total_driving,NA
172,T133,John Huh,5,285,166,119,2017,total_driving,NA
T173,T172,Jason Day,3,286,80,206,2017,total_driving,NA
T173,T172,Chris Kirk,3,286,199,87,2017,total_driving,NA
T173,T175,Rafael Campos,9,286,67,219,2017,total_driving,NA
176,T159,Nate Lashley,8,287,204,83,2017,total_driving,NA
177,177,Brandt Snedeker,4,288,155,133,2017,total_driving,NA
178,T178,Peter Uihlein,6,289,38,251,2017,total_driving,NA
179,150,Kevin Na,7,290,203,87,2017,total_driving,NA
180,T170,Ben Taylor,10,291,134,157,2017,total_driving,NA
181,162,Anirban Lahiri,8,292,118,174,2017,total_driving,NA
182,T208,Roger Sloan,8,293,158,135,2017,total_driving,NA
T183,182,Johnson Wagner,5,294,207,87,2017,total_driving,NA
T183,T183,Robert Garrigus,5,294,52,242,2017,total_driving,NA
T183,T187,Wes Roach,7,294,151,143,2017,total_driving,NA
186,181,Zach Johnson,7,299,216,83,2017,total_driving,NA
187,191,Mikumu Horikawa,3,303,237,66,2017,total_driving,NA
T188,194,Will Gordon,4,304,64,240,2017,total_driving,NA
T188,210,Rory Sabbatini,7,304,219,85,2017,total_driving,NA
T188,T183,Dylan Frittelli,9,304,193,111,2017,total_driving,NA
191,185,Nelson Ledesma,10,305,57,248,2017,total_driving,NA
192,192,Marc Leishman,5,306,90,216,2017,total_driving,NA
193,166,Joseph Bramlett,7,307,94,213,2017,total_driving,NA
194,195,Joaquin Niemann,8,308,164,144,2017,total_driving,NA
T195,T196,Graeme McDowell,5,311,236,75,2017,total_driving,NA
T195,T201,Bronson Burgoon,8,311,130,181,2017,total_driving,NA
197,T187,Brian Gay,9,312,162,150,2017,total_driving,NA
198,193,Rhein Gibson,9,313,90,223,2017,total_driving,NA
199,T196,Tom Hoge,8,314,185,129,2017,total_driving,NA
200,200,Mark Anderson,7,319,132,187,2017,total_driving,NA
201,204,Smylie Kaufman,3,320,64,256,2017,total_driving,NA
T202,199,Zac Blair,10,322,225,97,2017,total_driving,NA
T202,214,Francesco Molinari,3,322,125,197,2017,total_driving,NA
T204,T170,John Senden,5,324,120,204,2017,total_driving,NA
T204,180,Ben Martin,6,324,223,101,2017,total_driving,NA
T206,T205,James Hahn,6,325,163,162,2017,total_driving,NA
T206,186,Aaron Baddeley,6,325,198,127,2017,total_driving,NA
208,T211,J.J. Spaun,9,330,118,212,2017,total_driving,NA
T209,203,Robert Streb,9,332,141,191,2017,total_driving,NA
T209,T208,Robert Allenby,3,332,164,168,2017,total_driving,NA
211,T211,Martin Trainer,8,339,94,245,2017,total_driving,NA
212,T205,"Ted Potter, Jr.",7,340,151,189,2017,total_driving,NA
213,T201,Chris Stroud,6,341,194,147,2017,total_driving,NA
T214,T205,Rob Oppenheim,10,342,200,142,2017,total_driving,NA
T214,198,Matt Every,7,342,122,220,2017,total_driving,NA
T214,213,Morgan Hoffmann,4,342,143,199,2017,total_driving,NA
217,215,Roberto Díaz,2,345,110,235,2017,total_driving,NA
218,216,Stewart Cink,4,350,112,238,2017,total_driving,NA
219,217,C.T. Pan,5,353,189,164,2017,total_driving,NA
220,T218,Patton Kizzire,9,354,158,196,2017,total_driving,NA
221,222,Hudson Swafford,4,356,183,173,2017,total_driving,NA
222,T218,George McNeill,6,359,145,214,2017,total_driving,NA
223,220,Patrick Reed,4,363,239,124,2017,total_driving,NA
224,221,Jamie Lovemark,4,365,114,251,2017,total_driving,NA
225,224,Luke Donald,2,378,232,146,2017,total_driving,NA
226,226,Bo Van Pelt,7,387,155,232,2017,total_driving,NA
227,225,Davis Love III,3,400,172,228,2017,total_driving,NA
228,228,Arjun Atwal,5,404,173,231,2017,total_driving,NA
T229,231,Daniel Chopra,3,411,157,254,2017,total_driving,NA
T229,227,Kevin Stadler,6,411,217,194,2017,total_driving,NA
231,229,John Rollins,4,414,209,205,2017,total_driving,NA
232,230,Parker McLachlin,4,421,201,220,2017,total_driving,NA
233,232,Peter Malnati,9,422,197,225,2017,total_driving,NA
234,233,Michael Kim,8,435,211,224,2017,total_driving,NA
235,235,Tommy Gainey,4,442,209,233,2017,total_driving,NA
236,234,D.A. Points,4,446,226,220,2017,total_driving,NA
237,236,Ricky Barnes,6,451,214,237,2017,total_driving,NA
238,237,Brendon de Jonge,3,462,205,257,2017,total_driving,NA
239,238,Shugo Imahira,2,490,235,255,2017,total_driving,NA
1,1,Andrew Novak,2,35,17,18,2018,total_driving,NA
2,3,Viktor Hovland,4,63,16,47,2018,total_driving,NA
3,4,Chase Koepka,2,72,34,38,2018,total_driving,NA
4,5,John Oda,2,74,70,4,2018,total_driving,NA
5,6,D.J. Trahan,7,91,47,44,2018,total_driving,NA
6,8,Gary Woodland,4,98,94,4,2018,total_driving,NA
7,9,Branden Grace,4,99,21,78,2018,total_driving,NA
T8,10,Patrick Cantlay,3,103,86,17,2018,total_driving,NA
T8,7,Doc Redman,10,103,77,26,2018,total_driving,NA
10,2,Ryan Moore,5,105,94,11,2018,total_driving,NA
11,13,Scottie Scheffler,8,126,15,111,2018,total_driving,NA
12,T19,Kyoung-Hoon Lee,10,128,106,22,2018,total_driving,NA
13,14,Martin Laird,8,129,42,87,2018,total_driving,NA
14,11,Kevin Streelman,9,130,62,68,2018,total_driving,NA
15,25,Jhonattan Vegas,6,132,24,108,2018,total_driving,NA
T16,15,Nick Taylor,8,133,109,24,2018,total_driving,NA
T16,T23,Brendan Steele,8,133,63,70,2018,total_driving,NA
18,12,Harris English,7,135,36,99,2018,total_driving,NA
T19,T27,Harry Higgs,10,140,79,61,2018,total_driving,NA
T19,T27,Sung Kang,7,140,53,87,2018,total_driving,NA
T21,22,Emiliano Grillo,7,142,110,32,2018,total_driving,NA
T21,18,Bubba Watson,4,142,1,141,2018,total_driving,NA
23,T19,Bryson DeChambeau,3,144,13,131,2018,total_driving,NA
24,T52,Matthew Wolff,5,145,40,105,2018,total_driving,NA
25,29,Joel Dahmen,8,149,100,49,2018,total_driving,NA
26,16,Jason Kokrak,5,153,8,145,2018,total_driving,NA
27,17,Josh Teater,6,156,83,73,2018,total_driving,NA
28,T23,Cameron Champ,7,157,2,155,2018,total_driving,NA
29,33,Ryan Palmer,5,160,146,14,2018,total_driving,NA
30,T35,Adam Hadwin,5,164,121,43,2018,total_driving,NA
31,26,Sungjae Im,8,165,50,115,2018,total_driving,NA
32,31,Henrik Norlander,10,168,132,36,2018,total_driving,NA
T33,38,Boo Weekley,5,169,147,22,2018,total_driving,NA
T33,T35,Harold Varner III,7,169,18,151,2018,total_driving,NA
35,37,Lanto Griffin,10,170,40,130,2018,total_driving,NA
36,T19,Lucas Glover,7,174,98,76,2018,total_driving,NA
37,34,Scott Brown,9,175,151,24,2018,total_driving,NA
38,T44,Sebastián Muñoz,10,176,60,116,2018,total_driving,NA
T39,40,Daniel Berger,6,177,56,121,2018,total_driving,NA
T39,42,Keegan Bradley,7,177,71,106,2018,total_driving,NA
41,39,Chesson Hadley,7,179,106,73,2018,total_driving,NA
42,43,Webb Simpson,3,182,170,12,2018,total_driving,NA
43,48,Danny Lee,7,185,9,176,2018,total_driving,NA
44,T50,Pat Perez,6,186,130,56,2018,total_driving,NA
45,T52,Matthew NeSmith,9,188,154,34,2018,total_driving,NA
46,T99,Sepp Straka,10,191,92,99,2018,total_driving,NA
T47,T90,Isaiah Salinda,3,192,14,178,2018,total_driving,NA
T47,T56,John Merrick,4,192,135,57,2018,total_driving,NA
T49,T50,Jim Furyk,3,193,192,1,2018,total_driving,NA
T49,55,Chad Campbell,4,193,178,15,2018,total_driving,NA
T49,T44,Wyndham Clark,7,193,32,161,2018,total_driving,NA
52,32,Alex Noren,4,195,108,87,2018,total_driving,NA
53,NA,Rickie Fowler,2,196,194,2,2018,total_driving,NA
T54,T56,Tony Finau,5,198,12,186,2018,total_driving,NA
T54,T62,Phil Mickelson,5,198,31,167,2018,total_driving,NA
T54,T62,Aaron Wise,7,198,51,147,2018,total_driving,NA
T54,T69,Chase Seiffert,9,198,127,71,2018,total_driving,NA
T58,T73,Abraham Ancer,8,199,113,86,2018,total_driving,NA
T58,61,Adam Schenk,10,199,33,166,2018,total_driving,NA
T58,T64,Scott Harrington,9,199,34,165,2018,total_driving,NA
T61,T52,Brian Harman,8,200,143,57,2018,total_driving,NA
T61,47,Jason Dufner,7,200,140,60,2018,total_driving,NA
T61,59,Cameron Smith,6,200,77,123,2018,total_driving,NA
T64,46,Kramer Hickok,9,201,124,77,2018,total_driving,NA
T64,60,Matt Jones,8,201,49,152,2018,total_driving,NA
66,30,Robby Shelton,10,202,88,114,2018,total_driving,NA
T67,83,Grayson Murray,6,203,4,199,2018,total_driving,NA
T67,T73,Russell Knox,8,203,138,65,2018,total_driving,NA
69,41,Denny McCarthy,8,204,101,103,2018,total_driving,NA
70,T80,Sam Ryder,10,209,53,156,2018,total_driving,NA
71,58,Brice Garnett,8,214,150,64,2018,total_driving,NA
72,66,Michael Thompson,7,215,175,40,2018,total_driving,NA
73,76,Collin Morikawa,6,216,168,48,2018,total_driving,NA
T74,T69,Derek Ernst,4,217,80,137,2018,total_driving,NA
T74,T67,Adam Long,10,217,189,28,2018,total_driving,NA
T74,96,Andrew Landry,9,217,171,46,2018,total_driving,NA
77,T84,Akshay Bhatia,5,218,7,211,2018,total_driving,NA
78,T69,Rod Pampling,3,220,28,192,2018,total_driving,NA
79,136,Nick Watney,7,222,73,149,2018,total_driving,NA
T80,T84,Hideki Matsuyama,6,223,115,108,2018,total_driving,NA
T80,115,Doug Ghim,7,223,116,107,2018,total_driving,NA
T80,T90,Kristoffer Ventura,9,223,44,179,2018,total_driving,NA
T83,T73,Byeong Hun An,8,225,10,215,2018,total_driving,NA
T83,T90,Chandler Phillips,2,225,57,168,2018,total_driving,NA
T83,T69,Brian Stuard,10,225,215,10,2018,total_driving,NA
T83,T97,Alex Cejka,5,225,175,50,2018,total_driving,NA
T83,T80,Ryan Armour,9,225,217,8,2018,total_driving,NA
T88,T90,Graham DeLaet,5,226,36,190,2018,total_driving,NA
T88,T77,Tim Wilkinson,6,226,189,37,2018,total_driving,NA
T88,T86,Brandon Wu,2,226,188,38,2018,total_driving,NA
T91,T88,Hank Lebioda,9,228,104,124,2018,total_driving,NA
T91,79,Charles Howell III,9,228,69,159,2018,total_driving,NA
93,T67,Tyler McCumber,9,229,11,218,2018,total_driving,NA
94,T90,Fabián Gómez,9,230,167,63,2018,total_driving,NA
95,T90,Brendon Todd,11,231,228,3,2018,total_driving,NA
T96,49,Cameron Percy,8,233,61,172,2018,total_driving,NA
T96,T99,Adam Scott,4,233,46,187,2018,total_driving,NA
T96,T80,Luke List,9,233,80,153,2018,total_driving,NA
T96,T86,Russell Henley,8,233,179,54,2018,total_driving,NA
T96,T130,Mackenzie Hughes,8,233,101,132,2018,total_driving,NA
101,T109,J.T. Poston,9,234,175,59,2018,total_driving,NA
102,T64,Vince Covello,8,235,73,162,2018,total_driving,NA
103,T99,Xinjun Zhang,10,236,116,120,2018,total_driving,NA
104,105,K.J. Choi,3,237,233,4,2018,total_driving,NA
T105,107,Tim Herron,4,238,220,18,2018,total_driving,NA
T105,T109,Corey Conners,7,238,186,52,2018,total_driving,NA
T107,108,Keith Mitchell,7,239,135,104,2018,total_driving,NA
T107,T130,Cameron Davis,8,239,22,217,2018,total_driving,NA
T107,T99,Richy Werenski,4,239,45,194,2018,total_driving,NA
T107,T88,Vaughn Taylor,8,239,212,27,2018,total_driving,NA
111,168,Chris Baker,9,240,168,72,2018,total_driving,NA
T112,T112,Jim Herman,8,241,221,20,2018,total_driving,NA
T112,T127,Scott Piercy,8,241,105,136,2018,total_driving,NA
T114,T120,J.J. Henry,5,242,173,69,2018,total_driving,NA
T114,T103,Tyler Duncan,10,242,221,21,2018,total_driving,NA
116,T112,Davis Riley,2,243,83,160,2018,total_driving,NA
T117,T125,Bo Hoag,10,244,127,117,2018,total_driving,NA
T117,T116,Chez Reavie,9,244,228,16,2018,total_driving,NA
119,T116,Matt Kuchar,4,245,238,7,2018,total_driving,NA
T120,223,Paul Casey,4,247,160,87,2018,total_driving,NA
T120,T116,Satoshi Kodaira,6,247,234,13,2018,total_driving,NA
T120,T127,Shawn Stefani,6,247,73,174,2018,total_driving,NA
123,106,Carlos Ortiz,8,248,67,181,2018,total_driving,NA
124,T122,Ben Crane,6,249,207,42,2018,total_driving,NA
125,T130,Tom Lewis,3,252,5,247,2018,total_driving,NA
126,T139,Michael Gligic,9,253,73,180,2018,total_driving,NA
T127,T139,Scott Stallings,8,254,47,207,2018,total_driving,NA
T127,T137,Kyle Stanley,8,254,213,41,2018,total_driving,NA
T129,T137,Henrik Stenson,2,255,202,53,2018,total_driving,NA
T129,T125,Austin Cook,8,255,127,128,2018,total_driving,NA
T131,T120,Beau Hossler,8,256,29,227,2018,total_driving,NA
T131,T122,Patrick Rodgers,10,256,26,230,2018,total_driving,NA
T131,T143,Sebastian Cappelen,8,256,30,226,2018,total_driving,NA
T131,T133,Kurt Kitayama,2,256,3,253,2018,total_driving,NA
T131,T77,Vincent Whaley,7,256,103,153,2018,total_driving,NA
T131,T141,Ryan Brehm,10,256,6,250,2018,total_driving,NA
137,T122,Mark Hubbard,10,257,149,108,2018,total_driving,NA
T138,T163,Brandon Hagy,8,258,22,236,2018,total_driving,NA
T138,T109,Billy Horschel,6,258,196,62,2018,total_driving,NA
T140,T147,Sam Burns,6,259,20,239,2018,total_driving,NA
T140,T133,David Lingmerth,5,259,230,29,2018,total_driving,NA
T142,T187,Bud Cauley,6,262,125,137,2018,total_driving,NA
T142,T143,Cameron Tringale,7,262,55,207,2018,total_driving,NA
144,T143,Rikuya Hoshino,2,264,138,126,2018,total_driving,NA
145,T155,Jonathan Byrd,5,265,72,193,2018,total_driving,NA
T146,T116,Maverick McNealy,9,266,89,177,2018,total_driving,NA
T146,T147,Xander Schauffele,3,266,231,35,2018,total_driving,NA
T148,154,Whee Kim,2,267,180,87,2018,total_driving,NA
T148,T141,Lucas Bjerregaard,3,267,18,249,2018,total_driving,NA
150,T152,Chip McDaniel,2,268,59,209,2018,total_driving,NA
T151,T178,Max Homa,6,269,187,82,2018,total_driving,NA
T151,T112,Bill Haas,6,269,147,122,2018,total_driving,NA
T151,146,J.B. Holmes,3,269,224,45,2018,total_driving,NA
T154,129,Zack Sucher,6,270,24,246,2018,total_driving,NA
T154,T157,Roberto Castro,5,270,183,87,2018,total_driving,NA
156,151,Kevin Tway,6,271,27,244,2018,total_driving,NA
T157,T155,Kevin Chappell,6,272,43,229,2018,total_driving,NA
T157,T152,Dominic Bozzelli,7,272,38,234,2018,total_driving,NA
T159,T147,David Hearn,9,273,206,67,2018,total_driving,NA
T159,174,Jimmy Walker,4,273,92,181,2018,total_driving,NA
161,165,Sangmoon Bae,6,274,64,210,2018,total_driving,NA
162,167,Michael Gellerman,8,275,135,140,2018,total_driving,NA
163,T159,Kevin Kisner,7,277,227,50,2018,total_driving,NA
T164,T159,Justin Thomas,5,278,161,117,2018,total_driving,NA
T164,T187,Troy Merritt,7,278,182,96,2018,total_driving,NA
T164,T163,Freddie Jacobson,3,278,141,137,2018,total_driving,NA
167,T175,Talor Gooch,8,280,122,158,2018,total_driving,NA
168,T103,Andrew Putnam,6,283,181,102,2018,total_driving,NA
T169,T157,Si Woo Kim,8,284,99,185,2018,total_driving,NA
T169,T97,Charley Hoffman,7,284,87,197,2018,total_driving,NA
T169,169,Seamus Power,5,284,83,201,2018,total_driving,NA
172,T133,John Huh,5,285,166,119,2018,total_driving,NA
T173,T172,Jason Day,3,286,80,206,2018,total_driving,NA
T173,T172,Chris Kirk,3,286,199,87,2018,total_driving,NA
T173,T175,Rafael Campos,9,286,67,219,2018,total_driving,NA
176,T159,Nate Lashley,8,287,204,83,2018,total_driving,NA
177,177,Brandt Snedeker,4,288,155,133,2018,total_driving,NA
178,T178,Peter Uihlein,6,289,38,251,2018,total_driving,NA
179,150,Kevin Na,7,290,203,87,2018,total_driving,NA
180,T170,Ben Taylor,10,291,134,157,2018,total_driving,NA
181,162,Anirban Lahiri,8,292,118,174,2018,total_driving,NA
182,T208,Roger Sloan,8,293,158,135,2018,total_driving,NA
T183,182,Johnson Wagner,5,294,207,87,2018,total_driving,NA
T183,T183,Robert Garrigus,5,294,52,242,2018,total_driving,NA
T183,T187,Wes Roach,7,294,151,143,2018,total_driving,NA
186,181,Zach Johnson,7,299,216,83,2018,total_driving,NA
187,191,Mikumu Horikawa,3,303,237,66,2018,total_driving,NA
T188,194,Will Gordon,4,304,64,240,2018,total_driving,NA
T188,210,Rory Sabbatini,7,304,219,85,2018,total_driving,NA
T188,T183,Dylan Frittelli,9,304,193,111,2018,total_driving,NA
191,185,Nelson Ledesma,10,305,57,248,2018,total_driving,NA
192,192,Marc Leishman,5,306,90,216,2018,total_driving,NA
193,166,Joseph Bramlett,7,307,94,213,2018,total_driving,NA
194,195,Joaquin Niemann,8,308,164,144,2018,total_driving,NA
T195,T196,Graeme McDowell,5,311,236,75,2018,total_driving,NA
T195,T201,Bronson Burgoon,8,311,130,181,2018,total_driving,NA
197,T187,Brian Gay,9,312,162,150,2018,total_driving,NA
198,193,Rhein Gibson,9,313,90,223,2018,total_driving,NA
199,T196,Tom Hoge,8,314,185,129,2018,total_driving,NA
200,200,Mark Anderson,7,319,132,187,2018,total_driving,NA
201,204,Smylie Kaufman,3,320,64,256,2018,total_driving,NA
T202,199,Zac Blair,10,322,225,97,2018,total_driving,NA
T202,214,Francesco Molinari,3,322,125,197,2018,total_driving,NA
T204,T170,John Senden,5,324,120,204,2018,total_driving,NA
T204,180,Ben Martin,6,324,223,101,2018,total_driving,NA
T206,T205,James Hahn,6,325,163,162,2018,total_driving,NA
T206,186,Aaron Baddeley,6,325,198,127,2018,total_driving,NA
208,T211,J.J. Spaun,9,330,118,212,2018,total_driving,NA
T209,203,Robert Streb,9,332,141,191,2018,total_driving,NA
T209,T208,Robert Allenby,3,332,164,168,2018,total_driving,NA
211,T211,Martin Trainer,8,339,94,245,2018,total_driving,NA
212,T205,"Ted Potter, Jr.",7,340,151,189,2018,total_driving,NA
213,T201,Chris Stroud,6,341,194,147,2018,total_driving,NA
T214,T205,Rob Oppenheim,10,342,200,142,2018,total_driving,NA
T214,198,Matt Every,7,342,122,220,2018,total_driving,NA
T214,213,Morgan Hoffmann,4,342,143,199,2018,total_driving,NA
217,215,Roberto Díaz,2,345,110,235,2018,total_driving,NA
218,216,Stewart Cink,4,350,112,238,2018,total_driving,NA
219,217,C.T. Pan,5,353,189,164,2018,total_driving,NA
220,T218,Patton Kizzire,9,354,158,196,2018,total_driving,NA
221,222,Hudson Swafford,4,356,183,173,2018,total_driving,NA
222,T218,George McNeill,6,359,145,214,2018,total_driving,NA
223,220,Patrick Reed,4,363,239,124,2018,total_driving,NA
224,221,Jamie Lovemark,4,365,114,251,2018,total_driving,NA
225,224,Luke Donald,2,378,232,146,2018,total_driving,NA
226,226,Bo Van Pelt,7,387,155,232,2018,total_driving,NA
227,225,Davis Love III,3,400,172,228,2018,total_driving,NA
228,228,Arjun Atwal,5,404,173,231,2018,total_driving,NA
T229,231,Daniel Chopra,3,411,157,254,2018,total_driving,NA
T229,227,Kevin Stadler,6,411,217,194,2018,total_driving,NA
231,229,John Rollins,4,414,209,205,2018,total_driving,NA
232,230,Parker McLachlin,4,421,201,220,2018,total_driving,NA
233,232,Peter Malnati,9,422,197,225,2018,total_driving,NA
234,233,Michael Kim,8,435,211,224,2018,total_driving,NA
235,235,Tommy Gainey,4,442,209,233,2018,total_driving,NA
236,234,D.A. Points,4,446,226,220,2018,total_driving,NA
237,236,Ricky Barnes,6,451,214,237,2018,total_driving,NA
238,237,Brendon de Jonge,3,462,205,257,2018,total_driving,NA
239,238,Shugo Imahira,2,490,235,255,2018,total_driving,NA
1,1,Andrew Novak,2,35,17,18,2019,total_driving,NA
2,3,Viktor Hovland,4,63,16,47,2019,total_driving,NA
3,4,Chase Koepka,2,72,34,38,2019,total_driving,NA
4,5,John Oda,2,74,70,4,2019,total_driving,NA
5,6,D.J. Trahan,7,91,47,44,2019,total_driving,NA
6,8,Gary Woodland,4,98,94,4,2019,total_driving,NA
7,9,Branden Grace,4,99,21,78,2019,total_driving,NA
T8,10,Patrick Cantlay,3,103,86,17,2019,total_driving,NA
T8,7,Doc Redman,10,103,77,26,2019,total_driving,NA
10,2,Ryan Moore,5,105,94,11,2019,total_driving,NA
11,13,Scottie Scheffler,8,126,15,111,2019,total_driving,NA
12,T19,Kyoung-Hoon Lee,10,128,106,22,2019,total_driving,NA
13,14,Martin Laird,8,129,42,87,2019,total_driving,NA
14,11,Kevin Streelman,9,130,62,68,2019,total_driving,NA
15,25,Jhonattan Vegas,6,132,24,108,2019,total_driving,NA
T16,15,Nick Taylor,8,133,109,24,2019,total_driving,NA
T16,T23,Brendan Steele,8,133,63,70,2019,total_driving,NA
18,12,Harris English,7,135,36,99,2019,total_driving,NA
T19,T27,Harry Higgs,10,140,79,61,2019,total_driving,NA
T19,T27,Sung Kang,7,140,53,87,2019,total_driving,NA
T21,22,Emiliano Grillo,7,142,110,32,2019,total_driving,NA
T21,18,Bubba Watson,4,142,1,141,2019,total_driving,NA
23,T19,Bryson DeChambeau,3,144,13,131,2019,total_driving,NA
24,T52,Matthew Wolff,5,145,40,105,2019,total_driving,NA
25,29,Joel Dahmen,8,149,100,49,2019,total_driving,NA
26,16,Jason Kokrak,5,153,8,145,2019,total_driving,NA
27,17,Josh Teater,6,156,83,73,2019,total_driving,NA
28,T23,Cameron Champ,7,157,2,155,2019,total_driving,NA
29,33,Ryan Palmer,5,160,146,14,2019,total_driving,NA
30,T35,Adam Hadwin,5,164,121,43,2019,total_driving,NA
31,26,Sungjae Im,8,165,50,115,2019,total_driving,NA
32,31,Henrik Norlander,10,168,132,36,2019,total_driving,NA
T33,38,Boo Weekley,5,169,147,22,2019,total_driving,NA
T33,T35,Harold Varner III,7,169,18,151,2019,total_driving,NA
35,37,Lanto Griffin,10,170,40,130,2019,total_driving,NA
36,T19,Lucas Glover,7,174,98,76,2019,total_driving,NA
37,34,Scott Brown,9,175,151,24,2019,total_driving,NA
38,T44,Sebastián Muñoz,10,176,60,116,2019,total_driving,NA
T39,40,Daniel Berger,6,177,56,121,2019,total_driving,NA
T39,42,Keegan Bradley,7,177,71,106,2019,total_driving,NA
41,39,Chesson Hadley,7,179,106,73,2019,total_driving,NA
42,43,Webb Simpson,3,182,170,12,2019,total_driving,NA
43,48,Danny Lee,7,185,9,176,2019,total_driving,NA
44,T50,Pat Perez,6,186,130,56,2019,total_driving,NA
45,T52,Matthew NeSmith,9,188,154,34,2019,total_driving,NA
46,T99,Sepp Straka,10,191,92,99,2019,total_driving,NA
T47,T90,Isaiah Salinda,3,192,14,178,2019,total_driving,NA
T47,T56,John Merrick,4,192,135,57,2019,total_driving,NA
T49,T50,Jim Furyk,3,193,192,1,2019,total_driving,NA
T49,55,Chad Campbell,4,193,178,15,2019,total_driving,NA
T49,T44,Wyndham Clark,7,193,32,161,2019,total_driving,NA
52,32,Alex Noren,4,195,108,87,2019,total_driving,NA
53,NA,Rickie Fowler,2,196,194,2,2019,total_driving,NA
T54,T56,Tony Finau,5,198,12,186,2019,total_driving,NA
T54,T62,Phil Mickelson,5,198,31,167,2019,total_driving,NA
T54,T62,Aaron Wise,7,198,51,147,2019,total_driving,NA
T54,T69,Chase Seiffert,9,198,127,71,2019,total_driving,NA
T58,T73,Abraham Ancer,8,199,113,86,2019,total_driving,NA
T58,61,Adam Schenk,10,199,33,166,2019,total_driving,NA
T58,T64,Scott Harrington,9,199,34,165,2019,total_driving,NA
T61,T52,Brian Harman,8,200,143,57,2019,total_driving,NA
T61,47,Jason Dufner,7,200,140,60,2019,total_driving,NA
T61,59,Cameron Smith,6,200,77,123,2019,total_driving,NA
T64,46,Kramer Hickok,9,201,124,77,2019,total_driving,NA
T64,60,Matt Jones,8,201,49,152,2019,total_driving,NA
66,30,Robby Shelton,10,202,88,114,2019,total_driving,NA
T67,83,Grayson Murray,6,203,4,199,2019,total_driving,NA
T67,T73,Russell Knox,8,203,138,65,2019,total_driving,NA
69,41,Denny McCarthy,8,204,101,103,2019,total_driving,NA
70,T80,Sam Ryder,10,209,53,156,2019,total_driving,NA
71,58,Brice Garnett,8,214,150,64,2019,total_driving,NA
72,66,Michael Thompson,7,215,175,40,2019,total_driving,NA
73,76,Collin Morikawa,6,216,168,48,2019,total_driving,NA
T74,T69,Derek Ernst,4,217,80,137,2019,total_driving,NA
T74,T67,Adam Long,10,217,189,28,2019,total_driving,NA
T74,96,Andrew Landry,9,217,171,46,2019,total_driving,NA
77,T84,Akshay Bhatia,5,218,7,211,2019,total_driving,NA
78,T69,Rod Pampling,3,220,28,192,2019,total_driving,NA
79,136,Nick Watney,7,222,73,149,2019,total_driving,NA
T80,T84,Hideki Matsuyama,6,223,115,108,2019,total_driving,NA
T80,115,Doug Ghim,7,223,116,107,2019,total_driving,NA
T80,T90,Kristoffer Ventura,9,223,44,179,2019,total_driving,NA
T83,T73,Byeong Hun An,8,225,10,215,2019,total_driving,NA
T83,T90,Chandler Phillips,2,225,57,168,2019,total_driving,NA
T83,T69,Brian Stuard,10,225,215,10,2019,total_driving,NA
T83,T97,Alex Cejka,5,225,175,50,2019,total_driving,NA
T83,T80,Ryan Armour,9,225,217,8,2019,total_driving,NA
T88,T90,Graham DeLaet,5,226,36,190,2019,total_driving,NA
T88,T77,Tim Wilkinson,6,226,189,37,2019,total_driving,NA
T88,T86,Brandon Wu,2,226,188,38,2019,total_driving,NA
T91,T88,Hank Lebioda,9,228,104,124,2019,total_driving,NA
T91,79,Charles Howell III,9,228,69,159,2019,total_driving,NA
93,T67,Tyler McCumber,9,229,11,218,2019,total_driving,NA
94,T90,Fabián Gómez,9,230,167,63,2019,total_driving,NA
95,T90,Brendon Todd,11,231,228,3,2019,total_driving,NA
T96,49,Cameron Percy,8,233,61,172,2019,total_driving,NA
T96,T99,Adam Scott,4,233,46,187,2019,total_driving,NA
T96,T80,Luke List,9,233,80,153,2019,total_driving,NA
T96,T86,Russell Henley,8,233,179,54,2019,total_driving,NA
T96,T130,Mackenzie Hughes,8,233,101,132,2019,total_driving,NA
101,T109,J.T. Poston,9,234,175,59,2019,total_driving,NA
102,T64,Vince Covello,8,235,73,162,2019,total_driving,NA
103,T99,Xinjun Zhang,10,236,116,120,2019,total_driving,NA
104,105,K.J. Choi,3,237,233,4,2019,total_driving,NA
T105,107,Tim Herron,4,238,220,18,2019,total_driving,NA
T105,T109,Corey Conners,7,238,186,52,2019,total_driving,NA
T107,108,Keith Mitchell,7,239,135,104,2019,total_driving,NA
T107,T130,Cameron Davis,8,239,22,217,2019,total_driving,NA
T107,T99,Richy Werenski,4,239,45,194,2019,total_driving,NA
T107,T88,Vaughn Taylor,8,239,212,27,2019,total_driving,NA
111,168,Chris Baker,9,240,168,72,2019,total_driving,NA
T112,T112,Jim Herman,8,241,221,20,2019,total_driving,NA
T112,T127,Scott Piercy,8,241,105,136,2019,total_driving,NA
T114,T120,J.J. Henry,5,242,173,69,2019,total_driving,NA
T114,T103,Tyler Duncan,10,242,221,21,2019,total_driving,NA
116,T112,Davis Riley,2,243,83,160,2019,total_driving,NA
T117,T125,Bo Hoag,10,244,127,117,2019,total_driving,NA
T117,T116,Chez Reavie,9,244,228,16,2019,total_driving,NA
119,T116,Matt Kuchar,4,245,238,7,2019,total_driving,NA
T120,223,Paul Casey,4,247,160,87,2019,total_driving,NA
T120,T116,Satoshi Kodaira,6,247,234,13,2019,total_driving,NA
T120,T127,Shawn Stefani,6,247,73,174,2019,total_driving,NA
123,106,Carlos Ortiz,8,248,67,181,2019,total_driving,NA
124,T122,Ben Crane,6,249,207,42,2019,total_driving,NA
125,T130,Tom Lewis,3,252,5,247,2019,total_driving,NA
126,T139,Michael Gligic,9,253,73,180,2019,total_driving,NA
T127,T139,Scott Stallings,8,254,47,207,2019,total_driving,NA
T127,T137,Kyle Stanley,8,254,213,41,2019,total_driving,NA
T129,T137,Henrik Stenson,2,255,202,53,2019,total_driving,NA
T129,T125,Austin Cook,8,255,127,128,2019,total_driving,NA
T131,T120,Beau Hossler,8,256,29,227,2019,total_driving,NA
T131,T122,Patrick Rodgers,10,256,26,230,2019,total_driving,NA
T131,T143,Sebastian Cappelen,8,256,30,226,2019,total_driving,NA
T131,T133,Kurt Kitayama,2,256,3,253,2019,total_driving,NA
T131,T77,Vincent Whaley,7,256,103,153,2019,total_driving,NA
T131,T141,Ryan Brehm,10,256,6,250,2019,total_driving,NA
137,T122,Mark Hubbard,10,257,149,108,2019,total_driving,NA
T138,T163,Brandon Hagy,8,258,22,236,2019,total_driving,NA
T138,T109,Billy Horschel,6,258,196,62,2019,total_driving,NA
T140,T147,Sam Burns,6,259,20,239,2019,total_driving,NA
T140,T133,David Lingmerth,5,259,230,29,2019,total_driving,NA
T142,T187,Bud Cauley,6,262,125,137,2019,total_driving,NA
T142,T143,Cameron Tringale,7,262,55,207,2019,total_driving,NA
144,T143,Rikuya Hoshino,2,264,138,126,2019,total_driving,NA
145,T155,Jonathan Byrd,5,265,72,193,2019,total_driving,NA
T146,T116,Maverick McNealy,9,266,89,177,2019,total_driving,NA
T146,T147,Xander Schauffele,3,266,231,35,2019,total_driving,NA
T148,154,Whee Kim,2,267,180,87,2019,total_driving,NA
T148,T141,Lucas Bjerregaard,3,267,18,249,2019,total_driving,NA
150,T152,Chip McDaniel,2,268,59,209,2019,total_driving,NA
T151,T178,Max Homa,6,269,187,82,2019,total_driving,NA
T151,T112,Bill Haas,6,269,147,122,2019,total_driving,NA
T151,146,J.B. Holmes,3,269,224,45,2019,total_driving,NA
T154,129,Zack Sucher,6,270,24,246,2019,total_driving,NA
T154,T157,Roberto Castro,5,270,183,87,2019,total_driving,NA
156,151,Kevin Tway,6,271,27,244,2019,total_driving,NA
T157,T155,Kevin Chappell,6,272,43,229,2019,total_driving,NA
T157,T152,Dominic Bozzelli,7,272,38,234,2019,total_driving,NA
T159,T147,David Hearn,9,273,206,67,2019,total_driving,NA
T159,174,Jimmy Walker,4,273,92,181,2019,total_driving,NA
161,165,Sangmoon Bae,6,274,64,210,2019,total_driving,NA
162,167,Michael Gellerman,8,275,135,140,2019,total_driving,NA
163,T159,Kevin Kisner,7,277,227,50,2019,total_driving,NA
T164,T159,Justin Thomas,5,278,161,117,2019,total_driving,NA
T164,T187,Troy Merritt,7,278,182,96,2019,total_driving,NA
T164,T163,Freddie Jacobson,3,278,141,137,2019,total_driving,NA
167,T175,Talor Gooch,8,280,122,158,2019,total_driving,NA
168,T103,Andrew Putnam,6,283,181,102,2019,total_driving,NA
T169,T157,Si Woo Kim,8,284,99,185,2019,total_driving,NA
T169,T97,Charley Hoffman,7,284,87,197,2019,total_driving,NA
T169,169,Seamus Power,5,284,83,201,2019,total_driving,NA
172,T133,John Huh,5,285,166,119,2019,total_driving,NA
T173,T172,Jason Day,3,286,80,206,2019,total_driving,NA
T173,T172,Chris Kirk,3,286,199,87,2019,total_driving,NA
T173,T175,Rafael Campos,9,286,67,219,2019,total_driving,NA
176,T159,Nate Lashley,8,287,204,83,2019,total_driving,NA
177,177,Brandt Snedeker,4,288,155,133,2019,total_driving,NA
178,T178,Peter Uihlein,6,289,38,251,2019,total_driving,NA
179,150,Kevin Na,7,290,203,87,2019,total_driving,NA
180,T170,Ben Taylor,10,291,134,157,2019,total_driving,NA
181,162,Anirban Lahiri,8,292,118,174,2019,total_driving,NA
182,T208,Roger Sloan,8,293,158,135,2019,total_driving,NA
T183,182,Johnson Wagner,5,294,207,87,2019,total_driving,NA
T183,T183,Robert Garrigus,5,294,52,242,2019,total_driving,NA
T183,T187,Wes Roach,7,294,151,143,2019,total_driving,NA
186,181,Zach Johnson,7,299,216,83,2019,total_driving,NA
187,191,Mikumu Horikawa,3,303,237,66,2019,total_driving,NA
T188,194,Will Gordon,4,304,64,240,2019,total_driving,NA
T188,210,Rory Sabbatini,7,304,219,85,2019,total_driving,NA
T188,T183,Dylan Frittelli,9,304,193,111,2019,total_driving,NA
191,185,Nelson Ledesma,10,305,57,248,2019,total_driving,NA
192,192,Marc Leishman,5,306,90,216,2019,total_driving,NA
193,166,Joseph Bramlett,7,307,94,213,2019,total_driving,NA
194,195,Joaquin Niemann,8,308,164,144,2019,total_driving,NA
T195,T196,Graeme McDowell,5,311,236,75,2019,total_driving,NA
T195,T201,Bronson Burgoon,8,311,130,181,2019,total_driving,NA
197,T187,Brian Gay,9,312,162,150,2019,total_driving,NA
198,193,Rhein Gibson,9,313,90,223,2019,total_driving,NA
199,T196,Tom Hoge,8,314,185,129,2019,total_driving,NA
200,200,Mark Anderson,7,319,132,187,2019,total_driving,NA
201,204,Smylie Kaufman,3,320,64,256,2019,total_driving,NA
T202,199,Zac Blair,10,322,225,97,2019,total_driving,NA
T202,214,Francesco Molinari,3,322,125,197,2019,total_driving,NA
T204,T170,John Senden,5,324,120,204,2019,total_driving,NA
T204,180,Ben Martin,6,324,223,101,2019,total_driving,NA
T206,T205,James Hahn,6,325,163,162,2019,total_driving,NA
T206,186,Aaron Baddeley,6,325,198,127,2019,total_driving,NA
208,T211,J.J. Spaun,9,330,118,212,2019,total_driving,NA
T209,203,Robert Streb,9,332,141,191,2019,total_driving,NA
T209,T208,Robert Allenby,3,332,164,168,2019,total_driving,NA
211,T211,Martin Trainer,8,339,94,245,2019,total_driving,NA
212,T205,"Ted Potter, Jr.",7,340,151,189,2019,total_driving,NA
213,T201,Chris Stroud,6,341,194,147,2019,total_driving,NA
T214,T205,Rob Oppenheim,10,342,200,142,2019,total_driving,NA
T214,198,Matt Every,7,342,122,220,2019,total_driving,NA
T214,213,Morgan Hoffmann,4,342,143,199,2019,total_driving,NA
217,215,Roberto Díaz,2,345,110,235,2019,total_driving,NA
218,216,Stewart Cink,4,350,112,238,2019,total_driving,NA
219,217,C.T. Pan,5,353,189,164,2019,total_driving,NA
220,T218,Patton Kizzire,9,354,158,196,2019,total_driving,NA
221,222,Hudson Swafford,4,356,183,173,2019,total_driving,NA
222,T218,George McNeill,6,359,145,214,2019,total_driving,NA
223,220,Patrick Reed,4,363,239,124,2019,total_driving,NA
224,221,Jamie Lovemark,4,365,114,251,2019,total_driving,NA
225,224,Luke Donald,2,378,232,146,2019,total_driving,NA
226,226,Bo Van Pelt,7,387,155,232,2019,total_driving,NA
227,225,Davis Love III,3,400,172,228,2019,total_driving,NA
228,228,Arjun Atwal,5,404,173,231,2019,total_driving,NA
T229,231,Daniel Chopra,3,411,157,254,2019,total_driving,NA
T229,227,Kevin Stadler,6,411,217,194,2019,total_driving,NA
231,229,John Rollins,4,414,209,205,2019,total_driving,NA
232,230,Parker McLachlin,4,421,201,220,2019,total_driving,NA
233,232,Peter Malnati,9,422,197,225,2019,total_driving,NA
234,233,Michael Kim,8,435,211,224,2019,total_driving,NA
235,235,Tommy Gainey,4,442,209,233,2019,total_driving,NA
236,234,D.A. Points,4,446,226,220,2019,total_driving,NA
237,236,Ricky Barnes,6,451,214,237,2019,total_driving,NA
238,237,Brendon de Jonge,3,462,205,257,2019,total_driving,NA
239,238,Shugo Imahira,2,490,235,255,2019,total_driving,NA
NA,1,Jeff Brehaut,34,79,62,17,2004,total_driving,TRUE
NA,2,John Senden,28,94,23,71,2004,total_driving,NA
NA,T3,Lucas Glover,30,99,6,93,2004,total_driving,NA
NA,T3,Ted Purdy,35,99,76,23,2004,total_driving,NA
NA,T5,Joe Durant,26,101,97,4,2004,total_driving,NA
NA,T5,J.J. Henry,30,101,10,91,2004,total_driving,NA
NA,7,Jason Bohn,29,110,41,69,2004,total_driving,NA
NA,8,Craig Barlow,25,111,61,50,2004,total_driving,NA
NA,9,Brian Bateman,24,113,48,65,2004,total_driving,NA
NA,10,Bo Van Pelt,30,114,36,78,2004,total_driving,NA
NA,11,Robert Allenby,26,116,34,82,2004,total_driving,NA
NA,12,Harrison Frazar,25,117,18,99,2004,total_driving,NA
NA,13,Jay Williamson,33,118,85,33,2004,total_driving,NA
NA,T14,Cameron Beckman,30,121,59,62,2004,total_driving,NA
NA,T14,Geoff Ogilvy,26,121,7,114,2004,total_driving,NA
NA,T16,Scott McCarron,27,123,39,84,2004,total_driving,NA
NA,T16,Joey Sindelar,31,123,53,70,2004,total_driving,NA
NA,18,Vaughn Taylor,27,125,46,79,2004,total_driving,NA
NA,19,Tom Lehman,19,126,97,29,2004,total_driving,NA
NA,20,Mike Heinen,17,127,4,123,2004,total_driving,NA
NA,21,Zach Johnson,30,128,113,15,2004,total_driving,NA
NA,22,Roland Thatcher,23,129,43,86,2004,total_driving,NA
NA,23,Kent Jones,32,130,103,27,2004,total_driving,NA
NA,24,Pat Perez,32,134,54,80,2004,total_driving,NA
NA,25,John Rollins,29,137,101,36,2004,total_driving,NA
NA,26,Billy Mayfair,32,140,118,22,2004,total_driving,NA
NA,27,Notah Begay III,23,141,110,31,2004,total_driving,NA
NA,28,Ryan Palmer,33,142,29,113,2004,total_driving,NA
NA,29,Brent Geiberger,31,143,56,87,2004,total_driving,NA
NA,T30,Bart Bryant,23,145,138,7,2004,total_driving,NA
NA,T30,Steve Elkington,20,145,100,45,2004,total_driving,NA
NA,32,Mark Calcavecchia,24,148,56,92,2004,total_driving,NA
NA,33,Olin Browne,30,150,142,8,2004,total_driving,NA
NA,34,Phil Mickelson,22,151,30,121,2004,total_driving,NA
NA,T35,Jonathan Kaye,25,152,62,90,2004,total_driving,NA
NA,T35,Mark Wilson,19,152,138,14,2004,total_driving,NA
NA,T37,Frank Lickliter II,27,154,94,60,2004,total_driving,NA
NA,T37,Kenny Perry,23,154,26,128,2004,total_driving,NA
NA,39,Matt Gogel,25,155,113,42,2004,total_driving,NA
NA,T40,Briny Baird,30,156,73,83,2004,total_driving,NA
NA,T40,J.L. Lewis,32,156,83,73,2004,total_driving,NA
NA,T40,Rocco Mediate,19,156,131,25,2004,total_driving,NA
NA,T40,Tom Pernice Jr.,31,156,109,47,2004,total_driving,NA
NA,T40,Duffy Waldorf,26,156,116,40,2004,total_driving,NA
NA,45,Arron Oberholser,23,159,122,37,2004,total_driving,NA
NA,46,Rich Beem,28,160,22,138,2004,total_driving,NA
NA,T47,Chris Smith,33,161,5,156,2004,total_driving,NA
NA,T47,Kevin Sutherland,27,161,105,56,2004,total_driving,NA
NA,T47,Hidemichi Tanaka,27,161,150,11,2004,total_driving,NA
NA,T50,Jonathan Byrd,27,162,28,134,2004,total_driving,NA
NA,T50,Robert Gamez,31,162,85,77,2004,total_driving,NA
NA,T52,Dennis Paulson,21,163,14,149,2004,total_driving,NA
NA,T52,Vijay Singh,29,163,13,150,2004,total_driving,NA
NA,T54,Retief Goosen,16,164,38,126,2004,total_driving,NA
NA,T54,Brian Kortan,24,164,47,117,2004,total_driving,NA
NA,T56,Richard Johnson,32,165,131,34,2004,total_driving,NA
NA,T56,Davis Love III,24,165,14,151,2004,total_driving,NA
NA,58,Stuart Appleby,25,167,42,125,2004,total_driving,NA
NA,59,Woody Austin,29,168,56,112,2004,total_driving,NA
NA,60,D.J. Brigman,27,169,65,104,2004,total_driving,NA
NA,T61,Steve Allan,33,170,11,159,2004,total_driving,NA
NA,T61,Stephen Ames,27,170,89,81,2004,total_driving,NA
NA,T61,David Branshaw,30,170,110,60,2004,total_driving,NA
NA,T61,John Huston,20,170,103,67,2004,total_driving,NA
NA,65,José Coceres,20,172,166,6,2004,total_driving,NA
NA,66,Mark Hensby,29,173,122,51,2004,total_driving,NA
NA,T67,Heath Slocum,31,175,157,18,2004,total_driving,NA
NA,T67,Scott Verplank,24,175,173,2,2004,total_driving,NA
NA,69,Hunter Mahan,30,176,45,131,2004,total_driving,NA
NA,70,Charles Howell III,30,177,82,95,2004,total_driving,NA
NA,71,Kris Cox,26,178,16,162,2004,total_driving,NA
NA,T72,Glen Day,33,179,107,72,2004,total_driving,NA
NA,T72,Kirk Triplett,24,179,167,12,2004,total_driving,NA
NA,T74,Tim Clark,26,181,168,13,2004,total_driving,NA
NA,T74,Roger Tambellini,28,181,21,160,2004,total_driving,NA
NA,T76,Jeff Maggert,20,183,148,35,2004,total_driving,NA
NA,T76,Hirofumi Miyase,27,183,163,20,2004,total_driving,NA
NA,78,Deane Pappas,22,184,32,152,2004,total_driving,NA
NA,79,Andre Stolz,20,185,20,165,2004,total_driving,NA
NA,80,Justin Leonard,25,187,134,53,2004,total_driving,NA
NA,81,Scott Simpson,18,188,169,19,2004,total_driving,NA
NA,T82,Chad Campbell,28,189,87,102,2004,total_driving,NA
NA,T82,Chris Couch,24,189,8,181,2004,total_driving,NA
NA,T82,Matt Kuchar,28,189,94,95,2004,total_driving,NA
NA,T85,Scott Hend,29,191,2,189,2004,total_driving,NA
NA,T85,Skip Kendall,29,191,146,45,2004,total_driving,NA
NA,T85,Patrick Sheehan,33,191,72,119,2004,total_driving,NA
NA,T85,Tiger Woods,19,191,9,182,2004,total_driving,NA
NA,T89,Luke Donald,21,192,162,30,2004,total_driving,NA
NA,T89,Jason Dufner,28,192,65,127,2004,total_driving,NA
NA,T89,Scott Hoch,17,192,154,38,2004,total_driving,NA
NA,T89,Tag Ridings,18,192,12,180,2004,total_driving,NA
NA,T93,Fred Funk,29,193,192,1,2004,total_driving,NA
NA,T93,Jerry Kelly,29,193,172,21,2004,total_driving,NA
NA,T95,Tom Byrum,25,195,190,5,2004,total_driving,NA
NA,T95,Daniel Chopra,33,195,26,169,2004,total_driving,NA
NA,T95,John Daly,22,195,3,192,2004,total_driving,NA
NA,T98,Craig Bowden,30,196,193,3,2004,total_driving,NA
NA,T98,Peter Lonard,23,196,54,142,2004,total_driving,NA
NA,T98,Kevin Na,32,196,157,39,2004,total_driving,NA
NA,T101,Hank Kuehne,30,197,1,196,2004,total_driving,NA
NA,T101,Dicky Pride,23,197,153,44,2004,total_driving,NA
NA,T103,Tommy Armour III,28,199,70,129,2004,total_driving,NA
NA,T103,Danny Briggs,28,199,125,74,2004,total_driving,NA
NA,T105,Fred Couples,16,201,35,166,2004,total_driving,NA
NA,T105,Omar Uresti,28,201,191,10,2004,total_driving,NA
NA,T107,Robert Damron,28,202,178,24,2004,total_driving,NA
NA,T107,Spike McRoy,33,202,145,57,2004,total_driving,NA
NA,T109,John Cook,19,203,194,9,2004,total_driving,NA
NA,T109,J.P. Hayes,27,203,152,51,2004,total_driving,NA
NA,T111,Ernie Els,16,204,19,185,2004,total_driving,NA
NA,T111,Sergio Garcia,18,204,33,171,2004,total_driving,NA
NA,T111,Rod Pampling,26,204,50,154,2004,total_driving,NA
NA,T111,Adam Scott,16,204,30,174,2004,total_driving,NA
NA,115,Tim Petrovic,32,205,97,108,2004,total_driving,NA
NA,116,Rich Barcelo,26,206,43,163,2004,total_driving,NA
NA,117,Pat Bates,32,207,181,26,2004,total_driving,NA
NA,T118,Darren Clarke,16,208,78,130,2004,total_driving,NA
NA,T118,Justin Rose,22,208,65,143,2004,total_driving,NA
NA,T120,Shaun Micheel,27,209,93,116,2004,total_driving,NA
NA,T120,Rory Sabbatini,26,209,48,161,2004,total_driving,NA
NA,T122,Tom Carter,35,210,24,186,2004,total_driving,NA
NA,T122,Alex Cejka,24,210,110,100,2004,total_driving,NA
NA,124,Carl Pettersson,28,211,64,147,2004,total_driving,NA
NA,T125,Guy Boros,24,212,149,63,2004,total_driving,NA
NA,T125,Jay Delsing,26,212,79,133,2004,total_driving,NA
NA,T125,Brenden Pappas,34,212,17,195,2004,total_driving,NA
NA,T125,Corey Pavin,23,212,196,16,2004,total_driving,NA
NA,T129,Tim Herron,26,213,40,173,2004,total_driving,NA
NA,T129,Jeff Sluman,28,213,165,48,2004,total_driving,NA
NA,131,Brett Quigley,31,214,37,177,2004,total_driving,NA
NA,132,Steve Pate,24,216,128,88,2004,total_driving,NA
NA,T133,Chris DiMarco,27,217,176,41,2004,total_driving,NA
NA,T133,Niclas Fasth,22,217,77,140,2004,total_driving,NA
NA,T135,Ben Crane,27,219,125,94,2004,total_driving,NA
NA,T135,Dan Olsen,31,219,25,194,2004,total_driving,NA
NA,T137,Mathias Grönberg,32,220,50,170,2004,total_driving,NA
NA,T137,David Morland IV,27,220,188,32,2004,total_driving,NA
NA,T137,Gene Sauers,30,220,156,64,2004,total_driving,NA
NA,T140,Arjun Atwal,30,221,73,148,2004,total_driving,NA
NA,T140,Danny Ellis,26,221,101,120,2004,total_driving,NA
NA,T142,Stephen Leaney,24,223,135,88,2004,total_driving,NA
NA,T142,Loren Roberts,22,223,195,28,2004,total_driving,NA
NA,144,Joe Ogilvie,32,224,79,145,2004,total_driving,NA
NA,T145,Carlos Franco,27,227,69,158,2004,total_driving,NA
NA,T145,Neal Lancaster,33,227,52,175,2004,total_driving,NA
NA,T145,Len Mattiace,25,227,173,54,2004,total_driving,NA
NA,T148,Dudley Hart,23,228,113,115,2004,total_driving,NA
NA,T148,David Toms,24,228,117,111,2004,total_driving,NA
NA,150,Steve Flesch,31,229,161,68,2004,total_driving,NA
NA,151,Russ Cochran,25,230,155,75,2004,total_driving,NA
NA,T152,Nick Price,15,231,188,43,2004,total_driving,NA
NA,T152,Esteban Toledo,36,231,182,49,2004,total_driving,NA
NA,154,Greg Chalmers,22,233,94,139,2004,total_driving,NA
NA,T155,Bob Burns,30,235,180,55,2004,total_driving,NA
NA,T155,Ben Curtis,20,235,138,97,2004,total_driving,NA
NA,157,Stewart Cink,28,238,70,168,2004,total_driving,NA
NA,T158,Michael Allen,28,239,60,179,2004,total_driving,NA
NA,T158,Lee Janzen,25,239,107,132,2004,total_driving,NA
NA,T158,Mike Weir,22,239,138,101,2004,total_driving,NA
NA,T161,Dan Forsman,28,240,142,98,2004,total_driving,NA
NA,T161,Grant Waite,29,240,83,157,2004,total_driving,NA
NA,T163,Tripp Isenhour,22,242,106,136,2004,total_driving,NA
NA,T163,Jesper Parnevik,24,242,89,153,2004,total_driving,NA
NA,165,Mark Brooks,31,243,184,59,2004,total_driving,NA
NA,166,Mark O'Meara,17,245,187,58,2004,total_driving,NA
NA,T167,Brian Gay,32,248,163,85,2004,total_driving,NA
NA,T167,Kevin Muncrief,21,248,65,183,2004,total_driving,NA
NA,T169,Steve Lowery,28,251,79,172,2004,total_driving,NA
NA,T169,David Peoples,26,251,146,105,2004,total_driving,NA
NA,171,David Frost,26,252,186,66,2004,total_driving,NA
NA,T172,Cliff Kresge,33,253,131,122,2004,total_driving,NA
NA,T172,Dean Wilson,33,253,136,117,2004,total_driving,NA
NA,174,Jay Haas,23,259,183,76,2004,total_driving,NA
NA,175,Bernhard Langer,15,260,136,124,2004,total_driving,NA
NA,T176,Blaine McCallister,27,261,151,110,2004,total_driving,NA
NA,T176,Craig Perks,27,261,73,188,2004,total_driving,NA
NA,T178,Shigeki Maruyama,26,264,157,107,2004,total_driving,NA
NA,T178,John Riegger,17,264,120,144,2004,total_driving,NA
NA,180,K.J. Choi,24,266,120,146,2004,total_driving,NA
NA,181,Bob Estes,23,272,170,102,2004,total_driving,NA
NA,182,Freddie Jacobson,24,273,89,184,2004,total_driving,NA
NA,183,Bob Tway,26,275,170,105,2004,total_driving,NA
NA,184,Aaron Baddeley,27,278,87,191,2004,total_driving,NA
NA,185,Tommy Tolles,25,282,92,190,2004,total_driving,NA
NA,186,Billy Andrade,31,283,128,155,2004,total_driving,NA
NA,187,Ken Duke,30,287,124,163,2004,total_driving,NA
NA,188,Craig Parry,16,288,179,109,2004,total_driving,NA
NA,189,Todd Fischer,33,294,157,137,2004,total_driving,NA
NA,T190,Paul Azinger,23,295,119,176,2004,total_driving,NA
NA,T190,Todd Hamilton,27,295,128,167,2004,total_driving,NA
NA,192,Chris Riley,23,311,176,135,2004,total_driving,NA
NA,193,David Gossett,25,312,125,187,2004,total_driving,NA
NA,194,Brad Faxon,28,326,185,141,2004,total_driving,NA
NA,195,Steve Stricker,27,337,144,193,2004,total_driving,NA
NA,196,José María Olazábal,17,353,175,178,2004,total_driving,NA
NA,1,David Hearn,24,72,45,27,2005,total_driving,TRUE
NA,2,Kenny Perry,23,98,9,89,2005,total_driving,NA
NA,3,Harrison Frazar,31,104,17,87,2005,total_driving,NA
NA,4,Joe Durant,25,105,92,13,2005,total_driving,NA
NA,5,Charles Warren,31,106,27,79,2005,total_driving,NA
NA,6,Mathias Grönberg,19,108,15,93,2005,total_driving,NA
NA,7,Bradley Hughes,20,113,75,38,2005,total_driving,NA
NA,8,Joey Snyder III,31,118,68,50,2005,total_driving,NA
NA,9,Billy Mayfair,31,125,103,22,2005,total_driving,NA
NA,10,John Senden,29,131,77,54,2005,total_driving,NA
NA,11,Will MacKenzie,25,132,20,112,2005,total_driving,NA
NA,T12,Zach Johnson,30,133,86,47,2005,total_driving,NA
NA,T12,Michael Long,26,133,29,104,2005,total_driving,NA
NA,T12,John Rollins,30,133,49,84,2005,total_driving,NA
NA,15,Jeff Brehaut,23,134,114,20,2005,total_driving,NA
NA,T16,D.J. Brigman,26,136,42,94,2005,total_driving,NA
NA,T16,Ted Purdy,34,136,45,91,2005,total_driving,NA
NA,T16,Justin Rose,28,136,51,85,2005,total_driving,NA
NA,19,Roland Thatcher,26,137,67,70,2005,total_driving,NA
NA,20,Mark Calcavecchia,27,140,91,49,2005,total_driving,NA
NA,21,Robert Allenby,31,142,33,109,2005,total_driving,NA
NA,22,Briny Baird,33,143,100,43,2005,total_driving,NA
NA,23,Joey Sindelar,29,144,113,31,2005,total_driving,NA
NA,T24,Richard Johnson,16,145,117,28,2005,total_driving,NA
NA,T24,Jonathan Kaye,24,145,80,65,2005,total_driving,NA
NA,26,Sean O'Hair,29,150,23,127,2005,total_driving,NA
NA,T27,Lucas Glover,28,151,12,139,2005,total_driving,NA
NA,T27,J.L. Lewis,30,151,71,80,2005,total_driving,NA
NA,T27,Jeff Maggert,25,151,135,16,2005,total_driving,NA
NA,T30,Bart Bryant,26,153,147,6,2005,total_driving,NA
NA,T30,Alex Cejka,31,153,114,39,2005,total_driving,NA
NA,32,Bo Van Pelt,33,157,59,98,2005,total_driving,NA
NA,T33,Craig Barlow,26,159,88,71,2005,total_driving,NA
NA,T33,D.J. Trahan,28,159,41,118,2005,total_driving,NA
NA,35,John Huston,31,161,56,105,2005,total_driving,NA
NA,T36,Vaughn Taylor,32,162,84,78,2005,total_driving,NA
NA,T36,David Toms,25,162,107,55,2005,total_driving,NA
NA,T38,Brian Davis,23,163,155,8,2005,total_driving,NA
NA,T38,Marco Dawson,23,163,63,100,2005,total_driving,NA
NA,T38,Sergio Garcia,20,163,10,153,2005,total_driving,NA
NA,T38,Kent Jones,32,163,102,61,2005,total_driving,NA
NA,T42,Vijay Singh,30,164,16,148,2005,total_driving,NA
NA,T42,Lee Westwood,15,164,38,126,2005,total_driving,NA
NA,T44,Tommy Armour III,29,165,112,53,2005,total_driving,NA
NA,T44,K.J. Choi,24,165,98,67,2005,total_driving,NA
NA,T44,Paul Claxton,29,165,153,12,2005,total_driving,NA
NA,T44,J.J. Henry,32,165,34,131,2005,total_driving,NA
NA,T44,Chris Smith,32,165,18,147,2005,total_driving,NA
NA,T44,Darron Stiles,26,165,142,23,2005,total_driving,NA
NA,T50,Rocco Mediate,24,168,108,60,2005,total_driving,NA
NA,T50,D.A. Points,33,168,82,86,2005,total_driving,NA
NA,T50,Kevin Stadler,33,168,23,145,2005,total_driving,NA
NA,T50,Scott Verplank,25,168,159,9,2005,total_driving,NA
NA,T54,Scott Gutschewski,27,169,4,165,2005,total_driving,NA
NA,T54,Jay Williamson,16,169,155,14,2005,total_driving,NA
NA,T56,Geoff Ogilvy,26,170,31,139,2005,total_driving,NA
NA,T56,Heath Slocum,29,170,159,11,2005,total_driving,NA
NA,58,Duffy Waldorf,28,172,149,23,2005,total_driving,NA
NA,T59,Stuart Appleby,25,174,19,155,2005,total_driving,NA
NA,T59,Davis Love III,24,174,8,166,2005,total_driving,NA
NA,61,Jason Bohn,28,175,62,113,2005,total_driving,NA
NA,T62,Chad Campbell,27,176,52,124,2005,total_driving,NA
NA,T62,Kevin Sutherland,26,176,108,68,2005,total_driving,NA
NA,64,Olin Browne,29,177,173,4,2005,total_driving,NA
NA,T65,Tom Pernice Jr.,32,179,80,99,2005,total_driving,NA
NA,T65,Hidemichi Tanaka,34,179,150,29,2005,total_driving,NA
NA,67,Arjun Atwal,17,180,50,130,2005,total_driving,NA
NA,68,Nick Watney,31,182,28,154,2005,total_driving,NA
NA,T69,Cameron Beckman,31,183,120,63,2005,total_driving,NA
NA,T69,Steve Lowery,32,183,77,106,2005,total_driving,NA
NA,T69,Hunter Mahan,34,183,55,128,2005,total_driving,NA
NA,T72,Mark Hensby,21,185,83,102,2005,total_driving,NA
NA,T72,Brett Wetterich,28,185,3,182,2005,total_driving,NA
NA,T74,Rod Pampling,26,186,40,146,2005,total_driving,NA
NA,T74,Mario Tiziani,23,186,122,64,2005,total_driving,NA
NA,T76,Brian Bateman,32,187,76,111,2005,total_driving,NA
NA,T76,Tim Herron,28,187,65,122,2005,total_driving,NA
NA,T76,Phil Mickelson,21,187,26,161,2005,total_driving,NA
NA,T76,Greg Owen,24,187,71,116,2005,total_driving,NA
NA,T80,Jonathan Byrd,31,188,37,151,2005,total_driving,NA
NA,T80,Jerry Kelly,31,188,155,33,2005,total_driving,NA
NA,82,Brandt Jobe,27,189,11,178,2005,total_driving,NA
NA,83,Tjaart van der Walt,19,190,140,50,2005,total_driving,NA
NA,T84,José Coceres,22,191,184,7,2005,total_driving,NA
NA,T84,Robert Damron,28,191,181,10,2005,total_driving,NA
NA,T86,Arron Oberholser,21,193,145,48,2005,total_driving,NA
NA,T86,Tiger Woods,21,193,2,191,2005,total_driving,NA
NA,T88,Steve Allan,32,194,32,162,2005,total_driving,NA
NA,T88,Omar Uresti,27,194,191,3,2005,total_driving,NA
NA,90,Matt Kuchar,21,195,170,25,2005,total_driving,NA
NA,T91,Ryan Palmer,32,196,47,149,2005,total_driving,NA
NA,T91,Bob Tway,26,196,114,82,2005,total_driving,NA
NA,93,Tom Lehman,20,197,121,76,2005,total_driving,NA
NA,T94,Tim Clark,26,199,140,59,2005,total_driving,NA
NA,T94,Fred Funk,30,199,197,2,2005,total_driving,NA
NA,T94,Brendan Jones,28,199,14,185,2005,total_driving,NA
NA,T94,Adam Scott,19,199,23,176,2005,total_driving,NA
NA,98,Phillip Price,25,200,142,58,2005,total_driving,NA
NA,T99,Doug Barron,24,201,175,26,2005,total_driving,NA
NA,T99,Steve Elkington,20,201,145,56,2005,total_driving,NA
NA,T99,Retief Goosen,18,201,44,157,2005,total_driving,NA
NA,T102,Jim Furyk,26,202,170,32,2005,total_driving,NA
NA,T102,Jeff Hart,23,202,201,1,2005,total_driving,NA
NA,T102,Skip Kendall,32,202,187,15,2005,total_driving,NA
NA,T102,Justin Leonard,24,202,128,74,2005,total_driving,NA
NA,106,Scott Hend,28,203,1,202,2005,total_driving,NA
NA,T107,Frank Lickliter II,33,204,103,101,2005,total_driving,NA
NA,T107,Brenden Pappas,15,204,6,198,2005,total_driving,NA
NA,T107,Kirk Triplett,18,204,187,17,2005,total_driving,NA
NA,T110,Gavin Coles,22,205,200,5,2005,total_driving,NA
NA,T110,John Daly,25,205,5,200,2005,total_driving,NA
NA,T110,Tom Gillis,28,205,133,72,2005,total_driving,NA
NA,T110,Pat Perez,28,205,68,137,2005,total_driving,NA
NA,T110,Carl Pettersson,34,205,70,135,2005,total_driving,NA
NA,115,Hank Kuehne,30,206,7,199,2005,total_driving,NA
NA,116,Robert Gamez,28,208,162,46,2005,total_driving,NA
NA,T117,John Elliott,25,209,13,196,2005,total_driving,NA
NA,T117,Tag Ridings,31,209,20,189,2005,total_driving,NA
NA,119,Luke Donald,18,210,135,75,2005,total_driving,NA
NA,120,Larry Mize,18,211,192,19,2005,total_driving,NA
NA,T121,Tom Byrum,27,213,195,18,2005,total_driving,NA
NA,T121,Fred Couples,22,213,39,174,2005,total_driving,NA
NA,T121,Peter Lonard,27,213,93,120,2005,total_driving,NA
NA,T124,Jim Carter,25,215,185,30,2005,total_driving,NA
NA,T124,Dan Forsman,17,215,52,163,2005,total_driving,NA
NA,T124,Shaun Micheel,29,215,101,114,2005,total_driving,NA
NA,T124,Mark Wilson,25,215,174,41,2005,total_driving,NA
NA,T128,John Cook,26,217,196,21,2005,total_driving,NA
NA,T128,Neal Lancaster,31,217,58,159,2005,total_driving,NA
NA,T128,Stephen Leaney,29,217,182,35,2005,total_driving,NA
NA,T131,Scott McCarron,24,218,77,141,2005,total_driving,NA
NA,T131,Dennis Paulson,24,218,30,188,2005,total_driving,NA
NA,T131,Jeff Sluman,28,218,176,42,2005,total_driving,NA
NA,T131,Dean Wilson,27,218,152,66,2005,total_driving,NA
NA,T135,Bob Estes,25,219,142,77,2005,total_driving,NA
NA,T135,Shigeki Maruyama,29,219,98,121,2005,total_driving,NA
NA,137,Jason Allred,29,221,20,201,2005,total_driving,NA
NA,T138,Danny Briggs,29,222,185,37,2005,total_driving,NA
NA,T138,Daniel Chopra,34,222,35,187,2005,total_driving,NA
NA,T138,Chris Riley,25,222,178,44,2005,total_driving,NA
NA,T138,Rory Sabbatini,26,222,36,186,2005,total_driving,NA
NA,142,Carlos Franco,25,223,48,175,2005,total_driving,NA
NA,143,Steve Jones,20,224,167,57,2005,total_driving,NA
NA,144,Glen Day,27,225,118,107,2005,total_driving,NA
NA,145,Todd Hamilton,31,227,110,117,2005,total_driving,NA
NA,146,Charles Howell III,29,228,56,172,2005,total_driving,NA
NA,T147,Paul Gow,27,230,178,52,2005,total_driving,NA
NA,T147,Brett Quigley,31,230,59,171,2005,total_driving,NA
NA,T147,Patrick Sheehan,35,230,96,134,2005,total_driving,NA
NA,150,Loren Roberts,18,231,197,34,2005,total_driving,NA
NA,151,Jesper Parnevik,24,232,64,168,2005,total_driving,NA
NA,152,Brian Gay,33,233,193,40,2005,total_driving,NA
NA,T153,Matt Davidson,20,234,165,69,2005,total_driving,NA
NA,T153,Bill Glasson,21,234,139,95,2005,total_driving,NA
NA,T153,Joe Ogilvie,30,234,131,103,2005,total_driving,NA
NA,T156,Woody Austin,30,235,93,142,2005,total_driving,NA
NA,T156,Mark Brooks,28,235,199,36,2005,total_driving,NA
NA,T156,Steve Flesch,30,235,138,97,2005,total_driving,NA
NA,159,James Driscoll,26,237,42,195,2005,total_driving,NA
NA,160,Ian Poulter,20,239,132,107,2005,total_driving,NA
NA,161,Mike Weir,23,240,158,82,2005,total_driving,NA
NA,T162,Billy Andrade,26,241,151,90,2005,total_driving,NA
NA,T162,Bob Heintz,24,241,71,170,2005,total_driving,NA
NA,164,Padraig Harrington,15,243,54,189,2005,total_driving,NA
NA,T165,Ben Crane,21,244,61,183,2005,total_driving,NA
NA,T165,Charlie Wi,23,244,129,115,2005,total_driving,NA
NA,T167,Hunter Haas,28,247,88,159,2005,total_driving,NA
NA,T167,Corey Pavin,23,247,202,45,2005,total_driving,NA
NA,169,Jay Haas,16,249,187,62,2005,total_driving,NA
NA,170,Dudley Hart,29,250,127,123,2005,total_driving,NA
NA,T171,Justin Bolli,24,252,96,156,2005,total_driving,NA
NA,T171,Ryuji Imada,25,252,85,167,2005,total_driving,NA
NA,173,Stephen Ames,24,254,122,132,2005,total_driving,NA
NA,174,Michael Allen,30,257,65,192,2005,total_driving,NA
NA,T175,Chris Anderson,25,258,177,81,2005,total_driving,NA
NA,T175,Ben Curtis,24,258,170,88,2005,total_driving,NA
NA,T175,Brent Geiberger,21,258,162,96,2005,total_driving,NA
NA,T175,Glen Hnatiuk,21,258,148,110,2005,total_driving,NA
NA,179,Todd Fischer,35,260,187,73,2005,total_driving,NA
NA,T180,Matt Gogel,28,261,169,92,2005,total_driving,NA
NA,T180,José María Olazábal,16,261,103,158,2005,total_driving,NA
NA,182,Bernhard Langer,19,262,93,169,2005,total_driving,NA
NA,183,Hideto Tanihara,20,264,135,129,2005,total_driving,NA
NA,184,Freddie Jacobson,23,266,90,176,2005,total_driving,NA
NA,T185,Aaron Baddeley,27,268,74,194,2005,total_driving,NA
NA,T185,Andrew Magee,29,268,87,181,2005,total_driving,NA
NA,T187,Paul Azinger,22,269,133,136,2005,total_driving,NA
NA,T187,Stewart Cink,26,269,126,143,2005,total_driving,NA
NA,189,Rich Beem,26,270,106,164,2005,total_driving,NA
NA,190,Kevin Na,32,285,167,118,2005,total_driving,NA
NA,191,Chris DiMarco,24,289,164,125,2005,total_driving,NA
NA,192,Thomas Levet,20,290,110,180,2005,total_driving,NA
NA,T193,J.P. Hayes,22,297,153,144,2005,total_driving,NA
NA,T193,Tim Petrovic,32,297,118,179,2005,total_driving,NA
NA,195,Lee Janzen,26,309,125,184,2005,total_driving,NA
NA,196,Craig Perks,27,315,122,193,2005,total_driving,NA
NA,197,Mark O'Meara,21,316,183,133,2005,total_driving,NA
NA,198,Rob Rashell,25,318,166,152,2005,total_driving,NA
NA,199,Steve Stricker,21,326,129,197,2005,total_driving,NA
NA,200,Len Mattiace,34,328,178,150,2005,total_driving,NA
NA,T201,Brad Faxon,23,332,194,138,2005,total_driving,NA
NA,T201,Franklin Langham,31,332,159,173,2005,total_driving,NA
NA,1,Scott Gutschewski,19,83,11,72,2006,total_driving,TRUE
NA,2,Chris Smith,21,84,24,60,2006,total_driving,NA
NA,3,Nicholas Thompson,32,89,48,41,2006,total_driving,NA
NA,4,Hunter Mahan,29,91,57,34,2006,total_driving,NA
NA,5,Robert Allenby,22,93,64,29,2006,total_driving,NA
NA,6,Joe Durant,28,94,93,1,2006,total_driving,NA
NA,7,Greg Owen,24,101,54,47,2006,total_driving,NA
NA,8,Kenny Perry,22,102,69,33,2006,total_driving,NA
NA,9,Charles Warren,27,104,20,84,2006,total_driving,NA
NA,10,Lucas Glover,31,114,23,91,2006,total_driving,NA
NA,11,Jonathan Byrd,20,115,33,82,2006,total_driving,NA
NA,12,John Senden,28,117,44,73,2006,total_driving,NA
NA,13,Padraig Harrington,15,119,60,59,2006,total_driving,NA
NA,14,Ian Poulter,15,120,100,20,2006,total_driving,NA
NA,15,Ryan Moore,22,124,74,50,2006,total_driving,NA
NA,16,Brett Wetterich,25,126,4,122,2006,total_driving,NA
NA,17,Jonathan Kaye,32,128,61,67,2006,total_driving,NA
NA,18,John Rollins,28,129,50,79,2006,total_driving,NA
NA,19,Bubba Dickerson,32,132,27,105,2006,total_driving,NA
NA,20,Adam Scott,19,133,16,117,2006,total_driving,NA
NA,21,Steve Elkington,17,134,127,7,2006,total_driving,NA
NA,T22,David Branshaw,29,137,102,35,2006,total_driving,NA
NA,T22,Brian Davis,28,137,115,22,2006,total_driving,NA
NA,24,Nick Watney,29,139,18,121,2006,total_driving,NA
NA,25,Mathew Goggin,26,140,45,95,2006,total_driving,NA
NA,T26,Will MacKenzie,29,143,40,103,2006,total_driving,NA
NA,T26,Kevin Sutherland,29,143,67,76,2006,total_driving,NA
NA,T28,Harrison Frazar,29,145,9,136,2006,total_driving,NA
NA,T28,Tiger Woods,15,145,6,139,2006,total_driving,NA
NA,T30,Rich Beem,27,146,48,98,2006,total_driving,NA
NA,T30,Henrik Bjornstad,31,146,39,107,2006,total_driving,NA
NA,32,Kent Jones,32,147,110,37,2006,total_driving,NA
NA,33,Jason Bohn,29,148,95,53,2006,total_driving,NA
NA,34,Briny Baird,25,151,135,16,2006,total_driving,NA
NA,35,Jeff Gove,29,152,88,64,2006,total_driving,NA
NA,T36,Eric Axley,29,153,61,92,2006,total_driving,NA
NA,T36,Alex Cejka,30,153,96,57,2006,total_driving,NA
NA,T36,Duffy Waldorf,28,153,115,38,2006,total_driving,NA
NA,39,Daisuke Maruyama,25,154,139,15,2006,total_driving,NA
NA,40,Chris Couch,27,155,21,134,2006,total_driving,NA
NA,41,Chris Riley,27,157,139,18,2006,total_driving,NA
NA,42,Davis Love III,23,158,14,144,2006,total_driving,NA
NA,43,J.P. Hayes,19,159,108,51,2006,total_driving,NA
NA,T44,Brent Geiberger,30,161,113,48,2006,total_driving,NA
NA,T44,Sean O'Hair,30,161,71,90,2006,total_driving,NA
NA,46,Ted Purdy,33,162,101,61,2006,total_driving,NA
NA,T47,Ryan Palmer,30,163,47,116,2006,total_driving,NA
NA,T47,David Toms,22,163,133,30,2006,total_driving,NA
NA,T49,Mathias Grönberg,30,164,54,110,2006,total_driving,NA
NA,T49,Matt Hansen,25,164,19,145,2006,total_driving,NA
NA,T51,Jason Gore,29,165,22,143,2006,total_driving,NA
NA,T51,Brandt Jobe,28,165,37,128,2006,total_driving,NA
NA,T53,Bart Bryant,26,167,156,11,2006,total_driving,NA
NA,T53,Jim Furyk,24,167,159,8,2006,total_driving,NA
NA,T53,D.J. Trahan,33,167,81,86,2006,total_driving,NA
NA,56,Heath Slocum,30,169,165,4,2006,total_driving,NA
NA,T57,Zach Johnson,27,171,145,26,2006,total_driving,NA
NA,T57,Justin Rose,28,171,82,89,2006,total_driving,NA
NA,59,Geoff Ogilvy,20,172,53,119,2006,total_driving,NA
NA,T60,Trevor Immelman,24,173,58,115,2006,total_driving,NA
NA,T60,Bo Van Pelt,28,173,35,138,2006,total_driving,NA
NA,62,Tjaart van der Walt,21,174,150,24,2006,total_driving,NA
NA,63,Billy Mayfair,29,175,154,21,2006,total_driving,NA
NA,T64,Patrick Sheehan,34,176,105,71,2006,total_driving,NA
NA,T64,Paul Stankowski,22,176,51,125,2006,total_driving,NA
NA,T66,Charley Hoffman,29,177,10,167,2006,total_driving,NA
NA,T66,Phil Mickelson,19,177,17,160,2006,total_driving,NA
NA,T66,Omar Uresti,22,177,171,6,2006,total_driving,NA
NA,T69,Skip Kendall,22,178,165,13,2006,total_driving,NA
NA,T69,Jeff Maggert,26,178,164,14,2006,total_driving,NA
NA,T69,Camilo Villegas,29,178,13,165,2006,total_driving,NA
NA,T72,Troy Matteson,32,179,28,151,2006,total_driving,NA
NA,T72,Kirk Triplett,18,179,168,11,2006,total_driving,NA
NA,T74,Robert Garrigus,28,180,3,177,2006,total_driving,NA
NA,T74,Frank Lickliter II,29,180,125,55,2006,total_driving,NA
NA,76,K.J. Choi,26,182,112,70,2006,total_driving,NA
NA,T77,Jeff Brehaut,33,183,125,58,2006,total_driving,NA
NA,T77,Larry Mize,18,183,178,5,2006,total_driving,NA
NA,T77,Steve Stricker,17,183,134,49,2006,total_driving,NA
NA,T80,Kris Cox,28,184,30,154,2006,total_driving,NA
NA,T80,Richard Johnson,29,184,148,36,2006,total_driving,NA
NA,T80,David McKenzie,28,184,142,42,2006,total_driving,NA
NA,T80,Pat Perez,19,184,30,154,2006,total_driving,NA
NA,84,Brian Bateman,26,186,40,146,2006,total_driving,NA
NA,85,Jeff Overton,28,187,26,161,2006,total_driving,NA
NA,86,J.J. Henry,28,188,46,142,2006,total_driving,NA
NA,T87,Stephen Ames,21,189,88,101,2006,total_driving,NA
NA,T87,Steve Flesch,33,189,124,65,2006,total_driving,NA
NA,T87,J.B. Holmes,26,189,2,187,2006,total_driving,NA
NA,T87,Bob May,21,189,71,118,2006,total_driving,NA
NA,T87,Scott Verplank,25,189,186,3,2006,total_driving,NA
NA,T92,Joe Ogilvie,29,192,107,85,2006,total_driving,NA
NA,T92,Bubba Watson,27,192,1,191,2006,total_driving,NA
NA,T94,Olin Browne,30,193,184,9,2006,total_driving,NA
NA,T94,Ron Whittaker,28,193,161,32,2006,total_driving,NA
NA,T96,John Daly,21,195,5,190,2006,total_driving,NA
NA,T96,Freddie Jacobson,18,195,84,111,2006,total_driving,NA
NA,T98,Fred Funk,29,196,194,2,2006,total_driving,NA
NA,T98,Tag Ridings,33,196,8,188,2006,total_driving,NA
NA,100,Luke Donald,18,197,145,52,2006,total_driving,NA
NA,T101,Jerry Kelly,31,198,179,19,2006,total_driving,NA
NA,T101,Roger Tambellini,25,198,24,174,2006,total_driving,NA
NA,T103,John Cook,22,199,182,17,2006,total_driving,NA
NA,T103,Justin Leonard,26,199,154,45,2006,total_driving,NA
NA,T105,Arjun Atwal,33,200,102,98,2006,total_driving,NA
NA,T105,Sergio Garcia,17,200,71,129,2006,total_driving,NA
NA,T105,Thomas Levet,18,200,113,87,2006,total_driving,NA
NA,T108,Fred Couples,17,201,15,186,2006,total_driving,NA
NA,T108,Robert Gamez,30,201,174,27,2006,total_driving,NA
NA,T108,Ryan Hietala,23,201,7,194,2006,total_driving,NA
NA,T108,Mike Sposa,25,201,138,63,2006,total_driving,NA
NA,112,Paul Goydos,24,202,192,10,2006,total_driving,NA
NA,T113,Marco Dawson,27,203,77,126,2006,total_driving,NA
NA,T113,Mark Wilson,24,203,157,46,2006,total_driving,NA
NA,115,Alex Aragon,26,204,12,192,2006,total_driving,NA
NA,116,Jerry Smith,29,205,180,25,2006,total_driving,NA
NA,T117,Tommy Armour III,25,206,152,54,2006,total_driving,NA
NA,T117,Danny Ellis,23,206,66,140,2006,total_driving,NA
NA,T117,David Howell,14,206,93,113,2006,total_driving,NA
NA,T117,D.A. Points,28,206,92,114,2006,total_driving,NA
NA,121,Bob Estes,25,207,120,87,2006,total_driving,NA
NA,T122,Daniel Chopra,33,208,29,179,2006,total_driving,NA
NA,T122,Ian Leggatt,29,208,77,131,2006,total_driving,NA
NA,T124,Jesper Parnevik,24,209,86,123,2006,total_driving,NA
NA,T124,Joey Sindelar,29,209,143,66,2006,total_driving,NA
NA,T126,Retief Goosen,18,210,34,176,2006,total_driving,NA
NA,T126,Bill Haas,30,210,40,170,2006,total_driving,NA
NA,T126,Greg Kraft,26,210,187,23,2006,total_driving,NA
NA,T126,Jon Mills,27,210,32,178,2006,total_driving,NA
NA,130,Vaughn Taylor,26,212,115,97,2006,total_driving,NA
NA,131,Tom Pernice Jr.,33,213,144,69,2006,total_driving,NA
NA,132,Shaun Micheel,29,217,97,120,2006,total_driving,NA
NA,133,Vijay Singh,27,218,65,153,2006,total_driving,NA
NA,T134,Shane Bertsch,34,219,176,43,2006,total_driving,NA
NA,T134,Steve Lowery,31,219,110,109,2006,total_driving,NA
NA,T136,Mark Brooks,36,220,192,28,2006,total_driving,NA
NA,T136,Mark Calcavecchia,27,220,152,68,2006,total_driving,NA
NA,T136,Brian Gay,31,220,189,31,2006,total_driving,NA
NA,T136,Tim Herron,27,220,59,161,2006,total_driving,NA
NA,T140,Ben Crane,26,221,127,94,2006,total_driving,NA
NA,T140,Jason Schultz,28,221,69,152,2006,total_driving,NA
NA,142,Stewart Cink,26,223,75,148,2006,total_driving,NA
NA,143,Ernie Els,18,225,54,171,2006,total_driving,NA
NA,144,Tim Clark,22,227,183,44,2006,total_driving,NA
NA,T145,Doug Barron,28,228,188,40,2006,total_driving,NA
NA,T145,David Duval,24,228,35,193,2006,total_driving,NA
NA,147,Craig Barlow,22,229,63,166,2006,total_driving,NA
NA,148,Chad Campbell,25,230,83,147,2006,total_driving,NA
NA,149,Woody Austin,31,231,102,129,2006,total_driving,NA
NA,T150,Paul Azinger,30,233,127,106,2006,total_driving,NA
NA,T150,Ben Curtis,26,233,177,56,2006,total_driving,NA
NA,T150,Charles Howell III,30,233,51,182,2006,total_driving,NA
NA,T150,John Huston,27,233,75,158,2006,total_driving,NA
NA,154,Jimmy Walker,21,234,38,196,2006,total_driving,NA
NA,T155,Aaron Baddeley,25,235,98,137,2006,total_driving,NA
NA,T155,Corey Pavin,23,235,196,39,2006,total_driving,NA
NA,157,Billy Andrade,24,236,132,104,2006,total_driving,NA
NA,158,James Driscoll,29,238,43,195,2006,total_driving,NA
NA,159,Bernhard Langer,24,239,127,112,2006,total_driving,NA
NA,T160,Stuart Appleby,23,240,90,150,2006,total_driving,NA
NA,T160,Rod Pampling,24,240,99,141,2006,total_driving,NA
NA,162,Arron Oberholser,23,244,136,108,2006,total_driving,NA
NA,T163,Shigeki Maruyama,30,245,122,123,2006,total_driving,NA
NA,T163,Dean Wilson,34,245,149,96,2006,total_driving,NA
NA,165,Michael Allen,25,246,79,167,2006,total_driving,NA
NA,T166,Stephen Leaney,27,247,185,62,2006,total_driving,NA
NA,T166,Carl Pettersson,28,247,115,132,2006,total_driving,NA
NA,T166,Jeff Sluman,29,247,172,75,2006,total_driving,NA
NA,T169,Brett Quigley,33,248,91,157,2006,total_driving,NA
NA,T169,Mike Weir,24,248,165,83,2006,total_driving,NA
NA,171,"Wes Short, Jr.",33,249,80,169,2006,total_driving,NA
NA,172,Tom Lehman,20,250,115,135,2006,total_driving,NA
NA,173,Peter Lonard,22,251,170,81,2006,total_driving,NA
NA,T174,Chris DiMarco,26,253,175,78,2006,total_driving,NA
NA,T174,Carlos Franco,29,253,68,185,2006,total_driving,NA
NA,T174,J.L. Lewis,17,253,173,80,2006,total_driving,NA
NA,T177,Nathan Green,30,257,157,100,2006,total_driving,NA
NA,T177,José María Olazábal,18,257,108,149,2006,total_driving,NA
NA,179,Steve Jones,27,258,181,77,2006,total_driving,NA
NA,180,Tim Petrovic,30,261,168,93,2006,total_driving,NA
NA,T181,Robert Damron,31,264,162,102,2006,total_driving,NA
NA,T181,Todd Fischer,35,264,190,74,2006,total_driving,NA
NA,183,Len Mattiace,22,265,85,180,2006,total_driving,NA
NA,184,Bob Tway,25,266,139,127,2006,total_driving,NA
NA,185,Rory Sabbatini,24,268,87,181,2006,total_driving,NA
NA,186,"John Engler, Jr.",27,270,106,164,2006,total_driving,NA
NA,187,Dudley Hart,29,285,122,163,2006,total_driving,NA
NA,188,Michael Connell,22,292,159,133,2006,total_driving,NA
NA,189,Ryuji Imada,31,296,137,159,2006,total_driving,NA
NA,190,Vance Veazey,20,299,127,172,2006,total_driving,NA
NA,191,Greg Chalmers,28,309,120,189,2006,total_driving,NA
NA,192,Hidemichi Tanaka,31,318,162,156,2006,total_driving,NA
NA,193,Todd Hamilton,27,331,147,184,2006,total_driving,NA
NA,194,Lee Janzen,28,332,150,182,2006,total_driving,NA
NA,195,Mark O'Meara,18,366,191,175,2006,total_driving,NA
NA,196,Brad Faxon,26,368,195,173,2006,total_driving,NA
NA,1,Charles Warren,29,59,9,50,2007,total_driving,TRUE
NA,2,Mathew Goggin,30,70,26,44,2007,total_driving,NA
NA,3,Hunter Mahan,27,73,36,37,2007,total_driving,NA
NA,4,Jay Williamson,14,84,72,12,2007,total_driving,NA
NA,5,Kenny Perry,24,104,22,82,2007,total_driving,NA
NA,6,Cameron Beckman,29,109,69,40,2007,total_driving,NA
NA,7,Jason Gore,27,110,8,102,2007,total_driving,NA
NA,8,Sean O'Hair,28,113,34,79,2007,total_driving,NA
NA,9,John Senden,27,115,55,60,2007,total_driving,NA
NA,10,D.J. Trahan,30,116,48,68,2007,total_driving,NA
NA,11,Boo Weekley,29,118,37,81,2007,total_driving,NA
NA,12,Bill Haas,30,120,11,109,2007,total_driving,NA
NA,13,Briny Baird,31,121,66,55,2007,total_driving,NA
NA,14,Jeff Overton,19,122,24,98,2007,total_driving,NA
NA,15,Matt Hendrix,24,129,15,114,2007,total_driving,NA
NA,T16,Alex Cejka,25,130,94,36,2007,total_driving,NA
NA,T16,Greg Owen,29,130,40,90,2007,total_driving,NA
NA,18,Peter Lonard,27,131,80,51,2007,total_driving,NA
NA,19,Jeff Brehaut,21,133,76,57,2007,total_driving,NA
NA,T20,Lucas Glover,29,135,46,89,2007,total_driving,NA
NA,T20,Billy Mayfair,30,135,117,18,2007,total_driving,NA
NA,T22,Daisuke Maruyama,28,140,98,42,2007,total_driving,NA
NA,T22,Chris Stroud,24,140,87,53,2007,total_driving,NA
NA,24,Ted Purdy,33,142,57,85,2007,total_driving,NA
NA,25,Kent Jones,30,143,111,32,2007,total_driving,NA
NA,T26,Ken Duke,31,144,103,41,2007,total_driving,NA
NA,T26,Joe Durant,28,144,139,5,2007,total_driving,NA
NA,T26,Jim Rutledge,23,144,99,45,2007,total_driving,NA
NA,T29,Michael Allen,22,146,61,85,2007,total_driving,NA
NA,T29,Anthony Kim,26,146,12,134,2007,total_driving,NA
NA,31,Nick Watney,26,147,17,130,2007,total_driving,NA
NA,T32,Jeff Gove,30,148,84,64,2007,total_driving,NA
NA,T32,J.J. Henry,26,148,54,94,2007,total_driving,NA
NA,34,Bubba Dickerson,19,149,25,124,2007,total_driving,NA
NA,T35,Tommy Armour III,24,150,126,24,2007,total_driving,NA
NA,T35,Rich Beem,29,150,79,71,2007,total_driving,NA
NA,37,Robert Allenby,28,154,22,132,2007,total_driving,NA
NA,38,David Branshaw,30,155,93,62,2007,total_driving,NA
NA,39,Steve Allan,18,156,12,144,2007,total_driving,NA
NA,40,Ryan Armour,32,157,135,22,2007,total_driving,NA
NA,41,John Merrick,29,158,33,125,2007,total_driving,NA
NA,42,Mark Calcavecchia,28,159,86,73,2007,total_driving,NA
NA,T43,John Rollins,29,162,85,77,2007,total_driving,NA
NA,T43,Jaco Van Zyl,21,162,131,31,2007,total_driving,NA
NA,45,Tiger Woods,16,164,12,152,2007,total_driving,NA
NA,46,Steve Marino,31,165,29,136,2007,total_driving,NA
NA,47,Pat Perez,27,166,37,129,2007,total_driving,NA
NA,48,Darron Stiles,24,167,134,33,2007,total_driving,NA
NA,49,Bo Van Pelt,30,168,50,118,2007,total_driving,NA
NA,T50,Steve Lowery,22,169,67,102,2007,total_driving,NA
NA,T50,Camilo Villegas,24,169,27,142,2007,total_driving,NA
NA,52,Mathias Grönberg,31,170,16,154,2007,total_driving,NA
NA,T53,Tom Byrum,20,171,156,15,2007,total_driving,NA
NA,T53,J.B. Holmes,24,171,3,168,2007,total_driving,NA
NA,55,Justin Leonard,29,173,148,25,2007,total_driving,NA
NA,T56,Jim Furyk,23,174,171,3,2007,total_driving,NA
NA,T56,Ryan Moore,28,174,82,92,2007,total_driving,NA
NA,T58,Craig Barlow,16,176,45,131,2007,total_driving,NA
NA,T58,Steve Wheatcroft,25,176,122,54,2007,total_driving,NA
NA,T58,Charlie Wi,27,176,124,52,2007,total_driving,NA
NA,T61,Zach Johnson,23,177,169,8,2007,total_driving,NA
NA,T61,George McNeill,30,177,28,149,2007,total_driving,NA
NA,T61,Shaun Micheel,29,177,138,39,2007,total_driving,NA
NA,T61,Brett Wetterich,28,177,7,170,2007,total_driving,NA
NA,T61,Mark Wilson,25,177,131,46,2007,total_driving,NA
NA,T66,Steve Elkington,25,178,164,14,2007,total_driving,NA
NA,T66,Adam Scott,19,178,18,160,2007,total_driving,NA
NA,T66,Heath Slocum,28,178,172,6,2007,total_driving,NA
NA,69,Bart Bryant,25,179,160,19,2007,total_driving,NA
NA,T70,Michael Boyd,21,180,176,4,2007,total_driving,NA
NA,T70,Joey Sindelar,25,180,111,69,2007,total_driving,NA
NA,T72,Tag Ridings,18,181,6,175,2007,total_driving,NA
NA,T72,Jason Schultz,22,181,43,138,2007,total_driving,NA
NA,T72,Duffy Waldorf,23,181,107,74,2007,total_driving,NA
NA,75,Chris Tidland,21,182,62,120,2007,total_driving,NA
NA,76,Jason Bohn,17,183,111,72,2007,total_driving,NA
NA,T77,Glen Day,27,184,164,20,2007,total_driving,NA
NA,T77,Chris Riley,17,184,167,17,2007,total_driving,NA
NA,T79,Brian Davis,28,185,172,13,2007,total_driving,NA
NA,T79,Troy Matteson,26,185,37,148,2007,total_driving,NA
NA,T81,Robert Gamez,30,186,159,27,2007,total_driving,NA
NA,T81,Tom Johnson,27,186,103,83,2007,total_driving,NA
NA,T83,Paul Stankowski,18,188,43,145,2007,total_driving,NA
NA,T83,Scott Verplank,23,188,172,16,2007,total_driving,NA
NA,T83,Mike Weir,23,188,92,96,2007,total_driving,NA
NA,T86,John Mallinger,29,189,163,26,2007,total_driving,NA
NA,T86,Bubba Watson,26,189,1,188,2007,total_driving,NA
NA,88,Scott Gutschewski,22,190,5,185,2007,total_driving,NA
NA,T89,Will MacKenzie,30,191,74,117,2007,total_driving,NA
NA,T89,Justin Rose,16,191,96,95,2007,total_driving,NA
NA,91,José Coceres,17,192,191,1,2007,total_driving,NA
NA,92,Trevor Immelman,21,193,118,75,2007,total_driving,NA
NA,T93,Fred Funk,22,195,193,2,2007,total_driving,NA
NA,T93,J.P. Hayes,28,195,69,126,2007,total_driving,NA
NA,T93,Charley Hoffman,30,195,19,176,2007,total_driving,NA
NA,T93,Tripp Isenhour,32,195,111,84,2007,total_driving,NA
NA,97,Jerry Kelly,28,196,162,34,2007,total_driving,NA
NA,T98,Craig Bowden,25,197,190,7,2007,total_driving,NA
NA,T98,Robert Garrigus,28,197,4,193,2007,total_driving,NA
NA,T98,Michael Sim,17,197,78,119,2007,total_driving,NA
NA,T101,John Daly,24,198,2,196,2007,total_driving,NA
NA,T101,Doug LaBelle II,33,198,187,11,2007,total_driving,NA
NA,T101,Jarrod Lyle,24,198,65,133,2007,total_driving,NA
NA,T104,Mark Brooks,18,199,189,10,2007,total_driving,NA
NA,T104,Harrison Frazar,32,199,9,190,2007,total_driving,NA
NA,106,Michael Putnam,29,200,53,147,2007,total_driving,NA
NA,107,Stephen Ames,23,201,154,47,2007,total_driving,NA
NA,T108,Chris Couch,30,202,20,182,2007,total_driving,NA
NA,T108,Kyle Reifers,27,202,41,161,2007,total_driving,NA
NA,T108,Kirk Triplett,25,202,181,21,2007,total_driving,NA
NA,T111,Brian Gay,32,203,194,9,2007,total_driving,NA
NA,T111,Davis Love III,21,203,34,169,2007,total_driving,NA
NA,T111,Kevin Stadler,31,203,62,141,2007,total_driving,NA
NA,T114,Jeff Maggert,26,205,142,63,2007,total_driving,NA
NA,T114,Tom Pernice Jr.,31,205,156,49,2007,total_driving,NA
NA,116,Tim Clark,19,206,178,28,2007,total_driving,NA
NA,T117,Steve Flesch,31,207,107,100,2007,total_driving,NA
NA,T117,Frank Lickliter II,30,207,142,65,2007,total_driving,NA
NA,T119,D.J. Brigman,22,210,94,116,2007,total_driving,NA
NA,T119,Ernie Els,16,210,31,179,2007,total_driving,NA
NA,T119,Phil Mickelson,22,210,29,181,2007,total_driving,NA
NA,122,Bob Heintz,27,211,133,78,2007,total_driving,NA
NA,T123,Luke Donald,20,212,177,35,2007,total_driving,NA
NA,T123,Anders Hansen,17,212,164,48,2007,total_driving,NA
NA,T123,Geoff Ogilvy,22,212,47,165,2007,total_driving,NA
NA,T123,Kevin Sutherland,25,212,75,137,2007,total_driving,NA
NA,T127,Jeff Quinney,29,213,155,58,2007,total_driving,NA
NA,T127,Vijay Singh,27,213,58,155,2007,total_driving,NA
NA,129,Jesper Parnevik,27,214,99,115,2007,total_driving,NA
NA,T130,Aaron Baddeley,23,215,69,146,2007,total_driving,NA
NA,T130,Charles Howell III,26,215,20,195,2007,total_driving,NA
NA,T132,Jonathan Byrd,23,216,67,149,2007,total_driving,NA
NA,T132,Mark Hensby,25,216,115,101,2007,total_driving,NA
NA,T132,Rocco Mediate,22,216,178,38,2007,total_driving,NA
NA,T135,Brendon de Jonge,26,217,58,159,2007,total_driving,NA
NA,T135,Johnson Wagner,33,217,129,88,2007,total_driving,NA
NA,T137,Gavin Coles,28,218,195,23,2007,total_driving,NA
NA,T137,Joe Ogilvie,31,218,91,127,2007,total_driving,NA
NA,139,Bob Estes,28,219,149,70,2007,total_driving,NA
NA,140,Stuart Appleby,24,220,80,140,2007,total_driving,NA
NA,T141,Andrew Buckle,26,221,50,171,2007,total_driving,NA
NA,T141,Daniel Chopra,34,221,32,189,2007,total_driving,NA
NA,T141,Paul Goydos,19,221,192,29,2007,total_driving,NA
NA,T141,Rod Pampling,25,221,119,102,2007,total_driving,NA
NA,T141,Henrik Stenson,15,221,41,180,2007,total_driving,NA
NA,T146,Kevin Na,27,222,109,113,2007,total_driving,NA
NA,T146,Ryan Palmer,30,222,49,173,2007,total_driving,NA
NA,148,K.J. Choi,25,223,144,79,2007,total_driving,NA
NA,T149,Chad Campbell,28,225,115,110,2007,total_driving,NA
NA,T149,Jason Dufner,32,225,90,135,2007,total_driving,NA
NA,T151,Richard Johnson,32,226,160,66,2007,total_driving,NA
NA,T151,Corey Pavin,25,226,196,30,2007,total_driving,NA
NA,T151,David Toms,22,226,151,75,2007,total_driving,NA
NA,154,Woody Austin,27,227,122,105,2007,total_driving,NA
NA,T155,Ben Curtis,25,228,185,43,2007,total_driving,NA
NA,T155,Tom Lehman,19,228,137,91,2007,total_driving,NA
NA,157,Tim Herron,27,232,110,122,2007,total_driving,NA
NA,158,Stewart Cink,25,233,50,183,2007,total_driving,NA
NA,T159,Padraig Harrington,18,234,60,174,2007,total_driving,NA
NA,T159,Freddie Jacobson,20,234,135,99,2007,total_driving,NA
NA,T159,Vaughn Taylor,28,234,147,87,2007,total_driving,NA
NA,162,Paul Gow,26,237,170,67,2007,total_driving,NA
NA,163,Marco Dawson,23,238,89,149,2007,total_driving,NA
NA,T164,Brian Bateman,18,239,72,167,2007,total_driving,NA
NA,T164,Sergio Garcia,19,239,55,184,2007,total_driving,NA
NA,166,Matt Kuchar,26,241,185,56,2007,total_driving,NA
NA,167,Craig Kanada,34,242,183,59,2007,total_driving,NA
NA,T168,Stephen Leaney,26,243,182,61,2007,total_driving,NA
NA,T168,Steve Stricker,23,243,146,97,2007,total_driving,NA
NA,170,Rory Sabbatini,23,250,88,162,2007,total_driving,NA
NA,171,Craig Lile,24,251,145,106,2007,total_driving,NA
NA,172,Arron Oberholser,21,252,129,123,2007,total_driving,NA
NA,173,Retief Goosen,14,254,62,192,2007,total_driving,NA
NA,174,Cliff Kresge,30,255,127,128,2007,total_driving,NA
NA,175,Carl Pettersson,31,256,99,157,2007,total_driving,NA
NA,176,Ian Poulter,18,258,151,107,2007,total_driving,NA
NA,177,Nathan Green,29,259,139,120,2007,total_driving,NA
NA,178,Tim Petrovic,32,262,119,143,2007,total_driving,NA
NA,179,Bryce Molder,21,267,76,191,2007,total_driving,NA
NA,T180,Lee Janzen,24,268,105,163,2007,total_driving,NA
NA,T180,Dicky Pride,25,268,156,112,2007,total_driving,NA
NA,T180,Brett Quigley,25,268,82,186,2007,total_driving,NA
NA,183,Todd Hamilton,28,273,96,177,2007,total_driving,NA
NA,184,Dean Wilson,28,275,183,92,2007,total_driving,NA
NA,T185,Billy Andrade,27,277,121,156,2007,total_driving,NA
NA,T185,Parker McLachlin,28,277,99,178,2007,total_driving,NA
NA,187,Bob Tway,32,278,139,139,2007,total_driving,NA
NA,188,Brandt Snedeker,29,280,127,153,2007,total_driving,NA
NA,189,Nick O'Hern,22,286,175,111,2007,total_driving,NA
NA,190,Shigeki Maruyama,31,288,180,108,2007,total_driving,NA
NA,191,Eric Axley,36,293,106,187,2007,total_driving,NA
NA,192,Rich Barcelo,26,296,124,172,2007,total_driving,NA
NA,193,Ryuji Imada,32,315,149,166,2007,total_driving,NA
NA,194,Chris DiMarco,24,317,153,164,2007,total_driving,NA
NA,195,Jeff Sluman,21,325,168,157,2007,total_driving,NA
NA,196,José María Olazábal,16,382,188,194,2007,total_driving,NA
NA,1,Jason Gore,33,56,15,41,2008,total_driving,TRUE
NA,2,Charles Warren,29,85,10,75,2008,total_driving,NA
NA,3,Nicholas Thompson,36,88,36,52,2008,total_driving,NA
NA,4,John Merrick,28,100,20,80,2008,total_driving,NA
NA,5,John Riegger,24,105,74,31,2008,total_driving,NA
NA,6,Charley Hoffman,29,107,12,95,2008,total_driving,NA
NA,7,Joe Durant,28,110,102,8,2008,total_driving,NA
NA,8,Jeff Gove,18,114,103,11,2008,total_driving,NA
NA,9,John Senden,28,116,81,35,2008,total_driving,NA
NA,T10,Mathew Goggin,27,118,34,84,2008,total_driving,NA
NA,T10,John Rollins,28,118,80,38,2008,total_driving,NA
NA,12,Ryan Moore,24,122,56,66,2008,total_driving,NA
NA,T13,Michael Allen,28,126,101,25,2008,total_driving,NA
NA,T13,Ryan Armour,32,126,103,23,2008,total_driving,NA
NA,15,Paul Casey,16,127,18,109,2008,total_driving,NA
NA,16,Ben Crane,25,128,86,42,2008,total_driving,NA
NA,T17,Todd Demsey,25,130,53,77,2008,total_driving,NA
NA,T17,John Huston,18,130,65,65,2008,total_driving,NA
NA,19,Robert Allenby,28,131,61,70,2008,total_driving,NA
NA,20,J.J. Henry,34,132,61,71,2008,total_driving,NA
NA,21,Nick Watney,27,135,7,128,2008,total_driving,NA
NA,22,Rich Beem,29,136,88,48,2008,total_driving,NA
NA,23,Hunter Mahan,27,137,75,62,2008,total_driving,NA
NA,T24,Mathias Grönberg,30,140,38,102,2008,total_driving,NA
NA,T24,Steve Marino,32,140,49,91,2008,total_driving,NA
NA,T24,Charlie Wi,27,140,95,45,2008,total_driving,NA
NA,27,Pat Perez,27,141,44,97,2008,total_driving,NA
NA,T28,Billy Mayfair,29,142,129,13,2008,total_driving,NA
NA,T28,Mark Wilson,29,142,122,20,2008,total_driving,NA
NA,30,Chad Campbell,28,143,75,68,2008,total_driving,NA
NA,T31,Ryan Palmer,22,144,44,100,2008,total_driving,NA
NA,T31,D.J. Trahan,27,144,66,78,2008,total_driving,NA
NA,33,Martin Laird,29,145,31,114,2008,total_driving,NA
NA,34,Boo Weekley,24,146,61,85,2008,total_driving,NA
NA,35,Jay Williamson,33,147,123,24,2008,total_driving,NA
NA,36,Lucas Glover,26,148,23,125,2008,total_driving,NA
NA,37,Rod Pampling,28,151,82,69,2008,total_driving,NA
NA,T38,Kenny Perry,26,153,33,120,2008,total_driving,NA
NA,T38,Chris Stroud,29,153,95,58,2008,total_driving,NA
NA,40,Harrison Frazar,23,154,14,140,2008,total_driving,NA
NA,41,Kenneth Ferrie,25,155,119,36,2008,total_driving,NA
NA,T42,Kent Jones,23,157,141,16,2008,total_driving,NA
NA,T42,Michael Letzig,29,157,69,88,2008,total_driving,NA
NA,T44,Jonathan Byrd,27,160,114,46,2008,total_driving,NA
NA,T44,Robert Gamez,26,160,153,7,2008,total_driving,NA
NA,T44,Jeff Maggert,28,160,110,50,2008,total_driving,NA
NA,47,Chez Reavie,30,161,152,9,2008,total_driving,NA
NA,48,Nick Flanagan,29,164,60,104,2008,total_driving,NA
NA,49,Troy Matteson,30,165,38,127,2008,total_driving,NA
NA,T50,Steve Allan,21,166,5,161,2008,total_driving,NA
NA,T50,Jason Day,28,166,27,139,2008,total_driving,NA
NA,52,Heath Slocum,29,167,164,3,2008,total_driving,NA
NA,53,Ben Curtis,22,168,121,47,2008,total_driving,NA
NA,T54,Scott McCarron,22,169,139,30,2008,total_driving,NA
NA,T54,Joe Ogilvie,29,169,88,81,2008,total_driving,NA
NA,T54,Kevin Streelman,32,169,54,115,2008,total_driving,NA
NA,T57,Bart Bryant,23,170,166,4,2008,total_driving,NA
NA,T57,Steve Elkington,25,170,148,22,2008,total_driving,NA
NA,T57,Anthony Kim,22,170,11,159,2008,total_driving,NA
NA,T60,Bill Haas,31,171,29,142,2008,total_driving,NA
NA,T60,Davis Love III,23,171,9,162,2008,total_driving,NA
NA,62,Tommy Gainey,24,172,24,148,2008,total_driving,NA
NA,63,Trevor Immelman,22,173,66,107,2008,total_driving,NA
NA,T64,Woody Austin,30,174,114,60,2008,total_driving,NA
NA,T64,Tag Ridings,29,174,6,168,2008,total_driving,NA
NA,T64,Bo Van Pelt,32,174,58,116,2008,total_driving,NA
NA,67,Vijay Singh,23,175,25,150,2008,total_driving,NA
NA,T68,Rory Sabbatini,23,176,58,118,2008,total_driving,NA
NA,T68,Scott Verplank,24,176,170,6,2008,total_driving,NA
NA,70,Briny Baird,30,177,116,61,2008,total_driving,NA
NA,71,Todd Hamilton,28,180,129,51,2008,total_driving,NA
NA,T72,Robert Garrigus,29,181,2,179,2008,total_driving,NA
NA,T72,Patrick Sheehan,35,181,125,56,2008,total_driving,NA
NA,74,Tom Scherrer,20,182,88,94,2008,total_driving,NA
NA,T75,Tommy Armour III,25,183,88,95,2008,total_driving,NA
NA,T75,Brian Davis,34,183,173,10,2008,total_driving,NA
NA,T75,Tim Herron,28,183,52,131,2008,total_driving,NA
NA,T75,Tim Petrovic,32,183,129,54,2008,total_driving,NA
NA,T79,Ted Purdy,25,184,54,130,2008,total_driving,NA
NA,T79,Bubba Watson,29,184,1,183,2008,total_driving,NA
NA,T81,Fred Couples,18,185,16,169,2008,total_driving,NA
NA,T81,Kevin Stadler,30,185,68,117,2008,total_driving,NA
NA,T81,Omar Uresti,24,185,183,2,2008,total_driving,NA
NA,T84,Padraig Harrington,15,186,32,154,2008,total_driving,NA
NA,T84,Zach Johnson,25,186,181,5,2008,total_driving,NA
NA,86,Scott Sterling,28,188,125,63,2008,total_driving,NA
NA,T87,Jim Furyk,26,190,162,28,2008,total_driving,NA
NA,T87,Doug LaBelle II,22,190,153,37,2008,total_driving,NA
NA,T89,Justin Bolli,28,191,125,66,2008,total_driving,NA
NA,T89,Ron Whittaker,22,191,177,14,2008,total_driving,NA
NA,T91,Cameron Beckman,29,192,150,42,2008,total_driving,NA
NA,T91,George McNeill,29,192,40,152,2008,total_driving,NA
NA,T91,Kevin Sutherland,26,192,71,121,2008,total_driving,NA
NA,T91,Vaughn Taylor,32,192,82,110,2008,total_driving,NA
NA,T95,Adam Scott,15,193,8,185,2008,total_driving,NA
NA,T95,Y.E. Yang,29,193,100,93,2008,total_driving,NA
NA,T97,Olin Browne,27,195,194,1,2008,total_driving,NA
NA,T97,Dustin Johnson,30,195,4,191,2008,total_driving,NA
NA,T97,John Mallinger,29,195,169,26,2008,total_driving,NA
NA,T97,Nick O'Hern,26,195,183,12,2008,total_driving,NA
NA,T97,Marc Turnesa,29,195,117,78,2008,total_driving,NA
NA,T102,Sergio Garcia,19,196,43,153,2008,total_driving,NA
NA,T102,Justin Leonard,25,196,156,40,2008,total_driving,NA
NA,104,Kevin Na,29,197,158,39,2008,total_driving,NA
NA,T105,Paul Claxton,23,198,180,18,2008,total_driving,NA
NA,T105,J.B. Holmes,26,198,3,195,2008,total_driving,NA
NA,T105,Brandt Jobe,19,198,21,177,2008,total_driving,NA
NA,108,Bob Estes,28,201,145,56,2008,total_driving,NA
NA,109,Brad Elder,23,202,78,124,2008,total_driving,NA
NA,T110,Jason Allred,23,206,22,184,2008,total_driving,NA
NA,T110,Travis Perkins,23,206,16,190,2008,total_driving,NA
NA,T112,Frank Lickliter II,32,207,125,82,2008,total_driving,NA
NA,T112,Sean O'Hair,25,207,69,138,2008,total_driving,NA
NA,T114,Shane Bertsch,29,208,187,21,2008,total_driving,NA
NA,T114,Alejandro Cañizares,16,208,97,111,2008,total_driving,NA
NA,T116,Ángel Cabrera,17,209,13,196,2008,total_driving,NA
NA,T116,Stewart Cink,23,209,28,181,2008,total_driving,NA
NA,T116,Paul Goydos,25,209,190,19,2008,total_driving,NA
NA,T116,Jon Mills,32,209,51,158,2008,total_driving,NA
NA,120,Gavin Coles,16,210,195,15,2008,total_driving,NA
NA,T121,Brenden Pappas,24,211,42,169,2008,total_driving,NA
NA,T121,Andres Romero,20,211,19,192,2008,total_driving,NA
NA,T121,Bob Tway,20,211,167,44,2008,total_driving,NA
NA,T124,Mark Calcavecchia,25,213,139,74,2008,total_driving,NA
NA,T124,Brian Gay,31,213,196,17,2008,total_driving,NA
NA,T124,Will MacKenzie,21,213,108,105,2008,total_driving,NA
NA,T124,Jeff Overton,32,213,26,187,2008,total_driving,NA
NA,128,Glen Day,19,215,183,32,2008,total_driving,NA
NA,T129,David Lutterus,23,216,84,132,2008,total_driving,NA
NA,T129,Phil Mickelson,21,216,35,181,2008,total_driving,NA
NA,T129,Brett Quigley,25,216,94,122,2008,total_driving,NA
NA,T129,Camilo Villegas,22,216,50,166,2008,total_driving,NA
NA,T133,Richard Johnson,29,217,29,188,2008,total_driving,NA
NA,T133,Peter Lonard,30,217,153,64,2008,total_driving,NA
NA,T135,Alex Cejka,25,218,142,76,2008,total_driving,NA
NA,T135,David Toms,20,218,146,72,2008,total_driving,NA
NA,T135,Tim Wilkinson,29,218,165,53,2008,total_driving,NA
NA,T138,Craig Kanada,23,219,192,27,2008,total_driving,NA
NA,T138,Jin Park,30,219,186,33,2008,total_driving,NA
NA,T138,Bob Sowards,22,219,84,135,2008,total_driving,NA
NA,T138,Kyle Thompson,26,219,111,108,2008,total_driving,NA
NA,T142,J.P. Hayes,26,222,124,98,2008,total_driving,NA
NA,T142,Geoff Ogilvy,20,222,57,165,2008,total_driving,NA
NA,T144,Aaron Baddeley,22,223,73,150,2008,total_driving,NA
NA,T144,Charles Howell III,31,223,48,175,2008,total_driving,NA
NA,T144,Greg Kraft,21,223,189,34,2008,total_driving,NA
NA,T144,Chris Riley,17,223,168,55,2008,total_driving,NA
NA,148,Mike Weir,26,225,119,106,2008,total_driving,NA
NA,149,Corey Pavin,20,226,197,29,2008,total_driving,NA
NA,T150,James Driscoll,28,229,40,189,2008,total_driving,NA
NA,T150,Jesper Parnevik,29,229,93,136,2008,total_driving,NA
NA,T150,Jimmy Walker,24,229,36,193,2008,total_driving,NA
NA,153,Ken Duke,33,230,118,112,2008,total_driving,NA
NA,154,K.J. Choi,21,232,106,126,2008,total_driving,NA
NA,T155,Lee Janzen,28,233,132,101,2008,total_driving,NA
NA,T155,Matt Jones,31,233,47,186,2008,total_driving,NA
NA,T157,Richard Johnson,21,235,146,89,2008,total_driving,NA
NA,T157,Jerry Kelly,31,235,176,59,2008,total_driving,NA
NA,T157,Tom Lehman,17,235,148,87,2008,total_driving,NA
NA,T160,Stephen Ames,24,236,133,103,2008,total_driving,NA
NA,T160,Stuart Appleby,23,236,72,164,2008,total_driving,NA
NA,162,Ernie Els,16,237,64,173,2008,total_driving,NA
NA,163,Daniel Chopra,27,238,44,194,2008,total_driving,NA
NA,164,Mark Hensby,26,239,79,160,2008,total_driving,NA
NA,T165,Tim Clark,27,240,157,83,2008,total_driving,NA
NA,T165,Stephen Leaney,17,240,191,49,2008,total_driving,NA
NA,167,Brad Adamonis,29,242,75,167,2008,total_driving,NA
NA,168,Steve Lowery,25,243,99,144,2008,total_driving,NA
NA,169,Marco Dawson,21,247,106,141,2008,total_driving,NA
NA,170,Tom Pernice Jr.,30,251,161,90,2008,total_driving,NA
NA,171,Carl Pettersson,29,253,108,145,2008,total_driving,NA
NA,T172,Matt Kuchar,27,255,182,73,2008,total_driving,NA
NA,T172,Jim McGovern,26,255,163,92,2008,total_driving,NA
NA,174,Rocco Mediate,27,256,170,86,2008,total_driving,NA
NA,175,Cody Freeman,26,257,86,171,2008,total_driving,NA
NA,176,Parker McLachlin,27,262,105,157,2008,total_driving,NA
NA,177,Eric Axley,35,264,88,176,2008,total_driving,NA
NA,T178,Retief Goosen,18,271,97,174,2008,total_driving,NA
NA,T178,Cliff Kresge,28,271,158,113,2008,total_driving,NA
NA,T178,Johnson Wagner,26,271,138,133,2008,total_driving,NA
NA,181,Chris DiMarco,29,274,175,99,2008,total_driving,NA
NA,182,Carlos Franco,25,275,112,163,2008,total_driving,NA
NA,183,Ian Poulter,15,281,135,146,2008,total_driving,NA
NA,184,Nathan Green,30,283,134,149,2008,total_driving,NA
NA,T185,Steve Flesch,29,284,150,134,2008,total_driving,NA
NA,T185,Freddie Jacobson,24,284,142,142,2008,total_driving,NA
NA,187,Billy Andrade,24,292,137,155,2008,total_driving,NA
NA,188,Brandt Snedeker,26,297,160,137,2008,total_driving,NA
NA,189,Dean Wilson,32,301,178,123,2008,total_driving,NA
NA,190,Dudley Hart,22,308,179,129,2008,total_driving,NA
NA,191,David Duval,20,310,113,197,2008,total_driving,NA
NA,192,Jeff Quinney,28,312,193,119,2008,total_driving,NA
NA,193,Steve Stricker,22,313,135,178,2008,total_driving,NA
NA,194,Ryuji Imada,25,317,170,147,2008,total_driving,NA
NA,195,Brett Rumford,26,322,142,180,2008,total_driving,NA
NA,196,Chad Collins,24,330,174,156,2008,total_driving,NA
NA,197,Shigeki Maruyama,18,360,188,172,2008,total_driving,NA
NA,1,Jonathan Byrd,25,92,33,59,2009,total_driving,TRUE
NA,2,Lucas Glover,26,95,25,70,2009,total_driving,NA
NA,T3,Kenny Perry,24,97,48,49,2009,total_driving,NA
NA,T3,John Rollins,27,97,30,67,2009,total_driving,NA
NA,T5,Robert Allenby,21,98,48,50,2009,total_driving,NA
NA,T5,Boo Weekley,22,98,62,36,2009,total_driving,NA
NA,7,Hunter Mahan,25,102,28,74,2009,total_driving,NA
NA,T8,Ryan Moore,27,104,33,71,2009,total_driving,NA
NA,T8,Greg Owen,30,104,59,45,2009,total_driving,NA
NA,T8,Heath Slocum,30,104,97,7,2009,total_driving,NA
NA,11,Kirk Triplett,20,105,100,5,2009,total_driving,NA
NA,12,Tiger Woods,17,107,21,86,2009,total_driving,NA
NA,13,Charles Warren,20,111,18,93,2009,total_driving,NA
NA,14,Scott McCarron,27,117,114,3,2009,total_driving,NA
NA,15,John Senden,29,118,40,78,2009,total_driving,NA
NA,16,Michael Allen,22,119,80,39,2009,total_driving,NA
NA,T17,Martin Laird,24,121,14,107,2009,total_driving,NA
NA,T17,Jeff Maggert,28,121,83,38,2009,total_driving,NA
NA,19,Kris Blanks,20,122,65,57,2009,total_driving,NA
NA,20,David Toms,27,123,119,4,2009,total_driving,NA
NA,21,Bo Van Pelt,30,124,56,68,2009,total_driving,NA
NA,T22,Jason Bohn,25,126,108,18,2009,total_driving,NA
NA,T22,D.J. Trahan,30,126,79,47,2009,total_driving,NA
NA,T24,Tommy Armour III,19,129,95,34,2009,total_driving,NA
NA,T24,Nicholas Thompson,31,129,38,91,2009,total_driving,NA
NA,26,Mathew Goggin,26,131,69,62,2009,total_driving,NA
NA,T27,Jason Gore,24,132,72,60,2009,total_driving,NA
NA,T27,Bill Haas,29,132,22,110,2009,total_driving,NA
NA,29,Ted Purdy,30,134,45,89,2009,total_driving,NA
NA,T30,Steve Marino,29,139,35,104,2009,total_driving,NA
NA,T30,Billy Mayfair,28,139,119,20,2009,total_driving,NA
NA,32,Will MacKenzie,24,140,78,62,2009,total_driving,NA
NA,33,Steve Elkington,23,142,107,35,2009,total_driving,NA
NA,34,Steve Lowery,27,143,74,69,2009,total_driving,NA
NA,35,Peter Tomasulo,25,144,50,94,2009,total_driving,NA
NA,36,Ernie Els,19,145,68,77,2009,total_driving,NA
NA,T37,Troy Matteson,30,146,9,137,2009,total_driving,NA
NA,T37,Mark Wilson,28,146,118,28,2009,total_driving,NA
NA,39,Jason Dufner,26,148,102,46,2009,total_driving,NA
NA,T40,Bill Lunde,27,149,57,92,2009,total_driving,NA
NA,T40,Jay Williamson,22,149,123,26,2009,total_driving,NA
NA,42,Ben Crane,27,150,109,41,2009,total_driving,NA
NA,43,Tim Clark,23,152,150,2,2009,total_driving,NA
NA,44,Zach Johnson,26,153,143,10,2009,total_driving,NA
NA,T45,John Merrick,28,154,29,125,2009,total_driving,NA
NA,T45,Ryan Palmer,26,154,26,128,2009,total_driving,NA
NA,47,Justin Leonard,26,155,123,32,2009,total_driving,NA
NA,T48,Sergio Garcia,17,156,18,138,2009,total_driving,NA
NA,T48,Scott Verplank,24,156,145,11,2009,total_driving,NA
NA,T50,Davis Love III,27,157,14,143,2009,total_driving,NA
NA,T50,Steve Stricker,22,157,104,53,2009,total_driving,NA
NA,T52,Joe Durant,20,158,157,1,2009,total_driving,NA
NA,T52,Marc Leishman,28,158,17,141,2009,total_driving,NA
NA,54,Kevin Streelman,29,159,30,129,2009,total_driving,NA
NA,T55,Jeff Klauk,29,160,147,13,2009,total_driving,NA
NA,T55,Matt Weibring,22,160,84,76,2009,total_driving,NA
NA,57,Nick Watney,24,161,6,155,2009,total_driving,NA
NA,T58,Robert Garrigus,25,162,1,161,2009,total_driving,NA
NA,T58,Patrick Sheehan,15,162,146,16,2009,total_driving,NA
NA,60,Charlie Wi,28,164,112,52,2009,total_driving,NA
NA,61,Darron Stiles,20,165,153,12,2009,total_driving,NA
NA,T62,Stephen Ames,23,167,94,73,2009,total_driving,NA
NA,T62,Alex Cejka,25,167,143,24,2009,total_driving,NA
NA,T62,Charley Hoffman,27,167,11,156,2009,total_driving,NA
NA,65,Kent Jones,24,168,141,27,2009,total_driving,NA
NA,T66,Sean O'Hair,23,169,46,123,2009,total_driving,NA
NA,T66,Tag Ridings,16,169,4,165,2009,total_driving,NA
NA,T66,Justin Rose,22,169,90,79,2009,total_driving,NA
NA,69,J.J. Henry,28,171,44,127,2009,total_driving,NA
NA,T70,Jason Day,18,172,36,136,2009,total_driving,NA
NA,T70,Dustin Johnson,25,172,3,169,2009,total_driving,NA
NA,T70,Vijay Singh,21,172,41,131,2009,total_driving,NA
NA,T70,Chris Stroud,28,172,72,100,2009,total_driving,NA
NA,T70,Johnson Wagner,26,172,88,84,2009,total_driving,NA
NA,T75,Chad Campbell,26,173,70,103,2009,total_driving,NA
NA,T75,Chez Reavie,27,173,154,19,2009,total_driving,NA
NA,77,James Nitties,27,174,63,111,2009,total_driving,NA
NA,T78,Chris Riley,22,176,167,9,2009,total_driving,NA
NA,T78,Camilo Villegas,21,176,50,126,2009,total_driving,NA
NA,T80,Bob Estes,23,177,137,40,2009,total_driving,NA
NA,T80,Jim Furyk,23,177,152,25,2009,total_driving,NA
NA,T80,Colt Knost,24,177,154,23,2009,total_driving,NA
NA,T80,Michael Letzig,28,177,43,134,2009,total_driving,NA
NA,T84,Brian Davis,32,178,127,51,2009,total_driving,NA
NA,T84,D.A. Points,29,178,141,37,2009,total_driving,NA
NA,86,Scott Piercy,28,179,12,167,2009,total_driving,NA
NA,87,Bubba Watson,24,180,2,178,2009,total_driving,NA
NA,T88,Harrison Frazar,28,182,10,172,2009,total_driving,NA
NA,T88,Gary Woodland,18,182,5,177,2009,total_driving,NA
NA,90,Bart Bryant,17,183,175,8,2009,total_driving,NA
NA,T91,Daniel Chopra,28,185,26,159,2009,total_driving,NA
NA,T91,Adam Scott,19,185,37,148,2009,total_driving,NA
NA,T91,Vaughn Taylor,28,185,129,56,2009,total_driving,NA
NA,94,Briny Baird,28,186,138,48,2009,total_driving,NA
NA,T95,Bob Heintz,20,187,123,64,2009,total_driving,NA
NA,T95,Rod Pampling,23,187,90,97,2009,total_driving,NA
NA,T97,Stewart Cink,22,188,39,149,2009,total_driving,NA
NA,T97,Tim Petrovic,31,188,133,55,2009,total_driving,NA
NA,T99,Ángel Cabrera,17,189,8,181,2009,total_driving,NA
NA,T99,Brian Gay,27,189,183,6,2009,total_driving,NA
NA,T101,Fred Couples,16,190,24,166,2009,total_driving,NA
NA,T101,Brandt Snedeker,26,190,169,21,2009,total_driving,NA
NA,T103,J.B. Holmes,25,191,7,184,2009,total_driving,NA
NA,T103,Anthony Kim,22,191,16,175,2009,total_driving,NA
NA,T103,Brian Vranesh,20,191,89,102,2009,total_driving,NA
NA,T103,Casey Wittenberg,25,191,109,82,2009,total_driving,NA
NA,T107,Matt Jones,17,192,23,169,2009,total_driving,NA
NA,T107,Phil Mickelson,18,192,13,179,2009,total_driving,NA
NA,T107,Kevin Stadler,20,192,75,117,2009,total_driving,NA
NA,T107,Kevin Sutherland,27,192,80,112,2009,total_driving,NA
NA,T111,K.J. Choi,22,193,150,43,2009,total_driving,NA
NA,T111,Jerry Kelly,26,193,114,79,2009,total_driving,NA
NA,T113,Matt Kuchar,24,194,128,66,2009,total_driving,NA
NA,T113,Bryce Molder,21,194,129,65,2009,total_driving,NA
NA,T115,Glen Day,26,195,174,21,2009,total_driving,NA
NA,T115,John Mallinger,27,195,164,31,2009,total_driving,NA
NA,T117,Brendon de Jonge,29,196,75,121,2009,total_driving,NA
NA,T117,Todd Hamilton,29,196,113,83,2009,total_driving,NA
NA,T117,Tom Lehman,16,196,179,17,2009,total_driving,NA
NA,T117,George McNeill,26,196,61,135,2009,total_driving,NA
NA,T117,Pat Perez,22,196,87,109,2009,total_driving,NA
NA,T122,Woody Austin,24,197,99,98,2009,total_driving,NA
NA,T122,Mark Brooks,17,197,182,15,2009,total_driving,NA
NA,T122,Retief Goosen,20,197,58,139,2009,total_driving,NA
NA,T125,Leif Olson,21,198,30,168,2009,total_driving,NA
NA,T125,Corey Pavin,23,198,184,14,2009,total_driving,NA
NA,T125,Andres Romero,20,198,18,180,2009,total_driving,NA
NA,T128,Charles Howell III,29,199,53,146,2009,total_driving,NA
NA,T128,Nick O'Hern,27,199,170,29,2009,total_driving,NA
NA,130,Y.E. Yang,23,200,67,133,2009,total_driving,NA
NA,T131,Matt Bettencourt,31,201,52,149,2009,total_driving,NA
NA,T131,Rory Sabbatini,25,201,47,154,2009,total_driving,NA
NA,133,Paul Goydos,25,202,172,30,2009,total_driving,NA
NA,T134,Rich Beem,26,203,114,89,2009,total_driving,NA
NA,T134,Scott Sterling,16,203,109,94,2009,total_driving,NA
NA,136,Ricky Barnes,23,207,55,152,2009,total_driving,NA
NA,137,Ian Poulter,17,208,133,75,2009,total_driving,NA
NA,138,Richard Johnson,26,209,176,33,2009,total_driving,NA
NA,139,Rick Price,21,210,166,44,2009,total_driving,NA
NA,140,Chris DiMarco,29,211,157,54,2009,total_driving,NA
NA,141,Tim Herron,27,212,59,153,2009,total_driving,NA
NA,142,Geoff Ogilvy,20,214,63,151,2009,total_driving,NA
NA,T143,Cameron Beckman,26,215,97,118,2009,total_driving,NA
NA,T143,Peter Lonard,30,215,157,58,2009,total_driving,NA
NA,T143,Jeff Overton,28,215,41,174,2009,total_driving,NA
NA,146,Rocco Mediate,22,217,129,88,2009,total_driving,NA
NA,T147,Greg Chalmers,26,218,119,99,2009,total_driving,NA
NA,T147,Marc Turnesa,30,218,157,61,2009,total_driving,NA
NA,T149,Stuart Appleby,25,219,77,142,2009,total_driving,NA
NA,T149,Jarrod Lyle,21,219,95,124,2009,total_driving,NA
NA,T149,Jeff Quinney,26,219,177,42,2009,total_driving,NA
NA,152,Cliff Kresge,28,221,149,72,2009,total_driving,NA
NA,153,Joe Ogilvie,29,223,65,158,2009,total_driving,NA
NA,154,Steve Flesch,27,225,117,108,2009,total_driving,NA
NA,155,Tom Pernice Jr.,26,226,140,86,2009,total_driving,NA
NA,156,Mark Calcavecchia,23,234,104,130,2009,total_driving,NA
NA,157,David Duval,22,236,53,183,2009,total_driving,NA
NA,158,Brett Quigley,28,237,93,144,2009,total_driving,NA
NA,159,Ben Curtis,18,238,157,81,2009,total_driving,NA
NA,160,Kevin Na,26,240,136,104,2009,total_driving,NA
NA,T161,Brad Adamonis,25,242,82,160,2009,total_driving,NA
NA,T161,Ken Duke,29,242,129,113,2009,total_driving,NA
NA,T161,Webb Simpson,30,242,102,140,2009,total_driving,NA
NA,164,Carl Pettersson,29,243,86,157,2009,total_driving,NA
NA,165,Jimmy Walker,24,246,70,176,2009,total_driving,NA
NA,166,Brian Bateman,25,248,84,164,2009,total_driving,NA
NA,167,Aron Price,27,250,154,96,2009,total_driving,NA
NA,168,Lee Janzen,23,254,139,115,2009,total_driving,NA
NA,T169,Aaron Baddeley,23,255,92,163,2009,total_driving,NA
NA,T169,Nathan Green,30,255,123,132,2009,total_driving,NA
NA,171,Derek Fathauer,25,262,100,162,2009,total_driving,NA
NA,172,David Mathis,27,264,148,116,2009,total_driving,NA
NA,173,Dean Wilson,29,266,181,85,2009,total_driving,NA
NA,T174,Freddie Jacobson,25,269,122,147,2009,total_driving,NA
NA,T174,Mike Weir,24,269,163,106,2009,total_driving,NA
NA,176,Padraig Harrington,20,277,106,171,2009,total_driving,NA
NA,177,Greg Kraft,21,279,178,101,2009,total_driving,NA
NA,178,Spencer Levin,25,284,165,119,2009,total_driving,NA
NA,179,Luke Donald,21,287,173,114,2009,total_driving,NA
NA,180,Ryuji Imada,25,290,168,122,2009,total_driving,NA
NA,181,Brendon Todd,21,291,171,120,2009,total_driving,NA
NA,182,Eric Axley,30,315,133,182,2009,total_driving,NA
NA,183,Brad Faxon,23,324,180,144,2009,total_driving,NA
NA,184,Parker McLachlin,25,330,157,173,2009,total_driving,NA
NA,1,Charles Warren,21,70,9,61,2010,total_driving,TRUE
NA,2,Graham DeLaet,28,84,6,78,2010,total_driving,NA
NA,3,Hunter Mahan,25,95,57,38,2010,total_driving,NA
NA,T4,Davis Love III,24,102,17,85,2010,total_driving,NA
NA,T4,Boo Weekley,27,102,55,47,2010,total_driving,NA
NA,6,Kenny Perry,20,104,68,36,2010,total_driving,NA
NA,7,John Rollins,26,110,30,80,2010,total_driving,NA
NA,T8,Chris Couch,23,111,49,62,2010,total_driving,NA
NA,T8,Ryan Moore,24,111,75,36,2010,total_driving,NA
NA,10,John Merrick,31,113,60,53,2010,total_driving,NA
NA,T11,Blake Adams,26,115,63,52,2010,total_driving,NA
NA,T11,Steve Elkington,22,115,80,35,2010,total_driving,NA
NA,T11,Tom Gillis,27,115,86,29,2010,total_driving,NA
NA,T14,Joe Durant,19,118,116,2,2010,total_driving,NA
NA,T14,John Senden,30,118,72,46,2010,total_driving,NA
NA,16,J.J. Henry,27,120,46,74,2010,total_driving,NA
NA,17,Jarrod Lyle,18,122,23,99,2010,total_driving,NA
NA,T18,Mathias Grönberg,22,123,40,83,2010,total_driving,NA
NA,T18,Will MacKenzie,23,123,66,57,2010,total_driving,NA
NA,T18,Bo Van Pelt,28,123,53,70,2010,total_driving,NA
NA,21,Rory McIlroy,16,127,12,115,2010,total_driving,NA
NA,22,Bill Haas,25,130,42,88,2010,total_driving,NA
NA,23,Scott McCarron,29,131,88,43,2010,total_driving,NA
NA,24,Rickie Fowler,28,133,47,86,2010,total_driving,NA
NA,25,Kevin Streelman,28,134,70,64,2010,total_driving,NA
NA,T26,Retief Goosen,19,136,60,76,2010,total_driving,NA
NA,T26,Nick Watney,24,136,20,116,2010,total_driving,NA
NA,T28,Lucas Glover,23,138,27,111,2010,total_driving,NA
NA,T28,Paul Stankowski,18,138,70,68,2010,total_driving,NA
NA,30,Jay Williamson,24,139,119,20,2010,total_driving,NA
NA,T31,Stewart Cink,23,141,49,92,2010,total_driving,NA
NA,T31,Billy Mayfair,26,141,124,17,2010,total_driving,NA
NA,T31,Josh Teater,31,141,44,97,2010,total_driving,NA
NA,34,Sergio Garcia,15,142,47,95,2010,total_driving,NA
NA,T35,Charley Hoffman,24,143,15,128,2010,total_driving,NA
NA,T35,Adam Scott,20,143,33,110,2010,total_driving,NA
NA,T35,D.J. Trahan,27,143,10,133,2010,total_driving,NA
NA,T38,Chad Campbell,28,144,119,25,2010,total_driving,NA
NA,T38,Matt Kuchar,26,144,105,39,2010,total_driving,NA
NA,T40,Ben Crane,24,145,136,9,2010,total_driving,NA
NA,T40,Kevin Sutherland,25,145,96,49,2010,total_driving,NA
NA,42,Mathew Goggin,28,147,78,69,2010,total_driving,NA
NA,43,David Toms,25,151,144,7,2010,total_driving,NA
NA,44,Vijay Singh,24,153,51,102,2010,total_driving,NA
NA,45,Vaughn Taylor,26,155,122,33,2010,total_driving,NA
NA,46,Cliff Kresge,17,156,128,28,2010,total_driving,NA
NA,47,Robert Allenby,22,159,82,77,2010,total_driving,NA
NA,48,Kris Blanks,30,161,110,51,2010,total_driving,NA
NA,T49,Jason Dufner,25,164,140,24,2010,total_driving,NA
NA,T49,Zach Johnson,25,164,156,8,2010,total_driving,NA
NA,T49,Martin Laird,26,164,20,144,2010,total_driving,NA
NA,T49,Troy Matteson,28,164,22,142,2010,total_driving,NA
NA,T49,Steve Stricker,19,164,134,30,2010,total_driving,NA
NA,T54,Aron Price,22,166,121,45,2010,total_driving,NA
NA,T54,Brett Wetterich,16,166,4,162,2010,total_driving,NA
NA,T56,Garth Mulroy,19,167,29,138,2010,total_driving,NA
NA,T56,Garrett Willis,24,167,153,14,2010,total_driving,NA
NA,T58,Paul Casey,17,169,35,134,2010,total_driving,NA
NA,T58,Justin Rose,22,169,97,72,2010,total_driving,NA
NA,T58,Heath Slocum,25,169,163,6,2010,total_driving,NA
NA,T61,Brendon de Jonge,32,170,105,65,2010,total_driving,NA
NA,T61,Sean O'Hair,25,170,78,92,2010,total_driving,NA
NA,T61,Y.E. Yang,21,170,88,82,2010,total_driving,NA
NA,T64,Henrik Bjornstad,26,171,93,78,2010,total_driving,NA
NA,T64,Roger Tambellini,26,171,53,118,2010,total_driving,NA
NA,T64,Nicholas Thompson,29,171,80,91,2010,total_driving,NA
NA,67,Pat Perez,27,172,102,70,2010,total_driving,NA
NA,T68,Jerry Kelly,29,173,160,13,2010,total_driving,NA
NA,T68,Michael Letzig,27,173,75,98,2010,total_driving,NA
NA,T70,Dustin Johnson,23,175,3,172,2010,total_driving,NA
NA,T70,John Mallinger,29,175,152,23,2010,total_driving,NA
NA,T70,James Nitties,30,175,112,63,2010,total_driving,NA
NA,T73,Robert Garrigus,22,176,1,175,2010,total_driving,NA
NA,T73,Mark Wilson,28,176,150,26,2010,total_driving,NA
NA,T75,Jason Day,24,178,15,163,2010,total_driving,NA
NA,T75,Chris DiMarco,25,178,160,18,2010,total_driving,NA
NA,T75,Skip Kendall,18,178,157,21,2010,total_driving,NA
NA,T75,Bubba Watson,22,178,2,176,2010,total_driving,NA
NA,79,Kevin Stadler,28,180,72,108,2010,total_driving,NA
NA,80,Dean Wilson,18,183,142,41,2010,total_driving,NA
NA,81,Aaron Baddeley,26,184,14,170,2010,total_driving,NA
NA,82,Alex Prugh,28,185,27,158,2010,total_driving,NA
NA,83,Richard Johnson,27,186,175,11,2010,total_driving,NA
NA,84,Matt Every,18,187,64,123,2010,total_driving,NA
NA,85,J.B. Holmes,26,188,5,183,2010,total_driving,NA
NA,T86,Alex Cejka,28,189,173,16,2010,total_driving,NA
NA,T86,Jim Furyk,21,189,179,10,2010,total_driving,NA
NA,T86,Cameron Tringale,22,189,32,157,2010,total_driving,NA
NA,T89,Ángel Cabrera,19,190,8,182,2010,total_driving,NA
NA,T89,Marc Leishman,26,190,31,159,2010,total_driving,NA
NA,T89,Greg Owen,27,190,60,130,2010,total_driving,NA
NA,T89,Ryan Palmer,27,190,26,164,2010,total_driving,NA
NA,T89,Omar Uresti,27,190,189,1,2010,total_driving,NA
NA,T94,K.J. Choi,22,191,131,60,2010,total_driving,NA
NA,T94,Steve Wheatcroft,27,191,102,89,2010,total_driving,NA
NA,T96,Tim Clark,24,192,188,4,2010,total_driving,NA
NA,T96,Steve Marino,24,192,68,124,2010,total_driving,NA
NA,T96,Rod Pampling,26,192,126,66,2010,total_driving,NA
NA,T96,Cameron Percy,25,192,36,156,2010,total_driving,NA
NA,T96,Scott Piercy,28,192,19,173,2010,total_driving,NA
NA,T101,Stephen Ames,23,193,138,55,2010,total_driving,NA
NA,T101,Jonathan Byrd,26,193,64,129,2010,total_driving,NA
NA,T103,Brian Davis,32,194,163,31,2010,total_driving,NA
NA,T103,Jeff Gove,22,194,86,108,2010,total_driving,NA
NA,T103,Justin Leonard,27,194,172,22,2010,total_driving,NA
NA,T106,John Daly,20,195,6,189,2010,total_driving,NA
NA,T106,Brian Gay,30,195,192,3,2010,total_driving,NA
NA,T106,Jeff Overton,26,195,18,177,2010,total_driving,NA
NA,T109,Craig Bowden,20,196,191,5,2010,total_driving,NA
NA,T109,Chris Riley,24,196,169,27,2010,total_driving,NA
NA,111,Paul Goydos,25,197,185,12,2010,total_driving,NA
NA,T112,Justin Bolli,23,199,141,58,2010,total_driving,NA
NA,T112,Jeff Maggert,28,199,159,40,2010,total_driving,NA
NA,T112,Chris Tidland,24,199,93,106,2010,total_driving,NA
NA,115,Trevor Immelman,19,200,110,90,2010,total_driving,NA
NA,T116,Woody Austin,29,201,147,54,2010,total_driving,NA
NA,T116,Matt Bettencourt,32,201,36,165,2010,total_driving,NA
NA,T116,Ben Curtis,24,201,182,19,2010,total_driving,NA
NA,T116,Phil Mickelson,20,201,13,188,2010,total_driving,NA
NA,T116,Jeff Quinney,29,201,186,15,2010,total_driving,NA
NA,T116,Scott Verplank,22,201,167,34,2010,total_driving,NA
NA,T122,Rocco Mediate,25,202,170,32,2010,total_driving,NA
NA,T122,Tom Pernice Jr.,22,202,154,48,2010,total_driving,NA
NA,T122,Andres Romero,21,202,24,178,2010,total_driving,NA
NA,T125,Martin Flores,26,203,11,192,2010,total_driving,NA
NA,T125,Camilo Villegas,20,203,77,126,2010,total_driving,NA
NA,T127,Briny Baird,28,204,138,66,2010,total_driving,NA
NA,T127,Jason Bohn,25,204,155,49,2010,total_driving,NA
NA,T129,Andrew McLardy,21,205,74,131,2010,total_driving,NA
NA,T129,Ted Purdy,30,205,66,139,2010,total_driving,NA
NA,131,Tim Petrovic,32,206,165,41,2010,total_driving,NA
NA,T132,James Driscoll,26,207,39,168,2010,total_driving,NA
NA,T132,Chris Wilson,26,207,58,149,2010,total_driving,NA
NA,134,Chris Stroud,27,208,101,107,2010,total_driving,NA
NA,135,Matt Jones,27,209,42,167,2010,total_driving,NA
NA,136,Brian Stuard,28,210,105,105,2010,total_driving,NA
NA,137,Cameron Beckman,25,211,115,96,2010,total_driving,NA
NA,138,D.A. Points,29,214,133,81,2010,total_driving,NA
NA,139,Charles Howell III,28,215,34,181,2010,total_driving,NA
NA,T140,Daniel Chopra,28,216,25,191,2010,total_driving,NA
NA,T140,Derek Lamely,28,216,36,180,2010,total_driving,NA
NA,142,Padraig Harrington,18,221,52,169,2010,total_driving,NA
NA,T143,Bill Lunde,28,222,85,137,2010,total_driving,NA
NA,T143,Ian Poulter,15,222,109,113,2010,total_driving,NA
NA,T145,J.P. Hayes,25,223,148,75,2010,total_driving,NA
NA,T145,Spencer Levin,31,223,150,73,2010,total_driving,NA
NA,T145,Kevin Na,26,223,167,56,2010,total_driving,NA
NA,T148,Brent Delahoussaye,21,225,181,44,2010,total_driving,NA
NA,T148,George McNeill,28,225,41,184,2010,total_driving,NA
NA,T148,Rory Sabbatini,26,225,82,143,2010,total_driving,NA
NA,151,David Lutterus,25,226,55,171,2010,total_driving,NA
NA,152,Michael Sim,20,228,127,101,2010,total_driving,NA
NA,T153,Steve Flesch,25,232,173,59,2010,total_driving,NA
NA,T153,Charlie Wi,27,232,146,86,2010,total_driving,NA
NA,155,Jimmy Walker,27,235,45,190,2010,total_driving,NA
NA,T156,Stuart Appleby,31,236,84,152,2010,total_driving,NA
NA,T156,Jeev Milkha Singh,19,236,100,136,2010,total_driving,NA
NA,T158,Ernie Els,20,237,90,147,2010,total_driving,NA
NA,T158,Steve Lowery,25,237,112,125,2010,total_driving,NA
NA,160,Shaun Micheel,21,242,128,114,2010,total_driving,NA
NA,T161,Michael Connell,25,243,144,99,2010,total_driving,NA
NA,T161,Roland Thatcher,26,243,95,148,2010,total_driving,NA
NA,163,Tim Herron,24,244,58,186,2010,total_driving,NA
NA,164,Troy Merritt,29,246,92,154,2010,total_driving,NA
NA,165,Lee Janzen,26,248,98,150,2010,total_driving,NA
NA,166,Carl Pettersson,29,249,137,112,2010,total_driving,NA
NA,167,Johnson Wagner,28,252,135,117,2010,total_driving,NA
NA,168,Freddie Jacobson,24,253,131,122,2010,total_driving,NA
NA,169,Bob Estes,26,257,125,132,2010,total_driving,NA
NA,170,Webb Simpson,31,258,118,140,2010,total_driving,NA
NA,171,Brandt Snedeker,26,260,176,84,2010,total_driving,NA
NA,172,Geoff Ogilvy,19,265,104,161,2010,total_driving,NA
NA,T173,Mark Calcavecchia,16,269,148,121,2010,total_driving,NA
NA,T173,Ryuji Imada,28,269,165,104,2010,total_driving,NA
NA,T173,Joe Ogilvie,32,269,114,155,2010,total_driving,NA
NA,T173,Brenden Pappas,24,269,90,179,2010,total_driving,NA
NA,177,David Duval,24,271,105,166,2010,total_driving,NA
NA,178,Kevin Johnson,26,272,178,94,2010,total_driving,NA
NA,T179,Bryce Molder,26,274,171,103,2010,total_driving,NA
NA,T179,Brett Quigley,29,274,128,146,2010,total_driving,NA
NA,181,Ricky Barnes,28,276,117,159,2010,total_driving,NA
NA,182,Michael Bradley,24,284,143,141,2010,total_driving,NA
NA,T183,Rich Barcelo,25,286,99,187,2010,total_driving,NA
NA,T183,Jerod Turner,21,286,160,126,2010,total_driving,NA
NA,185,Nathan Green,27,292,157,135,2010,total_driving,NA
NA,T186,Luke Donald,20,297,177,120,2010,total_driving,NA
NA,T186,Vance Veazey,23,297,123,174,2010,total_driving,NA
NA,188,Greg Kraft,22,306,187,119,2010,total_driving,NA
NA,189,Chad Collins,26,324,180,144,2010,total_driving,NA
NA,190,Greg Chalmers,27,333,182,151,2010,total_driving,NA
NA,191,Brad Faxon,23,343,190,153,2010,total_driving,NA
NA,192,Mike Weir,19,369,184,185,2010,total_driving,NA
NA,1,John Merrick,21,66,41,25,2011,total_driving,TRUE
NA,2,John Rollins,27,74,46,28,2011,total_driving,NA
NA,3,Brandt Jobe,28,76,33,43,2011,total_driving,NA
NA,4,Boo Weekley,23,79,48,31,2011,total_driving,NA
NA,5,Adam Scott,18,86,24,62,2011,total_driving,NA
NA,6,Chris Couch,21,93,44,49,2011,total_driving,NA
NA,7,Chez Reavie,27,95,71,24,2011,total_driving,NA
NA,8,John Senden,26,101,72,29,2011,total_driving,NA
NA,9,Bo Van Pelt,27,105,38,67,2011,total_driving,NA
NA,10,Josh Teater,31,113,15,98,2011,total_driving,NA
NA,11,Bill Haas,26,115,48,67,2011,total_driving,NA
NA,T12,Keegan Bradley,28,116,20,96,2011,total_driving,NA
NA,T12,Rod Pampling,21,116,84,32,2011,total_driving,NA
NA,14,Blake Adams,34,125,80,45,2011,total_driving,NA
NA,15,Brendan Steele,27,127,77,50,2011,total_driving,NA
NA,16,J.J. Henry,28,128,92,36,2011,total_driving,NA
NA,17,Briny Baird,19,129,112,17,2011,total_driving,NA
NA,T18,Billy Horschel,25,133,94,39,2011,total_driving,NA
NA,T18,Kyle Stanley,28,133,9,124,2011,total_driving,NA
NA,20,Charley Hoffman,27,136,22,114,2011,total_driving,NA
NA,T21,Scott McCarron,22,138,84,54,2011,total_driving,NA
NA,T21,Charl Schwartzel,15,138,43,95,2011,total_driving,NA
NA,23,Gary Woodland,25,142,5,137,2011,total_driving,NA
NA,24,Webb Simpson,26,143,51,92,2011,total_driving,NA
NA,25,Justin Hicks,23,145,132,13,2011,total_driving,NA
NA,T26,Martin Laird,23,147,13,134,2011,total_driving,NA
NA,T26,Graeme McDowell,16,147,109,38,2011,total_driving,NA
NA,T28,Steve Elkington,17,149,135,14,2011,total_driving,NA
NA,T28,Kevin Stadler,27,149,74,75,2011,total_driving,NA
NA,30,Dustin Johnson,21,150,3,147,2011,total_driving,NA
NA,T31,Joe Durant,25,152,151,1,2011,total_driving,NA
NA,T31,D.J. Trahan,30,152,31,121,2011,total_driving,NA
NA,T31,Nick Watney,22,152,16,136,2011,total_driving,NA
NA,34,Troy Matteson,28,153,21,132,2011,total_driving,NA
NA,T35,Will Strickler,19,154,10,144,2011,total_driving,NA
NA,T35,Bubba Watson,22,154,2,152,2011,total_driving,NA
NA,37,Bobby Gates,29,155,38,117,2011,total_driving,NA
NA,38,Pat Perez,24,156,90,66,2011,total_driving,NA
NA,39,D.A. Points,26,157,122,35,2011,total_driving,NA
NA,40,Davis Love III,22,158,33,125,2011,total_driving,NA
NA,T41,Woody Austin,18,160,120,40,2011,total_driving,NA
NA,T41,Jason Bohn,22,160,139,21,2011,total_driving,NA
NA,T43,Sung Kang,21,161,68,93,2011,total_driving,NA
NA,T43,Scott Piercy,23,161,7,154,2011,total_driving,NA
NA,T45,Tom Gillis,19,162,103,59,2011,total_driving,NA
NA,T45,Billy Mayfair,29,162,153,9,2011,total_driving,NA
NA,T45,Tag Ridings,28,162,12,150,2011,total_driving,NA
NA,T48,Brian Davis,30,163,153,10,2011,total_driving,NA
NA,T48,Mark Wilson,26,163,143,20,2011,total_driving,NA
NA,50,Scott Stallings,28,164,11,153,2011,total_driving,NA
NA,T51,Chad Campbell,29,165,92,73,2011,total_driving,NA
NA,T51,Ben Crane,23,165,139,26,2011,total_driving,NA
NA,T51,Heath Slocum,29,165,163,2,2011,total_driving,NA
NA,54,Steve Marino,23,166,59,107,2011,total_driving,NA
NA,T55,Sergio Garcia,16,167,28,139,2011,total_driving,NA
NA,T55,Lucas Glover,23,167,63,104,2011,total_driving,NA
NA,T55,Hunter Mahan,25,167,84,83,2011,total_driving,NA
NA,T58,David Hearn,26,168,96,72,2011,total_driving,NA
NA,T58,Carl Pettersson,27,168,81,87,2011,total_driving,NA
NA,T60,Jason Dufner,23,169,125,44,2011,total_driving,NA
NA,T60,Jim Herman,22,169,18,151,2011,total_driving,NA
NA,T60,Aron Price,18,169,158,11,2011,total_driving,NA
NA,63,Jeff Overton,26,170,58,112,2011,total_driving,NA
NA,64,Jim Renner,22,171,44,127,2011,total_driving,NA
NA,T65,Stephen Ames,22,172,150,22,2011,total_driving,NA
NA,T65,Andres Gonzales,21,172,75,97,2011,total_driving,NA
NA,T65,Cameron Tringale,32,172,66,106,2011,total_driving,NA
NA,T68,Zack Miller,30,173,25,148,2011,total_driving,NA
NA,T68,Justin Rose,23,173,99,74,2011,total_driving,NA
NA,70,Scott Gutschewski,23,174,36,138,2011,total_driving,NA
NA,71,Steven Bowditch,28,175,6,169,2011,total_driving,NA
NA,T72,Tommy Gainey,34,176,46,130,2011,total_driving,NA
NA,T72,Alex Prugh,29,176,31,145,2011,total_driving,NA
NA,T72,Kevin Streelman,26,176,111,65,2011,total_driving,NA
NA,75,Roland Thatcher,22,177,75,102,2011,total_driving,NA
NA,T76,Hunter Haas,30,178,114,64,2011,total_driving,NA
NA,T76,Kent Jones,25,178,137,41,2011,total_driving,NA
NA,78,Brendon de Jonge,30,179,119,60,2011,total_driving,NA
NA,T79,Joseph Bramlett,25,180,57,123,2011,total_driving,NA
NA,T79,Matt Kuchar,24,180,128,52,2011,total_driving,NA
NA,T79,Ben Martin,25,180,109,71,2011,total_driving,NA
NA,T79,George McNeill,21,180,60,120,2011,total_driving,NA
NA,T79,Ryan Moore,22,180,103,77,2011,total_driving,NA
NA,T84,Robert Allenby,25,181,100,81,2011,total_driving,NA
NA,T84,David Toms,23,181,175,6,2011,total_driving,NA
NA,T84,Jhonattan Vegas,25,181,8,173,2011,total_driving,NA
NA,T87,Rickie Fowler,24,182,25,157,2011,total_driving,NA
NA,T87,Jim Furyk,26,182,164,18,2011,total_driving,NA
NA,T87,Lee Janzen,19,182,103,79,2011,total_driving,NA
NA,T90,J.B. Holmes,16,183,1,182,2011,total_driving,NA
NA,T90,Charles Howell III,30,183,40,143,2011,total_driving,NA
NA,T90,Robert Karlsson,18,183,28,155,2011,total_driving,NA
NA,T90,Johnson Wagner,25,183,160,23,2011,total_driving,NA
NA,T94,Kevin Chappell,26,184,55,129,2011,total_driving,NA
NA,T94,Robert Garrigus,26,184,4,180,2011,total_driving,NA
NA,T94,Alexandre Rocha,22,184,96,88,2011,total_driving,NA
NA,T97,Ben Curtis,23,185,180,5,2011,total_driving,NA
NA,T97,Zach Johnson,23,185,177,8,2011,total_driving,NA
NA,T97,Brandt Snedeker,26,185,124,61,2011,total_driving,NA
NA,T100,Jason Day,21,186,14,172,2011,total_driving,NA
NA,T100,Jerry Kelly,26,186,183,3,2011,total_driving,NA
NA,T100,Chris Riley,25,186,174,12,2011,total_driving,NA
NA,T103,Geoff Ogilvy,21,188,106,82,2011,total_driving,NA
NA,T103,Vijay Singh,25,188,66,122,2011,total_driving,NA
NA,T103,Y.E. Yang,18,188,100,88,2011,total_driving,NA
NA,T106,Ángel Cabrera,17,189,19,170,2011,total_driving,NA
NA,T106,Nick O'Hern,29,189,182,7,2011,total_driving,NA
NA,T108,Brian Gay,26,190,186,4,2011,total_driving,NA
NA,T108,David Mathis,25,190,161,29,2011,total_driving,NA
NA,T108,Matt McQuillan,21,190,135,55,2011,total_driving,NA
NA,T108,Garrett Willis,24,190,171,19,2011,total_driving,NA
NA,T112,Rich Beem,21,192,129,63,2011,total_driving,NA
NA,T112,Bill Lunde,28,192,89,103,2011,total_driving,NA
NA,114,Fabián Gómez,26,194,116,78,2011,total_driving,NA
NA,T115,Shane Bertsch,20,195,168,27,2011,total_driving,NA
NA,T115,Bryce Molder,27,195,161,34,2011,total_driving,NA
NA,T117,James Driscoll,24,196,33,163,2011,total_driving,NA
NA,T117,Spencer Levin,31,196,127,69,2011,total_driving,NA
NA,119,Steve Stricker,19,198,113,85,2011,total_driving,NA
NA,T120,Jonathan Byrd,26,199,84,115,2011,total_driving,NA
NA,T120,Phil Mickelson,21,199,22,177,2011,total_driving,NA
NA,T122,Paul Goydos,25,200,185,15,2011,total_driving,NA
NA,T122,Rocco Mediate,23,200,184,16,2011,total_driving,NA
NA,T124,Harrison Frazar,19,201,17,184,2011,total_driving,NA
NA,T124,Ryan Palmer,24,201,25,176,2011,total_driving,NA
NA,126,Andres Romero,22,202,61,141,2011,total_driving,NA
NA,T127,Alex Cejka,21,204,167,37,2011,total_driving,NA
NA,T127,Luke Donald,19,204,147,57,2011,total_driving,NA
NA,T129,Ricky Barnes,23,205,72,133,2011,total_driving,NA
NA,T129,Vaughn Taylor,27,205,147,58,2011,total_driving,NA
NA,T129,Camilo Villegas,25,205,65,140,2011,total_driving,NA
NA,T132,Retief Goosen,16,206,107,99,2011,total_driving,NA
NA,T132,Ian Poulter,16,206,155,51,2011,total_driving,NA
NA,T134,Trevor Immelman,25,208,114,94,2011,total_driving,NA
NA,T134,Jimmy Walker,24,208,30,178,2011,total_driving,NA
NA,T136,Chris Stroud,28,210,91,119,2011,total_driving,NA
NA,T136,Michael Thompson,25,210,94,116,2011,total_driving,NA
NA,138,Chris DiMarco,31,211,178,33,2011,total_driving,NA
NA,139,Michael Putnam,21,212,41,171,2011,total_driving,NA
NA,140,J.P. Hayes,19,213,157,56,2011,total_driving,NA
NA,T141,Kris Blanks,29,215,139,76,2011,total_driving,NA
NA,T141,Justin Leonard,26,215,168,47,2011,total_driving,NA
NA,T141,Troy Merritt,23,215,125,90,2011,total_driving,NA
NA,T144,Aaron Baddeley,22,217,51,166,2011,total_driving,NA
NA,T144,Chris Kirk,28,217,56,161,2011,total_driving,NA
NA,T146,Michael Connell,26,218,173,45,2011,total_driving,NA
NA,T146,Colt Knost,27,218,176,42,2011,total_driving,NA
NA,T146,William McGirt,32,218,107,111,2011,total_driving,NA
NA,149,Tim Petrovic,29,219,166,53,2011,total_driving,NA
NA,150,Derek Lamely,26,222,37,185,2011,total_driving,NA
NA,151,Daniel Summerhays,29,223,139,84,2011,total_driving,NA
NA,152,K.J. Choi,22,225,134,91,2011,total_driving,NA
NA,T153,Tim Herron,28,227,81,146,2011,total_driving,NA
NA,T153,Sean O'Hair,24,227,63,164,2011,total_driving,NA
NA,T153,Dean Wilson,22,227,179,48,2011,total_driving,NA
NA,156,Marc Leishman,27,228,54,174,2011,total_driving,NA
NA,157,Freddie Jacobson,25,232,122,110,2011,total_driving,NA
NA,158,David Duval,24,233,50,183,2011,total_driving,NA
NA,T159,Bio Kim,25,234,53,181,2011,total_driving,NA
NA,T159,Rory Sabbatini,24,234,78,156,2011,total_driving,NA
NA,T159,Charlie Wi,25,234,133,101,2011,total_driving,NA
NA,T162,Ernie Els,21,235,118,117,2011,total_driving,NA
NA,T162,Marc Turnesa,20,235,155,80,2011,total_driving,NA
NA,164,Matt Jones,25,237,70,167,2011,total_driving,NA
NA,T165,Stewart Cink,22,240,81,159,2011,total_driving,NA
NA,T165,Padraig Harrington,18,240,61,179,2011,total_driving,NA
NA,167,Joe Ogilvie,24,242,84,158,2011,total_driving,NA
NA,168,Michael Bradley,24,247,98,149,2011,total_driving,NA
NA,169,Cameron Beckman,25,249,145,104,2011,total_driving,NA
NA,170,Richard Johnson,23,251,181,70,2011,total_driving,NA
NA,T171,Anthony Kim,26,254,68,186,2011,total_driving,NA
NA,T171,Kevin Kisner,24,254,145,109,2011,total_driving,NA
NA,T171,Martin Piller,23,254,79,175,2011,total_driving,NA
NA,174,Stuart Appleby,24,256,121,135,2011,total_driving,NA
NA,175,Greg Chalmers,28,258,172,86,2011,total_driving,NA
NA,176,Steve Flesch,27,259,159,100,2011,total_driving,NA
NA,177,Jarrod Lyle,29,260,129,131,2011,total_driving,NA
NA,178,Nathan Green,26,263,137,126,2011,total_driving,NA
NA,179,Ryuji Imada,29,265,152,113,2011,total_driving,NA
NA,180,D.J. Brigman,23,268,100,168,2011,total_driving,NA
NA,181,Nate Smith,24,272,165,107,2011,total_driving,NA
NA,T182,Matt Bettencourt,30,277,117,160,2011,total_driving,NA
NA,T182,Paul Stankowski,24,277,149,128,2011,total_driving,NA
NA,184,Shaun Micheel,27,294,129,165,2011,total_driving,NA
NA,185,Arjun Atwal,29,305,143,162,2011,total_driving,NA
NA,186,Kevin Na,26,312,170,142,2011,total_driving,NA
NA,1,Boo Weekley,25,74,36,38,2012,total_driving,TRUE
NA,2,Hunter Mahan,23,78,61,17,2012,total_driving,NA
NA,3,Bo Van Pelt,24,84,40,44,2012,total_driving,NA
NA,T4,Chris Couch,21,85,54,31,2012,total_driving,NA
NA,T4,Jason Dufner,22,85,64,21,2012,total_driving,NA
NA,6,Tiger Woods,19,87,32,55,2012,total_driving,NA
NA,7,Louis Oosthuizen,19,90,23,67,2012,total_driving,NA
NA,8,Brandt Jobe,18,91,25,66,2012,total_driving,NA
NA,9,John Rollins,26,98,47,51,2012,total_driving,NA
NA,10,Kevin Stadler,25,102,62,40,2012,total_driving,NA
NA,T11,Keegan Bradley,25,103,16,87,2012,total_driving,NA
NA,T11,John Senden,22,103,79,24,2012,total_driving,NA
NA,T13,John Merrick,26,105,58,47,2012,total_driving,NA
NA,T13,Lee Westwood,15,105,29,76,2012,total_driving,NA
NA,T15,Rickie Fowler,23,108,60,48,2012,total_driving,NA
NA,T15,Justin Rose,19,108,80,28,2012,total_driving,NA
NA,17,Billy Horschel,17,111,89,22,2012,total_driving,NA
NA,18,Roberto Castro,27,117,83,34,2012,total_driving,NA
NA,T19,Will Claxton,28,119,85,34,2012,total_driving,NA
NA,T19,Charley Hoffman,27,119,46,73,2012,total_driving,NA
NA,21,Brian Harman,30,120,87,33,2012,total_driving,NA
NA,22,Bill Haas,23,122,66,56,2012,total_driving,NA
NA,T23,Graham DeLaet,23,123,13,110,2012,total_driving,NA
NA,T23,Josh Teater,30,123,27,96,2012,total_driving,NA
NA,25,John Huh,28,124,113,11,2012,total_driving,NA
NA,26,Tom Gillis,23,126,103,23,2012,total_driving,NA
NA,27,Kyle Stanley,27,132,8,124,2012,total_driving,NA
NA,28,Adam Scott,16,133,10,123,2012,total_driving,NA
NA,29,Cameron Tringale,26,134,85,49,2012,total_driving,NA
NA,30,Charl Schwartzel,16,135,42,93,2012,total_driving,NA
NA,31,Bubba Watson,19,136,1,135,2012,total_driving,NA
NA,32,Vijay Singh,27,137,47,90,2012,total_driving,NA
NA,33,Blake Adams,32,139,112,27,2012,total_driving,NA
NA,T34,Charlie Beljan,22,141,2,139,2012,total_driving,NA
NA,T34,Graeme McDowell,16,141,136,5,2012,total_driving,NA
NA,T36,Richard Lee,24,144,134,10,2012,total_driving,NA
NA,T36,Pat Perez,23,144,75,69,2012,total_driving,NA
NA,38,Harris English,27,145,20,125,2012,total_driving,NA
NA,T39,Ryan Moore,24,146,117,29,2012,total_driving,NA
NA,T39,Seung-Yul Noh,28,146,19,127,2012,total_driving,NA
NA,T41,Sean O'Hair,24,149,31,118,2012,total_driving,NA
NA,T41,Henrik Stenson,15,149,96,53,2012,total_driving,NA
NA,43,Jeff Overton,29,150,68,82,2012,total_driving,NA
NA,T44,Russell Knox,23,152,132,20,2012,total_driving,NA
NA,T44,Kevin Streelman,26,152,63,89,2012,total_driving,NA
NA,46,Greg Owen,27,156,41,115,2012,total_driving,NA
NA,T47,Martin Laird,22,157,28,129,2012,total_driving,NA
NA,T47,Scott Stallings,27,157,17,140,2012,total_driving,NA
NA,T49,Bobby Gates,29,158,21,137,2012,total_driving,NA
NA,T49,Billy Mayfair,28,158,122,36,2012,total_driving,NA
NA,51,Ryan Palmer,24,159,15,144,2012,total_driving,NA
NA,T52,Robert Garrigus,26,160,3,157,2012,total_driving,NA
NA,T52,Jeff Maggert,27,160,141,19,2012,total_driving,NA
NA,T54,Rory McIlroy,16,161,5,156,2012,total_driving,NA
NA,T54,D.J. Trahan,27,161,66,95,2012,total_driving,NA
NA,T56,Sergio Garcia,16,162,64,98,2012,total_driving,NA
NA,T56,Dustin Johnson,19,162,4,158,2012,total_driving,NA
NA,58,Brendan Steele,24,163,105,58,2012,total_driving,NA
NA,59,Brendon de Jonge,31,164,105,59,2012,total_driving,NA
NA,60,Camilo Villegas,25,165,87,78,2012,total_driving,NA
NA,61,Geoff Ogilvy,20,168,90,78,2012,total_driving,NA
NA,T62,Davis Love III,20,169,39,130,2012,total_driving,NA
NA,T62,Rod Pampling,26,169,105,64,2012,total_driving,NA
NA,T64,Matt Kuchar,22,170,128,42,2012,total_driving,NA
NA,T64,Nick Watney,26,170,36,134,2012,total_driving,NA
NA,66,Erik Compton,26,171,33,138,2012,total_driving,NA
NA,T67,Ben Crane,23,172,122,50,2012,total_driving,NA
NA,T67,Garth Mulroy,20,172,55,117,2012,total_driving,NA
NA,T69,Gary Christian,28,173,164,9,2012,total_driving,NA
NA,T69,John Daly,15,173,9,164,2012,total_driving,NA
NA,T69,Scott Piercy,28,173,12,161,2012,total_driving,NA
NA,T72,Kris Blanks,23,174,148,26,2012,total_driving,NA
NA,T72,Chez Reavie,26,174,161,13,2012,total_driving,NA
NA,T74,Ángel Cabrera,20,175,22,153,2012,total_driving,NA
NA,T74,Jim Furyk,24,175,171,4,2012,total_driving,NA
NA,T76,Padraig Harrington,18,177,57,120,2012,total_driving,NA
NA,T76,Kyle Reifers,27,177,92,85,2012,total_driving,NA
NA,T76,Heath Slocum,29,177,175,2,2012,total_driving,NA
NA,79,J.J. Henry,28,178,115,63,2012,total_driving,NA
NA,T80,J.B. Holmes,25,179,6,173,2012,total_driving,NA
NA,T80,Roland Thatcher,21,179,104,75,2012,total_driving,NA
NA,T82,Zach Johnson,25,182,168,14,2012,total_driving,NA
NA,T82,John Mallinger,25,182,166,16,2012,total_driving,NA
NA,T82,Daniel Summerhays,26,182,101,81,2012,total_driving,NA
NA,T85,Tim Clark,20,183,180,3,2012,total_driving,NA
NA,T85,Jerry Kelly,26,183,182,1,2012,total_driving,NA
NA,T85,Carl Pettersson,26,183,35,148,2012,total_driving,NA
NA,88,Ian Poulter,15,184,145,39,2012,total_driving,NA
NA,89,Bud Cauley,28,186,74,112,2012,total_driving,NA
NA,90,Steve Wheatcroft,22,189,121,68,2012,total_driving,NA
NA,T91,Scott Brown,24,190,77,113,2012,total_driving,NA
NA,T91,Ken Duke,30,190,160,30,2012,total_driving,NA
NA,T91,Jason Kokrak,27,190,14,176,2012,total_driving,NA
NA,T91,Kevin Na,25,190,165,25,2012,total_driving,NA
NA,T91,David Toms,19,190,184,6,2012,total_driving,NA
NA,T91,Jhonattan Vegas,25,190,10,180,2012,total_driving,NA
NA,T91,Gary Woodland,22,190,18,172,2012,total_driving,NA
NA,T98,Stuart Appleby,24,191,159,32,2012,total_driving,NA
NA,T98,Jason Day,17,191,7,184,2012,total_driving,NA
NA,100,Ben Curtis,19,193,186,7,2012,total_driving,NA
NA,101,Chris Kirk,27,194,73,121,2012,total_driving,NA
NA,102,Mark Wilson,25,195,183,12,2012,total_driving,NA
NA,T103,Chris DiMarco,29,196,188,8,2012,total_driving,NA
NA,T103,David Hearn,28,196,124,72,2012,total_driving,NA
NA,T105,Brian Davis,29,197,179,18,2012,total_driving,NA
NA,T105,D.A. Points,29,197,152,45,2012,total_driving,NA
NA,T105,Chris Stroud,28,197,126,71,2012,total_driving,NA
NA,108,Tommy Gainey,32,198,33,165,2012,total_driving,NA
NA,109,Steve Stricker,19,199,138,61,2012,total_driving,NA
NA,T110,Harrison Frazar,20,200,30,170,2012,total_driving,NA
NA,T110,"Ted Potter, Jr.",25,200,148,52,2012,total_driving,NA
NA,T112,Hunter Haas,24,201,117,84,2012,total_driving,NA
NA,T112,Trevor Immelman,24,201,80,121,2012,total_driving,NA
NA,114,Webb Simpson,22,203,111,92,2012,total_driving,NA
NA,T115,Chad Campbell,27,204,90,114,2012,total_driving,NA
NA,T115,Colt Knost,29,204,189,15,2012,total_driving,NA
NA,T115,George McNeill,25,204,105,99,2012,total_driving,NA
NA,T115,Alexandre Rocha,21,204,147,57,2012,total_driving,NA
NA,T119,Ernie Els,22,206,51,155,2012,total_driving,NA
NA,T119,Troy Kelly,23,206,23,183,2012,total_driving,NA
NA,T121,Luke Donald,17,207,170,37,2012,total_driving,NA
NA,T121,Edward Loar,23,207,44,163,2012,total_driving,NA
NA,T123,Ricky Barnes,28,208,68,140,2012,total_driving,NA
NA,T123,Troy Matteson,32,208,26,182,2012,total_driving,NA
NA,125,Scott Dunlap,20,211,166,45,2012,total_driving,NA
NA,126,Kevin Chappell,29,212,58,154,2012,total_driving,NA
NA,127,Bill Lunde,25,215,84,131,2012,total_driving,NA
NA,T128,K.J. Choi,21,216,162,54,2012,total_driving,NA
NA,T128,Kyle Thompson,22,216,151,65,2012,total_driving,NA
NA,T130,Jason Bohn,28,217,174,43,2012,total_driving,NA
NA,T130,Robert Karlsson,17,217,50,167,2012,total_driving,NA
NA,T130,Kevin Kisner,24,217,116,101,2012,total_driving,NA
NA,133,Tim Herron,27,218,99,119,2012,total_driving,NA
NA,T134,Brandt Snedeker,22,219,110,109,2012,total_driving,NA
NA,T134,Jimmy Walker,28,219,38,181,2012,total_driving,NA
NA,T136,Matt Jones,19,221,55,166,2012,total_driving,NA
NA,T136,Charlie Wi,25,221,134,87,2012,total_driving,NA
NA,T138,Charles Howell III,29,222,51,171,2012,total_driving,NA
NA,T138,Danny Lee,26,222,72,150,2012,total_driving,NA
NA,T138,Rory Sabbatini,29,222,119,103,2012,total_driving,NA
NA,T138,Johnson Wagner,27,222,152,70,2012,total_driving,NA
NA,142,Dicky Pride,19,224,130,94,2012,total_driving,NA
NA,143,Martin Flores,30,226,49,177,2012,total_driving,NA
NA,144,Phil Mickelson,22,227,53,174,2012,total_driving,NA
NA,145,Cameron Beckman,26,228,142,86,2012,total_driving,NA
NA,T146,Mark Anderson,25,229,43,186,2012,total_driving,NA
NA,T146,Mathew Goggin,23,229,82,147,2012,total_driving,NA
NA,148,Gavin Coles,23,231,190,41,2012,total_driving,NA
NA,T149,Daniel Chopra,21,235,44,191,2012,total_driving,NA
NA,T149,Vaughn Taylor,26,235,129,106,2012,total_driving,NA
NA,T151,Sangmoon Bae,25,237,95,142,2012,total_driving,NA
NA,T151,Andres Romero,22,237,68,169,2012,total_driving,NA
NA,T153,Stephen Ames,20,238,155,83,2012,total_driving,NA
NA,T153,David Mathis,29,238,176,62,2012,total_driving,NA
NA,155,Matt Every,25,240,136,104,2012,total_driving,NA
NA,T156,Jonathan Byrd,21,241,96,145,2012,total_driving,NA
NA,T156,Miguel Angel Carballo,25,241,96,145,2012,total_driving,NA
NA,T158,Aaron Baddeley,22,243,68,175,2012,total_driving,NA
NA,T158,Greg Chalmers,25,243,163,80,2012,total_driving,NA
NA,T158,Rocco Mediate,23,243,169,74,2012,total_driving,NA
NA,161,Arjun Atwal,27,244,144,100,2012,total_driving,NA
NA,162,William McGirt,30,245,138,107,2012,total_driving,NA
NA,163,Bob Estes,23,247,142,105,2012,total_driving,NA
NA,164,Y.E. Yang,20,248,146,102,2012,total_driving,NA
NA,T165,Robert Allenby,27,251,124,127,2012,total_driving,NA
NA,T165,Nick O'Hern,26,251,191,60,2012,total_driving,NA
NA,T167,Brian Gay,28,254,177,77,2012,total_driving,NA
NA,T167,J.J. Killeen,33,254,94,160,2012,total_driving,NA
NA,169,Jonas Blixt,21,260,127,133,2012,total_driving,NA
NA,170,Freddie Jacobson,17,262,119,143,2012,total_driving,NA
NA,171,Stephen Gangluff,23,265,75,190,2012,total_driving,NA
NA,T172,James Driscoll,27,267,78,189,2012,total_driving,NA
NA,T172,Marc Leishman,23,267,99,168,2012,total_driving,NA
NA,174,Bryce Molder,25,269,178,91,2012,total_driving,NA
NA,175,Ryo Ishikawa,18,271,92,179,2012,total_driving,NA
NA,176,Sung Kang,30,282,133,149,2012,total_driving,NA
NA,T177,Stewart Cink,22,283,105,178,2012,total_driving,NA
NA,T177,Justin Leonard,26,283,172,111,2012,total_driving,NA
NA,T179,Tom Pernice Jr.,23,284,187,97,2012,total_driving,NA
NA,T179,Michael Thompson,25,284,158,126,2012,total_driving,NA
NA,181,Nathan Green,22,286,154,132,2012,total_driving,NA
NA,T182,Derek Lamely,25,289,102,187,2012,total_driving,NA
NA,T182,Patrick Sheehan,21,289,173,116,2012,total_driving,NA
NA,184,Tommy Biershenk,27,290,138,152,2012,total_driving,NA
NA,185,Marco Dawson,22,292,130,162,2012,total_driving,NA
NA,T186,Billy Hurley III,27,293,185,108,2012,total_driving,NA
NA,T186,Brendon Todd,29,293,157,136,2012,total_driving,NA
NA,188,Matt Bettencourt,31,299,114,185,2012,total_driving,NA
NA,189,Spencer Levin,26,306,155,151,2012,total_driving,NA
NA,190,Michael Bradley,23,336,148,188,2012,total_driving,NA
NA,191,Ryuji Imada,28,340,181,159,2012,total_driving,NA
NA,1,Graham DeLaet,26,53,19,34,2013,total_driving,TRUE
NA,2,Keegan Bradley,25,72,11,61,2013,total_driving,NA
NA,3,Henrik Stenson,18,73,66,7,2013,total_driving,NA
NA,4,Justin Rose,17,79,27,52,2013,total_driving,NA
NA,5,Jim Herman,19,82,17,65,2013,total_driving,NA
NA,6,Billy Horschel,26,92,42,50,2013,total_driving,NA
NA,7,Boo Weekley,27,94,66,28,2013,total_driving,NA
NA,T8,Hunter Mahan,25,98,73,25,2013,total_driving,NA
NA,T8,Jordan Spieth,23,98,80,18,2013,total_driving,NA
NA,10,D.J. Trahan,16,99,46,53,2013,total_driving,NA
NA,11,Brandt Jobe,19,100,57,43,2013,total_driving,NA
NA,12,Matt Jones,24,101,56,45,2013,total_driving,NA
NA,13,Nicholas Thompson,29,105,60,45,2013,total_driving,NA
NA,14,Adam Scott,16,107,23,84,2013,total_driving,NA
NA,15,Vaughn Taylor,16,112,75,37,2013,total_driving,NA
NA,16,Kevin Streelman,25,117,94,23,2013,total_driving,NA
NA,17,Tiger Woods,16,118,49,69,2013,total_driving,NA
NA,18,Kevin Stadler,25,124,75,49,2013,total_driving,NA
NA,19,Steve Stricker,13,127,124,3,2013,total_driving,NA
NA,20,Lucas Glover,23,128,43,85,2013,total_driving,NA
NA,21,Russell Henley,24,130,83,47,2013,total_driving,NA
NA,22,Bubba Watson,21,131,5,126,2013,total_driving,NA
NA,23,Brendon de Jonge,30,133,104,29,2013,total_driving,NA
NA,24,Chez Reavie,22,134,128,6,2013,total_driving,NA
NA,25,Lee Westwood,19,135,69,66,2013,total_driving,NA
NA,26,Nick Watney,26,136,63,73,2013,total_driving,NA
NA,T27,Kevin Chappell,24,139,52,87,2013,total_driving,NA
NA,T27,Charl Schwartzel,19,139,29,110,2013,total_driving,NA
NA,T29,Kyle Stanley,24,140,22,118,2013,total_driving,NA
NA,T29,Robert Streb,25,140,24,116,2013,total_driving,NA
NA,T31,George McNeill,21,142,106,36,2013,total_driving,NA
NA,T31,Josh Teater,24,142,43,99,2013,total_driving,NA
NA,33,Charlie Beljan,24,143,32,111,2013,total_driving,NA
NA,34,Martin Laird,21,144,46,98,2013,total_driving,NA
NA,35,Henrik Norlander,22,145,36,109,2013,total_driving,NA
NA,T36,Steve LeBrun,21,146,38,108,2013,total_driving,NA
NA,T36,Ryan Moore,22,146,130,16,2013,total_driving,NA
NA,38,John Huh,28,147,133,14,2013,total_driving,NA
NA,T39,Jason Dufner,22,148,107,41,2013,total_driving,NA
NA,T39,Tom Gillis,22,148,104,44,2013,total_driving,NA
NA,T39,Rory McIlroy,16,148,8,140,2013,total_driving,NA
NA,42,David Lingmerth,23,149,109,40,2013,total_driving,NA
NA,43,Gary Woodland,26,150,4,146,2013,total_driving,NA
NA,44,Roberto Castro,29,152,130,22,2013,total_driving,NA
NA,T45,Scott Brown,21,154,78,76,2013,total_driving,NA
NA,T45,Jason Day,21,154,16,138,2013,total_driving,NA
NA,T45,Brendan Steele,26,154,68,86,2013,total_driving,NA
NA,T48,Justin Hicks,25,155,146,9,2013,total_driving,NA
NA,T48,Ryan Palmer,22,155,10,145,2013,total_driving,NA
NA,T50,Sergio Garcia,17,156,64,92,2013,total_driving,NA
NA,T50,Charley Hoffman,23,156,40,116,2013,total_driving,NA
NA,T50,Eric Meierdierks,19,156,9,147,2013,total_driving,NA
NA,T50,Scott Stallings,27,156,30,126,2013,total_driving,NA
NA,54,Cameron Tringale,24,157,98,59,2013,total_driving,NA
NA,T55,J.J. Henry,26,158,119,39,2013,total_driving,NA
NA,T55,Bo Van Pelt,22,158,107,51,2013,total_driving,NA
NA,57,Mark Wilson,19,160,158,2,2013,total_driving,NA
NA,T58,Fabián Gómez,23,161,78,83,2013,total_driving,NA
NA,T58,Zach Johnson,24,161,153,8,2013,total_driving,NA
NA,T58,"Ted Potter, Jr.",22,161,144,17,2013,total_driving,NA
NA,T61,Pat Perez,22,162,71,91,2013,total_driving,NA
NA,T61,John Rollins,24,162,31,131,2013,total_driving,NA
NA,63,Brad Fritsch,24,163,26,137,2013,total_driving,NA
NA,T64,Harris English,26,164,35,129,2013,total_driving,NA
NA,T64,Rory Sabbatini,27,164,50,114,2013,total_driving,NA
NA,T66,Greg Owen,24,165,53,112,2013,total_driving,NA
NA,T66,Cameron Percy,21,165,45,120,2013,total_driving,NA
NA,T66,Y.E. Yang,19,165,101,64,2013,total_driving,NA
NA,T69,Brian Davis,28,166,153,13,2013,total_driving,NA
NA,T69,Derek Ernst,21,166,61,105,2013,total_driving,NA
NA,T69,Doug LaBelle II,23,166,145,21,2013,total_driving,NA
NA,T69,Webb Simpson,25,166,111,55,2013,total_driving,NA
NA,T69,Brian Stuard,25,166,134,32,2013,total_driving,NA
NA,74,Bill Haas,25,167,90,77,2013,total_driving,NA
NA,T75,Vijay Singh,19,168,91,77,2013,total_driving,NA
NA,T75,Andrew Svoboda,18,168,71,97,2013,total_driving,NA
NA,77,Robert Garrigus,22,169,7,162,2013,total_driving,NA
NA,T78,Nicolas Colsaerts,17,170,3,167,2013,total_driving,NA
NA,T78,Ben Kohles,25,170,151,19,2013,total_driving,NA
NA,T78,D.H. Lee,22,170,140,30,2013,total_driving,NA
NA,T81,Bob Estes,18,171,115,56,2013,total_driving,NA
NA,T81,Jeff Maggert,21,171,160,11,2013,total_driving,NA
NA,83,Sean O'Hair,22,172,14,158,2013,total_driving,NA
NA,T84,Jim Furyk,22,173,169,4,2013,total_driving,NA
NA,T84,Dustin Johnson,22,173,2,171,2013,total_driving,NA
NA,T84,Richard Lee,24,173,149,24,2013,total_driving,NA
NA,87,Morgan Hoffmann,20,175,32,143,2013,total_driving,NA
NA,T88,Martin Kaymer,17,176,87,89,2013,total_driving,NA
NA,T88,Graeme McDowell,16,176,161,15,2013,total_driving,NA
NA,T90,Will Claxton,24,178,116,62,2013,total_driving,NA
NA,T90,James Hahn,26,178,48,130,2013,total_driving,NA
NA,T90,Jerry Kelly,22,178,177,1,2013,total_driving,NA
NA,T90,Jason Kokrak,25,178,6,172,2013,total_driving,NA
NA,T94,Tim Clark,20,180,175,5,2013,total_driving,NA
NA,T94,Ken Duke,28,180,170,10,2013,total_driving,NA
NA,T94,Martin Flores,25,180,12,168,2013,total_driving,NA
NA,97,Luke List,24,181,1,180,2013,total_driving,NA
NA,98,Rickie Fowler,22,183,103,80,2013,total_driving,NA
NA,99,John Senden,25,184,82,102,2013,total_driving,NA
NA,T100,Chad Campbell,25,185,85,100,2013,total_driving,NA
NA,T100,Tag Ridings,24,185,15,170,2013,total_driving,NA
NA,102,Ricky Barnes,26,186,80,106,2013,total_driving,NA
NA,T103,Stuart Appleby,25,187,119,68,2013,total_driving,NA
NA,T103,Steven Bowditch,22,187,13,174,2013,total_driving,NA
NA,T103,K.J. Choi,24,187,156,31,2013,total_driving,NA
NA,T106,Peter Hanson,15,188,34,154,2013,total_driving,NA
NA,T106,David Toms,16,188,162,26,2013,total_driving,NA
NA,T108,Jin Park,20,189,177,12,2013,total_driving,NA
NA,T108,Carl Pettersson,24,189,70,119,2013,total_driving,NA
NA,T108,Shawn Stefani,21,189,25,164,2013,total_driving,NA
NA,T111,Scott Piercy,24,190,21,169,2013,total_driving,NA
NA,T111,Darron Stiles,20,190,170,20,2013,total_driving,NA
NA,T111,Camilo Villegas,23,190,59,131,2013,total_driving,NA
NA,T111,Charlie Wi,23,190,132,58,2013,total_driving,NA
NA,115,Daniel Summerhays,26,191,110,81,2013,total_driving,NA
NA,116,D.A. Points,28,192,138,54,2013,total_driving,NA
NA,117,Brian Harman,29,195,94,101,2013,total_driving,NA
NA,T118,Ángel Cabrera,21,196,40,156,2013,total_driving,NA
NA,T118,Seung-Yul Noh,25,196,18,178,2013,total_driving,NA
NA,T118,Jimmy Walker,24,196,20,176,2013,total_driving,NA
NA,121,Jeff Overton,24,197,55,142,2013,total_driving,NA
NA,T122,Chris Kirk,24,198,83,115,2013,total_driving,NA
NA,T122,Andres Romero,21,198,50,148,2013,total_driving,NA
NA,124,Troy Matteson,24,199,38,161,2013,total_driving,NA
NA,125,Jason Bohn,23,201,166,35,2013,total_driving,NA
NA,T126,Rod Pampling,16,204,129,75,2013,total_driving,NA
NA,T126,Brandt Snedeker,23,204,137,67,2013,total_driving,NA
NA,T128,Erik Compton,24,205,54,151,2013,total_driving,NA
NA,T128,Bobby Gates,20,205,28,177,2013,total_driving,NA
NA,T128,Robert Karlsson,18,205,98,107,2013,total_driving,NA
NA,131,Colt Knost,25,206,179,27,2013,total_driving,NA
NA,132,Ian Poulter,16,207,136,71,2013,total_driving,NA
NA,T133,Bryce Molder,24,209,176,33,2013,total_driving,NA
NA,T133,Geoff Ogilvy,19,209,114,95,2013,total_driving,NA
NA,135,Charles Howell III,26,210,37,173,2013,total_driving,NA
NA,T136,Brian Gay,24,212,170,42,2013,total_driving,NA
NA,T136,Dicky Pride,23,212,174,38,2013,total_driving,NA
NA,T138,David Mathis,24,213,142,71,2013,total_driving,NA
NA,T138,William McGirt,24,213,134,79,2013,total_driving,NA
NA,T140,Matt Every,28,214,91,123,2013,total_driving,NA
NA,T140,Justin Leonard,24,214,166,48,2013,total_driving,NA
NA,142,Patrick Reed,26,215,58,157,2013,total_driving,NA
NA,143,Bud Cauley,24,216,94,122,2013,total_driving,NA
NA,T144,Luke Donald,17,217,157,60,2013,total_driving,NA
NA,T144,Tommy Gainey,28,217,64,153,2013,total_driving,NA
NA,146,Trevor Immelman,24,218,124,94,2013,total_driving,NA
NA,T147,Ernie Els,19,220,77,143,2013,total_driving,NA
NA,T147,Luke Guthrie,27,220,127,93,2013,total_driving,NA
NA,T147,Aaron Watkins,19,220,163,57,2013,total_driving,NA
NA,T150,Scott Gardiner,23,221,87,134,2013,total_driving,NA
NA,T150,Ryo Ishikawa,23,221,62,159,2013,total_driving,NA
NA,152,Scott Langley,27,222,152,70,2013,total_driving,NA
NA,153,Stewart Cink,22,223,73,150,2013,total_driving,NA
NA,154,Padraig Harrington,17,224,89,135,2013,total_driving,NA
NA,155,John Merrick,23,226,122,104,2013,total_driving,NA
NA,T156,Greg Chalmers,25,227,165,62,2013,total_driving,NA
NA,T156,Marc Leishman,23,227,102,125,2013,total_driving,NA
NA,158,David Hearn,26,228,147,81,2013,total_driving,NA
NA,159,Ben Crane,21,234,139,95,2013,total_driving,NA
NA,160,Michael Thompson,22,236,148,88,2013,total_driving,NA
NA,161,Chris Stroud,26,237,164,73,2013,total_driving,NA
NA,162,Justin Bolli,23,238,149,89,2013,total_driving,NA
NA,163,Matt Kuchar,23,240,116,124,2013,total_driving,NA
NA,164,Phil Mickelson,21,242,93,149,2013,total_driving,NA
NA,165,Sangmoon Bae,26,247,112,135,2013,total_driving,NA
NA,166,Freddie Jacobson,19,252,97,155,2013,total_driving,NA
NA,167,Robert Allenby,24,257,116,141,2013,total_driving,NA
NA,168,Alistair Presnell,23,260,121,139,2013,total_driving,NA
NA,169,Aaron Baddeley,24,265,86,179,2013,total_driving,NA
NA,170,James Driscoll,23,266,100,166,2013,total_driving,NA
NA,171,Michael Bradley,21,272,112,160,2013,total_driving,NA
NA,172,Stephen Ames,19,274,141,133,2013,total_driving,NA
NA,173,Jonas Blixt,24,275,123,152,2013,total_driving,NA
NA,174,Ben Curtis,20,276,173,103,2013,total_driving,NA
NA,T175,David Lynn,22,280,159,121,2013,total_driving,NA
NA,T175,Lee Williams,22,280,168,112,2013,total_driving,NA
NA,177,Johnson Wagner,24,283,155,128,2013,total_driving,NA
NA,178,Tim Herron,15,299,124,175,2013,total_driving,NA
NA,179,Casey Wittenberg,27,308,143,165,2013,total_driving,NA
NA,180,Mike Weir,22,343,180,163,2013,total_driving,NA
NA,1,Lucas Glover,26,74,20,54,2014,total_driving,TRUE
NA,2,Henrik Stenson,15,78,64,14,2014,total_driving,NA
NA,3,Hunter Mahan,25,81,45,36,2014,total_driving,NA
NA,4,Hudson Swafford,26,82,33,49,2014,total_driving,NA
NA,5,Derek Ernst,28,83,38,45,2014,total_driving,NA
NA,T6,Kevin Chappell,28,84,43,41,2014,total_driving,NA
NA,T6,Shawn Stefani,17,84,31,53,2014,total_driving,NA
NA,8,Keegan Bradley,26,86,17,69,2014,total_driving,NA
NA,9,Graham DeLaet,24,89,14,75,2014,total_driving,NA
NA,10,Adam Scott,17,93,13,80,2014,total_driving,NA
NA,11,Billy Horschel,27,99,76,23,2014,total_driving,NA
NA,T12,Jhonattan Vegas,23,101,8,93,2014,total_driving,NA
NA,T12,Nick Watney,25,101,45,56,2014,total_driving,NA
NA,14,Bubba Watson,21,103,1,102,2014,total_driving,NA
NA,15,Boo Weekley,24,110,100,10,2014,total_driving,NA
NA,16,Rory McIlroy,17,111,3,108,2014,total_driving,NA
NA,17,Kevin Streelman,24,113,97,16,2014,total_driving,NA
NA,18,Louis Oosthuizen,16,119,21,98,2014,total_driving,NA
NA,19,Willy Wilcox,16,121,36,85,2014,total_driving,NA
NA,T20,Ben Martin,26,122,75,47,2014,total_driving,NA
NA,T20,Kyle Stanley,28,122,33,89,2014,total_driving,NA
NA,T22,Brendon de Jonge,31,123,106,17,2014,total_driving,NA
NA,T22,Russell Henley,29,123,61,62,2014,total_driving,NA
NA,24,Kevin Stadler,26,125,76,49,2014,total_driving,NA
NA,T25,Jim Herman,21,126,52,74,2014,total_driving,NA
NA,T25,Martin Laird,20,126,37,89,2014,total_driving,NA
NA,T27,J.J. Henry,28,128,82,46,2014,total_driving,NA
NA,T27,Justin Hicks,30,128,125,3,2014,total_driving,NA
NA,T27,Will MacKenzie,27,128,84,44,2014,total_driving,NA
NA,T27,Gary Woodland,25,128,9,119,2014,total_driving,NA
NA,T31,Sergio Garcia,16,130,57,73,2014,total_driving,NA
NA,T31,Hideki Matsuyama,24,130,51,79,2014,total_driving,NA
NA,33,Harris English,28,132,26,106,2014,total_driving,NA
NA,T34,Charlie Beljan,26,136,11,125,2014,total_driving,NA
NA,T34,Nicholas Thompson,30,136,114,22,2014,total_driving,NA
NA,T36,Bill Haas,28,137,73,64,2014,total_driving,NA
NA,T36,John Merrick,25,137,122,15,2014,total_driving,NA
NA,T38,Scott Brown,30,138,112,26,2014,total_driving,NA
NA,T38,Martin Kaymer,19,138,50,88,2014,total_driving,NA
NA,T38,Russell Knox,26,138,120,18,2014,total_driving,NA
NA,T38,Ryan Moore,24,138,129,9,2014,total_driving,NA
NA,T42,Rickie Fowler,26,141,33,108,2014,total_driving,NA
NA,T42,Robert Streb,21,141,25,116,2014,total_driving,NA
NA,T44,Chad Campbell,18,142,107,35,2014,total_driving,NA
NA,T44,Andrew Svoboda,24,142,111,31,2014,total_driving,NA
NA,46,Bo Van Pelt,25,143,78,65,2014,total_driving,NA
NA,47,Josh Teater,28,144,53,91,2014,total_driving,NA
NA,48,Brendan Steele,26,145,28,117,2014,total_driving,NA
NA,T49,Chris Kirk,28,146,80,66,2014,total_driving,NA
NA,T49,John Senden,27,146,95,51,2014,total_driving,NA
NA,51,Zach Johnson,26,147,141,6,2014,total_driving,NA
NA,52,Dustin Johnson,17,148,2,146,2014,total_driving,NA
NA,53,Jason Day,15,149,18,131,2014,total_driving,NA
NA,T54,Ángel Cabrera,23,151,12,139,2014,total_driving,NA
NA,T54,Charl Schwartzel,18,151,30,121,2014,total_driving,NA
NA,56,Robert Garrigus,25,153,7,146,2014,total_driving,NA
NA,T57,Brooks Koepka,16,156,6,150,2014,total_driving,NA
NA,T57,Matt Kuchar,24,156,136,20,2014,total_driving,NA
NA,T57,Ryan Palmer,23,156,23,133,2014,total_driving,NA
NA,60,John Peterson,25,157,102,55,2014,total_driving,NA
NA,61,Charley Hoffman,25,158,26,132,2014,total_driving,NA
NA,T62,Jim Furyk,21,159,155,4,2014,total_driving,NA
NA,T62,John Huh,28,159,134,25,2014,total_driving,NA
NA,T62,Michael Putnam,30,159,65,94,2014,total_driving,NA
NA,T65,Brad Fritsch,18,160,56,104,2014,total_driving,NA
NA,T65,Justin Rose,19,160,49,111,2014,total_driving,NA
NA,67,Wes Roach,22,161,65,96,2014,total_driving,NA
NA,68,Lee Westwood,18,162,71,91,2014,total_driving,NA
NA,69,Michael Thompson,22,164,93,71,2014,total_driving,NA
NA,70,Davis Love III,22,165,41,124,2014,total_driving,NA
NA,71,Paul Casey,16,166,65,101,2014,total_driving,NA
NA,T72,J.B. Holmes,24,168,4,164,2014,total_driving,NA
NA,T72,Webb Simpson,25,168,98,70,2014,total_driving,NA
NA,T72,Brian Stuard,29,168,137,31,2014,total_driving,NA
NA,75,Danny Lee,28,169,132,37,2014,total_driving,NA
NA,T76,Jason Kokrak,19,171,14,157,2014,total_driving,NA
NA,T76,Heath Slocum,23,171,166,5,2014,total_driving,NA
NA,T76,Daniel Summerhays,27,171,141,30,2014,total_driving,NA
NA,T79,Marc Leishman,24,173,32,141,2014,total_driving,NA
NA,T79,"Ted Potter, Jr.",24,173,162,11,2014,total_driving,NA
NA,T81,David Toms,20,174,173,1,2014,total_driving,NA
NA,T81,Camilo Villegas,29,174,68,106,2014,total_driving,NA
NA,T83,David Hearn,28,175,156,19,2014,total_driving,NA
NA,T83,Billy Hurley III,26,175,168,7,2014,total_driving,NA
NA,T85,Tim Clark,26,176,174,2,2014,total_driving,NA
NA,T85,Carl Pettersson,28,176,47,129,2014,total_driving,NA
NA,T85,Chris Stroud,25,176,119,57,2014,total_driving,NA
NA,T88,Matt Jones,25,177,41,136,2014,total_driving,NA
NA,T88,Graeme McDowell,17,177,165,12,2014,total_driving,NA
NA,T88,Mark Wilson,25,177,153,24,2014,total_driving,NA
NA,T88,Y.E. Yang,28,177,143,34,2014,total_driving,NA
NA,92,Scott Stallings,28,178,23,155,2014,total_driving,NA
NA,93,Ken Duke,25,179,171,8,2014,total_driving,NA
NA,94,Jonathan Byrd,24,180,102,78,2014,total_driving,NA
NA,T95,Jason Dufner,17,181,122,59,2014,total_driving,NA
NA,T95,Charles Howell III,29,181,9,172,2014,total_driving,NA
NA,T95,Andrew Loupe,22,181,4,177,2014,total_driving,NA
NA,T95,Brandt Snedeker,25,181,121,60,2014,total_driving,NA
NA,T99,Stewart Cink,25,182,61,121,2014,total_driving,NA
NA,T99,Jamie Lovemark,20,182,16,166,2014,total_driving,NA
NA,T99,Jeff Maggert,19,182,169,13,2014,total_driving,NA
NA,T99,Kevin Tway,23,182,55,127,2014,total_driving,NA
NA,T103,Sangmoon Bae,24,184,98,86,2014,total_driving,NA
NA,T103,Brian Davis,28,184,163,21,2014,total_driving,NA
NA,105,Ben Crane,25,186,157,29,2014,total_driving,NA
NA,T106,George McNeill,24,188,117,71,2014,total_driving,NA
NA,T106,Sean O'Hair,25,188,21,167,2014,total_driving,NA
NA,T108,Steven Bowditch,30,189,29,160,2014,total_driving,NA
NA,T108,Ian Poulter,17,189,102,87,2014,total_driving,NA
NA,T108,Vijay Singh,25,189,89,100,2014,total_driving,NA
NA,T111,Jason Bohn,25,190,151,39,2014,total_driving,NA
NA,T111,James Hahn,27,190,91,99,2014,total_driving,NA
NA,T111,Kevin Kisner,26,190,107,83,2014,total_driving,NA
NA,T111,Spencer Levin,20,190,150,40,2014,total_driving,NA
NA,T111,Brendon Todd,29,190,148,42,2014,total_driving,NA
NA,116,Brian Harman,32,191,94,97,2014,total_driving,NA
NA,117,William McGirt,29,193,160,33,2014,total_driving,NA
NA,118,Jerry Kelly,23,194,167,27,2014,total_driving,NA
NA,119,Jimmy Walker,27,195,19,176,2014,total_driving,NA
NA,T120,Martin Flores,26,196,44,152,2014,total_driving,NA
NA,T120,Kevin Na,27,196,148,48,2014,total_driving,NA
NA,T122,Roberto Castro,27,197,134,63,2014,total_driving,NA
NA,T122,Ben Curtis,24,197,154,43,2014,total_driving,NA
NA,T122,Cameron Tringale,31,197,139,58,2014,total_driving,NA
NA,T125,D.H. Lee,20,198,170,28,2014,total_driving,NA
NA,T125,D.A. Points,27,198,131,67,2014,total_driving,NA
NA,127,John Rollins,28,199,86,113,2014,total_driving,NA
NA,128,David Lingmerth,26,200,88,112,2014,total_driving,NA
NA,T129,Tommy Gainey,26,201,59,142,2014,total_driving,NA
NA,T129,Seung-Yul Noh,27,201,40,161,2014,total_driving,NA
NA,T131,Richard Lee,27,202,125,77,2014,total_driving,NA
NA,T131,Geoff Ogilvy,26,202,68,134,2014,total_driving,NA
NA,T133,Briny Baird,17,204,144,60,2014,total_driving,NA
NA,T133,K.J. Choi,23,204,152,52,2014,total_driving,NA
NA,T135,Bud Cauley,19,207,63,144,2014,total_driving,NA
NA,T135,Troy Merritt,20,207,124,83,2014,total_driving,NA
NA,137,Robert Allenby,29,208,127,81,2014,total_driving,NA
NA,T138,Gonzalo Fernandez-Castaño,25,210,102,108,2014,total_driving,NA
NA,T138,Trevor Immelman,28,210,74,136,2014,total_driving,NA
NA,T138,Troy Matteson,23,210,39,171,2014,total_driving,NA
NA,T138,Phil Mickelson,21,210,70,140,2014,total_driving,NA
NA,142,Morgan Hoffmann,32,213,48,165,2014,total_driving,NA
NA,143,Justin Leonard,22,215,177,38,2014,total_driving,NA
NA,144,Andres Romero,26,216,53,163,2014,total_driving,NA
NA,145,Rory Sabbatini,26,217,58,159,2014,total_driving,NA
NA,146,Jordan Spieth,27,218,89,129,2014,total_driving,NA
NA,T147,Brice Garnett,28,220,92,128,2014,total_driving,NA
NA,T147,Pat Perez,25,220,115,105,2014,total_driving,NA
NA,149,Patrick Reed,28,229,71,158,2014,total_driving,NA
NA,150,Luke Donald,17,231,164,67,2014,total_driving,NA
NA,151,Chesson Hadley,29,232,84,148,2014,total_driving,NA
NA,T152,Aaron Baddeley,24,235,60,175,2014,total_driving,NA
NA,T152,Luke Guthrie,26,235,109,126,2014,total_driving,NA
NA,154,Scott Langley,29,239,145,94,2014,total_driving,NA
NA,155,Bronson La'Cassie,18,241,127,114,2014,total_driving,NA
NA,156,Woody Austin,22,242,160,82,2014,total_driving,NA
NA,157,Ricky Barnes,27,244,82,162,2014,total_driving,NA
NA,158,Ernie Els,24,248,79,169,2014,total_driving,NA
NA,159,Ryo Ishikawa,24,249,80,169,2014,total_driving,NA
NA,160,Brian Gay,26,251,175,76,2014,total_driving,NA
NA,161,Retief Goosen,26,252,96,156,2014,total_driving,NA
NA,162,Freddie Jacobson,27,253,130,123,2014,total_driving,NA
NA,163,Jim Renner,25,254,101,153,2014,total_driving,NA
NA,T164,Jeff Overton,24,255,110,145,2014,total_driving,NA
NA,T164,Tyrone Van Aswegen,25,255,87,168,2014,total_driving,NA
NA,166,Tim Wilkinson,25,257,140,117,2014,total_driving,NA
NA,T167,Stuart Appleby,29,262,159,103,2014,total_driving,NA
NA,T167,Johnson Wagner,24,262,113,149,2014,total_driving,NA
NA,169,Matt Every,26,267,116,151,2014,total_driving,NA
NA,170,Jonas Blixt,21,271,117,154,2014,total_driving,NA
NA,171,Erik Compton,28,276,138,138,2014,total_driving,NA
NA,172,Bryce Molder,25,277,158,119,2014,total_driving,NA
NA,173,Greg Chalmers,27,281,147,134,2014,total_driving,NA
NA,174,Chad Collins,28,287,172,115,2014,total_driving,NA
NA,175,Charlie Wi,25,289,146,143,2014,total_driving,NA
NA,176,James Driscoll,25,306,132,174,2014,total_driving,NA
NA,177,Mike Weir,25,349,176,173,2014,total_driving,NA
NA,1,Henrik Stenson,16,55,43,12,2015,total_driving,TRUE
NA,2,Willy Wilcox,17,60,42,18,2015,total_driving,NA
NA,3,Keegan Bradley,24,62,10,52,2015,total_driving,NA
NA,4,Justin Rose,20,78,14,64,2015,total_driving,NA
NA,5,Graham DeLaet,22,79,32,47,2015,total_driving,NA
NA,6,Charlie Beljan,27,89,6,83,2015,total_driving,NA
NA,7,Russell Henley,24,90,36,54,2015,total_driving,NA
NA,8,Paul Casey,24,93,35,58,2015,total_driving,NA
NA,9,Jim Herman,27,95,62,33,2015,total_driving,NA
NA,10,Hudson Swafford,30,103,29,74,2015,total_driving,NA
NA,11,Lucas Glover,26,104,38,66,2015,total_driving,NA
NA,T12,Derek Ernst,26,106,50,56,2015,total_driving,NA
NA,T12,Hideki Matsuyama,25,106,57,49,2015,total_driving,NA
NA,14,Davis Love III,18,107,56,51,2015,total_driving,NA
NA,15,Adam Scott,15,111,4,107,2015,total_driving,NA
NA,T16,Brendan Steele,24,113,16,97,2015,total_driving,NA
NA,T16,Kevin Streelman,27,113,93,20,2015,total_driving,NA
NA,T18,Daniel Berger,31,122,18,104,2015,total_driving,NA
NA,T18,Billy Horschel,28,122,53,69,2015,total_driving,NA
NA,T20,Jason Gore,26,123,87,36,2015,total_driving,NA
NA,T20,Webb Simpson,22,123,97,26,2015,total_driving,NA
NA,T22,Rickie Fowler,21,126,39,87,2015,total_driving,NA
NA,T22,John Senden,24,126,89,37,2015,total_driving,NA
NA,24,Charl Schwartzel,19,127,24,103,2015,total_driving,NA
NA,25,Chez Reavie,19,128,125,3,2015,total_driving,NA
NA,26,Sam Saunders,28,130,68,62,2015,total_driving,NA
NA,T27,Kevin Chappell,26,132,67,65,2015,total_driving,NA
NA,T27,Shawn Stefani,26,132,44,88,2015,total_driving,NA
NA,29,Alex Prugh,27,138,49,89,2015,total_driving,NA
NA,30,David Lingmerth,28,139,93,46,2015,total_driving,NA
NA,31,John Peterson,25,140,110,30,2015,total_driving,NA
NA,32,Lee Westwood,15,144,25,119,2015,total_driving,NA
NA,33,Nicholas Thompson,31,146,127,19,2015,total_driving,NA
NA,T34,Jason Dufner,21,148,121,27,2015,total_driving,NA
NA,T34,Sergio Garcia,15,148,25,123,2015,total_driving,NA
NA,T34,Kevin Kisner,30,148,114,34,2015,total_driving,NA
NA,T34,Louis Oosthuizen,20,148,31,117,2015,total_driving,NA
NA,38,Carlos Ortiz,30,150,33,117,2015,total_driving,NA
NA,T39,Sean O'Hair,26,151,47,104,2015,total_driving,NA
NA,T39,Boo Weekley,24,151,76,75,2015,total_driving,NA
NA,41,Justin Thomas,30,152,15,137,2015,total_driving,NA
NA,42,Brooks Koepka,23,153,8,145,2015,total_driving,NA
NA,43,Francesco Molinari,16,154,153,1,2015,total_driving,NA
NA,T44,Bill Haas,25,155,82,73,2015,total_driving,NA
NA,T44,Spencer Levin,31,155,139,16,2015,total_driving,NA
NA,T44,John Merrick,27,155,133,22,2015,total_driving,NA
NA,T44,Patrick Rodgers,17,155,9,146,2015,total_driving,NA
NA,T44,Bubba Watson,19,155,2,153,2015,total_driving,NA
NA,T49,Adam Hadwin,30,156,108,48,2015,total_driving,NA
NA,T49,Zach Johnson,25,156,148,8,2015,total_driving,NA
NA,51,Martin Laird,24,157,22,135,2015,total_driving,NA
NA,52,Jordan Spieth,25,158,78,80,2015,total_driving,NA
NA,T53,Ryan Moore,24,159,148,11,2015,total_driving,NA
NA,T53,Robert Streb,30,159,36,123,2015,total_driving,NA
NA,T53,Nick Watney,28,159,61,98,2015,total_driving,NA
NA,56,Ben Martin,27,160,110,50,2015,total_driving,NA
NA,57,Jonathan Byrd,22,162,117,45,2015,total_driving,NA
NA,T58,Russell Knox,28,164,136,28,2015,total_driving,NA
NA,T58,Ryan Palmer,22,164,13,151,2015,total_driving,NA
NA,T60,Jason Day,20,165,3,162,2015,total_driving,NA
NA,T60,Matt Jones,25,165,46,119,2015,total_driving,NA
NA,T62,James Hahn,28,166,50,116,2015,total_driving,NA
NA,T62,Dustin Johnson,21,166,1,165,2015,total_driving,NA
NA,T62,Jason Kokrak,28,166,11,155,2015,total_driving,NA
NA,65,Jamie Donaldson,16,167,54,113,2015,total_driving,NA
NA,T66,Jim Furyk,19,168,151,17,2015,total_driving,NA
NA,T66,Brian Harman,29,168,113,55,2015,total_driving,NA
NA,T66,Johnson Wagner,23,168,82,86,2015,total_driving,NA
NA,T69,Harris English,29,169,33,136,2015,total_driving,NA
NA,T69,Scott Piercy,28,169,41,128,2015,total_driving,NA
NA,T71,Robert Garrigus,25,170,20,150,2015,total_driving,NA
NA,T71,Charley Hoffman,28,170,29,141,2015,total_driving,NA
NA,T71,Gary Woodland,24,170,12,158,2015,total_driving,NA
NA,74,Chad Campbell,30,172,131,41,2015,total_driving,NA
NA,T75,Steven Alker,22,173,167,6,2015,total_driving,NA
NA,T75,Blayne Barber,26,173,103,70,2015,total_driving,NA
NA,T75,Cameron Tringale,28,173,152,21,2015,total_driving,NA
NA,T78,Brendon de Jonge,31,174,130,44,2015,total_driving,NA
NA,T78,John Huh,31,174,160,14,2015,total_driving,NA
NA,80,Jason Bohn,27,176,171,5,2015,total_driving,NA
NA,81,Pat Perez,26,178,135,43,2015,total_driving,NA
NA,T82,Tony Finau,31,179,7,172,2015,total_driving,NA
NA,T82,Jerry Kelly,24,179,170,9,2015,total_driving,NA
NA,T84,J.B. Holmes,25,180,5,175,2015,total_driving,NA
NA,T84,Colt Knost,29,180,173,7,2015,total_driving,NA
NA,T84,Matt Kuchar,25,180,104,76,2015,total_driving,NA
NA,T87,Hunter Mahan,24,181,50,131,2015,total_driving,NA
NA,T87,Sung Joon Park,27,181,139,42,2015,total_driving,NA
NA,T89,J.J. Henry,30,183,72,111,2015,total_driving,NA
NA,T89,William McGirt,30,183,158,25,2015,total_driving,NA
NA,T89,Phil Mickelson,19,183,22,161,2015,total_driving,NA
NA,T89,Greg Owen,19,183,62,121,2015,total_driving,NA
NA,T93,Oscar Fraustro,21,186,93,93,2015,total_driving,NA
NA,T93,Justin Leonard,22,186,182,4,2015,total_driving,NA
NA,T93,Bill Lunde,18,186,115,71,2015,total_driving,NA
NA,T93,George McNeill,27,186,126,60,2015,total_driving,NA
NA,T93,Geoff Ogilvy,15,186,64,122,2015,total_driving,NA
NA,T93,Brendon Todd,27,186,176,10,2015,total_driving,NA
NA,T93,David Toms,21,186,184,2,2015,total_driving,NA
NA,T93,Steve Wheatcroft,28,186,107,79,2015,total_driving,NA
NA,T101,Martin Flores,30,187,39,148,2015,total_driving,NA
NA,T101,Jhonattan Vegas,27,187,27,160,2015,total_driving,NA
NA,T103,Scott Pinckney,27,189,88,101,2015,total_driving,NA
NA,T103,Brian Stuard,31,189,174,15,2015,total_driving,NA
NA,T105,Scott Brown,30,190,108,82,2015,total_driving,NA
NA,T105,Roger Sloan,20,190,65,125,2015,total_driving,NA
NA,T105,Heath Slocum,22,190,177,13,2015,total_driving,NA
NA,T108,Ángel Cabrera,19,191,28,163,2015,total_driving,NA
NA,T108,Ken Duke,30,191,168,23,2015,total_driving,NA
NA,110,Ian Poulter,19,193,121,72,2015,total_driving,NA
NA,111,Steven Bowditch,32,194,18,176,2015,total_driving,NA
NA,T112,Charles Howell III,30,196,17,179,2015,total_driving,NA
NA,T112,Michael Putnam,28,196,101,95,2015,total_driving,NA
NA,114,Andres Gonzales,28,197,57,140,2015,total_driving,NA
NA,115,Gonzalo Fernandez-Castaño,28,198,98,100,2015,total_driving,NA
NA,T116,Cameron Percy,23,199,90,109,2015,total_driving,NA
NA,T116,Vijay Singh,23,199,85,114,2015,total_driving,NA
NA,T116,Bo Van Pelt,28,199,93,106,2015,total_driving,NA
NA,T119,Roberto Castro,16,200,160,40,2015,total_driving,NA
NA,T119,Rory Sabbatini,25,200,90,110,2015,total_driving,NA
NA,121,Jimmy Walker,24,201,21,180,2015,total_driving,NA
NA,T122,Zac Blair,34,203,180,23,2015,total_driving,NA
NA,T122,Mark Hubbard,25,203,165,38,2015,total_driving,NA
NA,T122,Chris Stroud,28,203,146,57,2015,total_driving,NA
NA,T125,Bryce Molder,26,204,169,35,2015,total_driving,NA
NA,T125,Brandt Snedeker,27,204,105,99,2015,total_driving,NA
NA,127,Kyle Reifers,31,206,112,94,2015,total_driving,NA
NA,T128,Sangmoon Bae,30,207,92,115,2015,total_driving,NA
NA,T128,Brian Davis,31,207,178,29,2015,total_driving,NA
NA,T130,Tom Hoge,26,208,74,134,2015,total_driving,NA
NA,T130,Danny Lee,36,208,145,63,2015,total_driving,NA
NA,T132,Alex Cejka,30,209,141,68,2015,total_driving,NA
NA,T132,Stewart Cink,23,209,65,144,2015,total_driving,NA
NA,T134,Jon Curran,28,211,179,32,2015,total_driving,NA
NA,T134,Carl Pettersson,32,211,81,130,2015,total_driving,NA
NA,136,Troy Merritt,29,212,131,81,2015,total_driving,NA
NA,137,Max Homa,27,213,59,154,2015,total_driving,NA
NA,T138,Ben Crane,22,214,183,31,2015,total_driving,NA
NA,T138,David Hearn,30,214,156,58,2015,total_driving,NA
NA,T140,Brice Garnett,29,215,119,96,2015,total_driving,NA
NA,T140,Morgan Hoffmann,26,215,45,170,2015,total_driving,NA
NA,T140,Mark Wilson,28,215,162,53,2015,total_driving,NA
NA,143,Byron Smith,21,216,77,139,2015,total_driving,NA
NA,144,Chris Kirk,21,218,128,90,2015,total_driving,NA
NA,T145,Billy Hurley III,28,220,181,39,2015,total_driving,NA
NA,T145,Scott Stallings,19,220,78,142,2015,total_driving,NA
NA,T147,Retief Goosen,25,222,71,151,2015,total_driving,NA
NA,T147,Marc Leishman,23,222,55,167,2015,total_driving,NA
NA,T149,Robert Allenby,25,225,147,78,2015,total_driving,NA
NA,T149,Andres Romero,24,225,47,178,2015,total_driving,NA
NA,151,Jonas Blixt,26,228,116,112,2015,total_driving,NA
NA,T152,Ernie Els,18,229,80,149,2015,total_driving,NA
NA,T152,Chesson Hadley,30,229,82,147,2015,total_driving,NA
NA,T152,Daniel Summerhays,29,229,137,92,2015,total_driving,NA
NA,155,Nick Taylor,28,231,72,159,2015,total_driving,NA
NA,T156,Chad Collins,24,232,166,66,2015,total_driving,NA
NA,T156,Erik Compton,28,232,105,127,2015,total_driving,NA
NA,T158,K.J. Choi,19,235,174,61,2015,total_driving,NA
NA,T158,Michael Thompson,27,235,98,137,2015,total_driving,NA
NA,T160,Greg Chalmers,17,239,154,85,2015,total_driving,NA
NA,T160,Seung-Yul Noh,21,239,70,169,2015,total_driving,NA
NA,T162,Patrick Reed,27,240,69,171,2015,total_driving,NA
NA,T162,Tim Wilkinson,28,240,163,77,2015,total_driving,NA
NA,164,Kevin Na,27,243,159,84,2015,total_driving,NA
NA,165,Aaron Baddeley,25,244,60,184,2015,total_driving,NA
NA,166,Andrew Svoboda,30,245,119,126,2015,total_driving,NA
NA,167,Fabián Gómez,26,246,144,102,2015,total_driving,NA
NA,168,Camilo Villegas,27,247,74,173,2015,total_driving,NA
NA,169,Scott Langley,28,248,157,91,2015,total_driving,NA
NA,170,Ryo Ishikawa,28,256,100,156,2015,total_driving,NA
NA,171,Whee Kim,23,258,150,108,2015,total_driving,NA
NA,172,Jeff Overton,30,266,134,132,2015,total_driving,NA
NA,173,Padraig Harrington,21,267,86,181,2015,total_driving,NA
NA,174,Luke Guthrie,27,271,138,133,2015,total_driving,NA
NA,175,Derek Fathauer,27,283,101,182,2015,total_driving,NA
NA,T176,Jonathan Randolph,25,284,118,166,2015,total_driving,NA
NA,T176,Jim Renner,27,284,141,143,2015,total_driving,NA
NA,178,Eric Axley,21,288,124,164,2015,total_driving,NA
NA,179,Luke Donald,20,301,172,129,2015,total_driving,NA
NA,T180,Matt Every,26,306,123,183,2015,total_driving,NA
NA,T180,Tyrone Van Aswegen,20,306,129,177,2015,total_driving,NA
NA,182,D.A. Points,26,312,155,157,2015,total_driving,NA
NA,183,Ricky Barnes,27,315,141,174,2015,total_driving,NA
NA,184,Andrew Putnam,23,332,164,168,2015,total_driving,NA
NA,1,Keegan Bradley,26,64,27,37,2016,total_driving,TRUE
NA,2,Lucas Glover,23,75,35,40,2016,total_driving,NA
NA,3,Hudson Swafford,30,81,7,74,2016,total_driving,NA
NA,4,Emiliano Grillo,25,84,67,17,2016,total_driving,NA
NA,5,Andrew Landry,18,85,59,26,2016,total_driving,NA
NA,6,Rory McIlroy,18,86,9,77,2016,total_driving,NA
NA,7,Paul Casey,22,90,54,36,2016,total_driving,NA
NA,8,Thomas Aiken,23,91,89,2,2016,total_driving,NA
NA,9,Sergio Garcia,15,98,28,70,2016,total_driving,NA
NA,10,Scott Pinckney,29,99,43,56,2016,total_driving,NA
NA,11,Boo Weekley,26,100,84,16,2016,total_driving,NA
NA,12,Shane Lowry,17,101,32,69,2016,total_driving,NA
NA,13,Russell Henley,25,103,48,55,2016,total_driving,NA
NA,14,Jim Herman,29,112,87,25,2016,total_driving,NA
NA,15,Brendan Steele,25,114,20,94,2016,total_driving,NA
NA,16,Scott Brown,27,123,76,47,2016,total_driving,NA
NA,17,Jason Kokrak,28,125,6,119,2016,total_driving,NA
NA,T18,Si Woo Kim,34,126,69,57,2016,total_driving,NA
NA,T18,Harold Varner III,28,126,22,104,2016,total_driving,NA
NA,20,Jason Dufner,28,128,70,58,2016,total_driving,NA
NA,T21,Graham DeLaet,21,132,37,95,2016,total_driving,NA
NA,T21,Hideki Matsuyama,23,132,65,67,2016,total_driving,NA
NA,T21,Sean O'Hair,27,132,20,112,2016,total_driving,NA
NA,T21,Brett Stegmaier,29,132,52,80,2016,total_driving,NA
NA,T25,Kevin Chappell,27,133,46,87,2016,total_driving,NA
NA,T25,Chez Reavie,27,133,123,10,2016,total_driving,NA
NA,T27,Rickie Fowler,23,136,23,113,2016,total_driving,NA
NA,T27,Brooks Koepka,21,136,19,117,2016,total_driving,NA
NA,29,Wes Roach,21,137,59,78,2016,total_driving,NA
NA,T30,Kevin Kisner,27,138,105,33,2016,total_driving,NA
NA,T30,Scott Piercy,24,138,37,101,2016,total_driving,NA
NA,32,Louis Oosthuizen,17,139,68,71,2016,total_driving,NA
NA,T33,Dustin Johnson,22,140,2,138,2016,total_driving,NA
NA,T33,Ryan Palmer,23,140,12,128,2016,total_driving,NA
NA,35,Adam Hadwin,27,141,92,49,2016,total_driving,NA
NA,36,Justin Rose,18,143,16,127,2016,total_driving,NA
NA,37,Kevin Streelman,26,144,104,40,2016,total_driving,NA
NA,T38,Russell Knox,25,145,137,8,2016,total_driving,NA
NA,T38,Marc Leishman,25,145,55,90,2016,total_driving,NA
NA,T40,Brian Harman,31,146,95,51,2016,total_driving,NA
NA,T40,Jamie Lovemark,27,146,11,135,2016,total_driving,NA
NA,T40,Greg Owen,29,146,39,107,2016,total_driving,NA
NA,43,William McGirt,28,149,118,31,2016,total_driving,NA
NA,44,Kyle Stanley,28,150,112,38,2016,total_driving,NA
NA,45,Jason Gore,27,151,103,48,2016,total_driving,NA
NA,46,Kyle Reifers,34,153,123,30,2016,total_driving,NA
NA,T47,John Huh,28,154,145,9,2016,total_driving,NA
NA,T47,Gary Woodland,26,154,10,144,2016,total_driving,NA
NA,T49,Chad Campbell,28,155,116,39,2016,total_driving,NA
NA,T49,Roberto Castro,27,155,149,6,2016,total_driving,NA
NA,T49,Geoff Ogilvy,22,155,80,75,2016,total_driving,NA
NA,52,Billy Horschel,20,156,72,84,2016,total_driving,NA
NA,T53,Blayne Barber,27,157,97,60,2016,total_driving,NA
NA,T53,Patrick Rodgers,28,157,26,131,2016,total_driving,NA
NA,T55,Derek Ernst,20,159,63,96,2016,total_driving,NA
NA,T55,Bill Haas,24,159,97,62,2016,total_driving,NA
NA,T55,David Lingmerth,24,159,144,15,2016,total_driving,NA
NA,58,Matt Kuchar,26,161,137,24,2016,total_driving,NA
NA,T59,Stewart Cink,19,162,42,120,2016,total_driving,NA
NA,T59,Rod Pampling,18,162,117,45,2016,total_driving,NA
NA,T59,Jhonattan Vegas,27,162,14,148,2016,total_driving,NA
NA,T62,Henrik Norlander,21,164,112,52,2016,total_driving,NA
NA,T62,Bubba Watson,19,164,4,160,2016,total_driving,NA
NA,64,Adam Scott,20,166,13,153,2016,total_driving,NA
NA,65,Jim Furyk,14,167,160,7,2016,total_driving,NA
NA,T66,Whee Kim,27,168,118,50,2016,total_driving,NA
NA,T66,Ryan Moore,23,168,150,18,2016,total_driving,NA
NA,T68,Spencer Levin,32,169,157,12,2016,total_driving,NA
NA,T68,Graeme McDowell,21,169,156,13,2016,total_driving,NA
NA,70,James Hahn,26,172,88,84,2016,total_driving,NA
NA,T71,Scott Langley,22,174,139,35,2016,total_driving,NA
NA,T71,Danny Lee,28,174,130,44,2016,total_driving,NA
NA,T71,Ben Martin,28,174,108,66,2016,total_driving,NA
NA,T71,Jordan Spieth,21,174,51,123,2016,total_driving,NA
NA,T71,Michael Thompson,23,174,85,89,2016,total_driving,NA
NA,76,Francesco Molinari,18,175,129,46,2016,total_driving,NA
NA,77,Willy Wilcox,23,176,73,103,2016,total_driving,NA
NA,T78,Alex Cejka,22,177,155,22,2016,total_driving,NA
NA,T78,Jerry Kelly,23,177,174,3,2016,total_driving,NA
NA,T78,Johnson Wagner,26,177,101,76,2016,total_driving,NA
NA,T81,Tony Finau,28,178,3,175,2016,total_driving,NA
NA,T81,Fabián Gómez,26,178,105,73,2016,total_driving,NA
NA,T83,David Hearn,29,179,158,21,2016,total_driving,NA
NA,T83,Sung Kang,29,179,77,102,2016,total_driving,NA
NA,T83,Sam Saunders,24,179,81,98,2016,total_driving,NA
NA,T86,Daniel Berger,26,180,34,146,2016,total_driving,NA
NA,T86,J.B. Holmes,22,180,1,179,2016,total_driving,NA
NA,T86,Brian Stuard,20,180,176,4,2016,total_driving,NA
NA,89,Rory Sabbatini,20,182,118,64,2016,total_driving,NA
NA,90,Nick Taylor,26,184,47,137,2016,total_driving,NA
NA,T91,Zac Blair,31,185,180,5,2016,total_driving,NA
NA,T91,Padraig Harrington,16,185,97,88,2016,total_driving,NA
NA,T91,Colt Knost,26,185,184,1,2016,total_driving,NA
NA,T91,Kelly Kraft,20,185,93,92,2016,total_driving,NA
NA,T95,Robert Garrigus,21,186,18,168,2016,total_driving,NA
NA,T95,Charl Schwartzel,19,186,44,142,2016,total_driving,NA
NA,T97,Ángel Cabrera,22,187,63,124,2016,total_driving,NA
NA,T97,Luke List,27,187,7,180,2016,total_driving,NA
NA,T99,Matt Jones,27,188,56,132,2016,total_driving,NA
NA,T99,Brandt Snedeker,27,188,75,113,2016,total_driving,NA
NA,101,Andrew Loupe,27,189,5,184,2016,total_driving,NA
NA,102,Scott Stallings,27,190,50,140,2016,total_driving,NA
NA,T103,Harris English,27,191,29,162,2016,total_driving,NA
NA,T103,Charles Howell III,25,191,17,174,2016,total_driving,NA
NA,T103,Martin Laird,24,191,33,158,2016,total_driving,NA
NA,T103,Justin Thomas,28,191,24,167,2016,total_driving,NA
NA,T107,Chesson Hadley,27,192,45,147,2016,total_driving,NA
NA,T107,Patrick Reed,28,192,41,151,2016,total_driving,NA
NA,T107,John Senden,28,192,95,97,2016,total_driving,NA
NA,T107,Robert Streb,27,192,59,133,2016,total_driving,NA
NA,111,Jason Bohn,21,193,179,14,2016,total_driving,NA
NA,T112,Morgan Hoffmann,25,195,66,129,2016,total_driving,NA
NA,T112,Hunter Mahan,22,195,56,139,2016,total_driving,NA
NA,T112,David Toms,19,195,184,11,2016,total_driving,NA
NA,T115,Jason Day,20,196,15,181,2016,total_driving,NA
NA,T115,Dicky Pride,21,196,173,23,2016,total_driving,NA
NA,T117,Steve Marino,24,197,79,118,2016,total_driving,NA
NA,T117,Webb Simpson,20,197,132,65,2016,total_driving,NA
NA,T119,Mark Hubbard,30,198,164,34,2016,total_driving,NA
NA,T119,Shawn Stefani,29,198,78,120,2016,total_driving,NA
NA,T121,Zach Johnson,24,199,167,32,2016,total_driving,NA
NA,T121,Kevin Na,26,199,170,29,2016,total_driving,NA
NA,T121,Vaughn Taylor,24,199,127,72,2016,total_driving,NA
NA,T124,K.J. Choi,22,200,180,20,2016,total_driving,NA
NA,T124,Charley Hoffman,26,200,36,164,2016,total_driving,NA
NA,T126,Smylie Kaufman,28,201,30,171,2016,total_driving,NA
NA,T126,Mark Wilson,21,201,182,19,2016,total_driving,NA
NA,T128,Billy Hurley III,20,204,176,28,2016,total_driving,NA
NA,T128,Chris Kirk,28,204,136,68,2016,total_driving,NA
NA,T128,Carlos Ortiz,29,204,31,173,2016,total_driving,NA
NA,131,Abraham Ancer,19,205,178,27,2016,total_driving,NA
NA,132,Branden Grace,18,206,48,158,2016,total_driving,NA
NA,T133,Bronson Burgoon,27,207,71,136,2016,total_driving,NA
NA,T133,Ken Duke,20,207,164,43,2016,total_driving,NA
NA,T133,Troy Merritt,26,207,126,81,2016,total_driving,NA
NA,T133,Jimmy Walker,25,207,24,183,2016,total_driving,NA
NA,137,Stuart Appleby,23,215,152,63,2016,total_driving,NA
NA,T138,Ben Crane,27,216,162,54,2016,total_driving,NA
NA,T138,Rhein Gibson,20,216,40,176,2016,total_driving,NA
NA,140,Chris Stroud,27,218,132,86,2016,total_driving,NA
NA,141,Phil Mickelson,22,219,56,163,2016,total_driving,NA
NA,142,Jonas Blixt,26,220,90,130,2016,total_driving,NA
NA,T143,Will MacKenzie,26,223,140,83,2016,total_driving,NA
NA,T143,Bryce Molder,26,223,164,59,2016,total_driving,NA
NA,145,Andres Gonzales,28,224,59,165,2016,total_driving,NA
NA,T146,Jon Curran,30,225,183,42,2016,total_driving,NA
NA,T146,George McNeill,23,225,147,78,2016,total_driving,NA
NA,148,J.J. Henry,24,227,123,104,2016,total_driving,NA
NA,T149,Steve Stricker,15,228,175,53,2016,total_driving,NA
NA,T149,Steve Wheatcroft,26,228,135,93,2016,total_driving,NA
NA,151,Daniel Summerhays,28,229,114,115,2016,total_driving,NA
NA,152,Hiroshi Iwata,29,230,108,122,2016,total_driving,NA
NA,153,Brendon de Jonge,30,231,122,109,2016,total_driving,NA
NA,T154,Anirban Lahiri,21,232,82,150,2016,total_driving,NA
NA,T154,Dawie van der Walt,25,232,91,141,2016,total_driving,NA
NA,T154,Tim Wilkinson,22,232,171,61,2016,total_driving,NA
NA,157,Seung-Yul Noh,28,234,52,182,2016,total_driving,NA
NA,158,Vijay Singh,22,236,93,143,2016,total_driving,NA
NA,159,Aaron Baddeley,28,237,82,155,2016,total_driving,NA
NA,160,Cameron Smith,24,240,132,108,2016,total_driving,NA
NA,T161,Martin Piller,22,241,130,111,2016,total_driving,NA
NA,T161,Cameron Tringale,25,241,142,99,2016,total_driving,NA
NA,T163,Patton Kizzire,27,243,86,157,2016,total_driving,NA
NA,T163,D.H. Lee,22,243,161,82,2016,total_driving,NA
NA,165,Ernie Els,21,244,74,170,2016,total_driving,NA
NA,166,Jeff Overton,25,249,143,106,2016,total_driving,NA
NA,167,Tom Hoge,26,252,100,152,2016,total_driving,NA
NA,168,D.A. Points,18,253,153,100,2016,total_driving,NA
NA,169,Luke Guthrie,19,256,102,154,2016,total_driving,NA
NA,170,Retief Goosen,16,257,108,149,2016,total_driving,NA
NA,171,Peter Malnati,32,260,169,91,2016,total_driving,NA
NA,172,Michael Kim,29,264,148,116,2016,total_driving,NA
NA,173,Tyler Aldridge,28,267,141,126,2016,total_driving,NA
NA,174,Freddie Jacobson,26,272,162,110,2016,total_driving,NA
NA,175,Ricky Barnes,29,284,118,166,2016,total_driving,NA
NA,176,Tyrone Van Aswegen,31,285,114,171,2016,total_driving,NA
NA,177,Derek Fathauer,30,289,111,178,2016,total_driving,NA
NA,T178,Steven Bowditch,26,292,107,185,2016,total_driving,NA
NA,T178,Brendon Todd,29,292,167,125,2016,total_driving,NA
NA,180,Luke Donald,23,295,151,144,2016,total_driving,NA
NA,181,Camilo Villegas,27,304,127,177,2016,total_driving,NA
NA,182,Chad Collins,26,305,171,134,2016,total_driving,NA
NA,T183,Erik Compton,24,314,145,169,2016,total_driving,NA
NA,T183,Rob Oppenheim,21,314,158,156,2016,total_driving,NA
NA,185,Robert Allenby,23,315,154,161,2016,total_driving,NA
NA,NA,Keegan Bradley,29,70,44,26,2017,total_driving,TRUE
NA,NA,Kyle Stanley,29,76,63,13,2017,total_driving,NA
NA,NA,Graham DeLaet,25,82,32,50,2017,total_driving,NA
NA,NA,Lucas Glover,26,88,51,37,2017,total_driving,NA
NA,NA,Rickie Fowler,21,98,39,59,2017,total_driving,NA
NA,NA,Rick Lamb,19,98,54,44,2017,total_driving,NA
NA,NA,Jim Herman,25,106,95,11,2017,total_driving,NA
NA,NA,Francesco Molinari,21,106,99,7,2017,total_driving,NA
NA,NA,Martin Laird,25,109,66,43,2017,total_driving,NA
NA,NA,Brendan Steele,25,112,41,71,2017,total_driving,NA
NA,NA,Kevin Streelman,26,113,84,29,2017,total_driving,NA
NA,NA,Sergio Garcia,17,114,33,81,2017,total_driving,NA
NA,NA,Hudson Swafford,28,114,22,92,2017,total_driving,NA
NA,NA,Paul Casey,24,115,60,55,2017,total_driving,NA
NA,NA,Boo Weekley,27,115,113,2,2017,total_driving,NA
NA,NA,Shane Lowry,16,116,74,42,2017,total_driving,NA
NA,NA,Russell Henley,27,120,56,64,2017,total_driving,NA
NA,NA,Patrick Cantlay,13,126,47,79,2017,total_driving,NA
NA,NA,Emiliano Grillo,25,129,91,38,2017,total_driving,NA
NA,NA,Gary Woodland,26,129,13,116,2017,total_driving,NA
NA,NA,Bubba Watson,22,130,21,109,2017,total_driving,NA
NA,NA,Sam Saunders,24,133,88,45,2017,total_driving,NA
NA,NA,Jason Kokrak,28,134,20,114,2017,total_driving,NA
NA,NA,Hunter Mahan,26,134,78,56,2017,total_driving,NA
NA,NA,Jason Dufner,24,136,78,58,2017,total_driving,NA
NA,NA,Jon Rahm,23,136,19,117,2017,total_driving,NA
NA,NA,Richy Werenski,26,136,106,30,2017,total_driving,NA
NA,NA,Harold Varner III,31,137,29,108,2017,total_driving,NA
NA,NA,Tony Finau,29,143,9,134,2017,total_driving,NA
NA,NA,Xander Schauffele,28,143,15,128,2017,total_driving,NA
NA,NA,Rory Sabbatini,23,144,103,41,2017,total_driving,NA
NA,NA,Billy Horschel,28,145,43,102,2017,total_driving,NA
NA,NA,Kevin Kisner,28,145,122,23,2017,total_driving,NA
NA,NA,J.J. Spaun,29,145,105,40,2017,total_driving,NA
NA,NA,Julián Etulain,22,146,89,57,2017,total_driving,NA
NA,NA,Robert Garrigus,26,146,36,110,2017,total_driving,NA
NA,NA,Dustin Johnson,20,146,2,144,2017,total_driving,NA
NA,NA,Ryan Moore,24,146,129,17,2017,total_driving,NA
NA,NA,James Hahn,28,147,86,61,2017,total_driving,NA
NA,NA,Russell Knox,24,151,129,22,2017,total_driving,NA
NA,NA,Tag Ridings,20,151,30,121,2017,total_driving,NA
NA,NA,J.J. Henry,29,152,83,69,2017,total_driving,NA
NA,NA,Kevin Chappell,27,154,24,130,2017,total_driving,NA
NA,NA,Ben Martin,27,154,102,52,2017,total_driving,NA
NA,NA,Hideki Matsuyama,22,157,27,130,2017,total_driving,NA
NA,NA,Sean O'Hair,25,157,58,99,2017,total_driving,NA
NA,NA,Chez Reavie,28,157,152,5,2017,total_driving,NA
NA,NA,William McGirt,28,158,152,6,2017,total_driving,NA
NA,NA,Justin Rose,18,158,40,118,2017,total_driving,NA
NA,NA,Daniel Berger,26,159,63,96,2017,total_driving,NA
NA,NA,Luke List,31,159,4,155,2017,total_driving,NA
NA,NA,Rory McIlroy,14,159,1,158,2017,total_driving,NA
NA,NA,Grayson Murray,30,160,12,148,2017,total_driving,NA
NA,NA,Anirban Lahiri,22,161,60,101,2017,total_driving,NA
NA,NA,Matt Jones,20,164,28,136,2017,total_driving,NA
NA,NA,Ryan Palmer,20,164,26,138,2017,total_driving,NA
NA,NA,Zach Johnson,23,165,140,25,2017,total_driving,NA
NA,NA,Jamie Lovemark,28,166,25,141,2017,total_driving,NA
NA,NA,Chad Campbell,29,167,147,20,2017,total_driving,NA
NA,NA,Bud Cauley,28,167,67,100,2017,total_driving,NA
NA,NA,Adam Scott,16,167,18,149,2017,total_driving,NA
NA,NA,Scott Brown,29,168,119,49,2017,total_driving,NA
NA,NA,Brett Stegmaier,27,168,122,46,2017,total_driving,NA
NA,NA,Bryson DeChambeau,31,170,46,124,2017,total_driving,NA
NA,NA,Louis Oosthuizen,18,170,73,97,2017,total_driving,NA
NA,NA,Jhonattan Vegas,29,170,35,135,2017,total_driving,NA
NA,NA,Sung Kang,32,171,65,106,2017,total_driving,NA
NA,NA,Shawn Stefani,26,171,84,87,2017,total_driving,NA
NA,NA,Chris Stroud,22,172,140,32,2017,total_driving,NA
NA,NA,Adam Hadwin,28,173,110,63,2017,total_driving,NA
NA,NA,Danny Lee,32,173,108,65,2017,total_driving,NA
NA,NA,Brooks Koepka,24,174,6,168,2017,total_driving,NA
NA,NA,Vaughn Taylor,26,175,161,14,2017,total_driving,NA
NA,NA,Morgan Hoffmann,29,176,86,90,2017,total_driving,NA
NA,NA,Ryan Armour,20,177,176,1,2017,total_driving,NA
NA,NA,Charley Hoffman,31,177,50,127,2017,total_driving,NA
NA,NA,Justin Thomas,25,177,8,169,2017,total_driving,NA
NA,NA,Webb Simpson,28,179,145,34,2017,total_driving,NA
NA,NA,Byeong Hun An,22,180,41,139,2017,total_driving,NA
NA,NA,Marc Leishman,25,180,51,129,2017,total_driving,NA
NA,NA,Nick Taylor,29,180,103,77,2017,total_driving,NA
NA,NA,Miguel Angel Carballo,22,181,127,54,2017,total_driving,NA
NA,NA,John Huh,28,182,135,47,2017,total_driving,NA
NA,NA,Smylie Kaufman,26,182,23,159,2017,total_driving,NA
NA,NA,Brandon Hagy,26,183,3,180,2017,total_driving,NA
NA,NA,Blayne Barber,25,184,106,78,2017,total_driving,NA
NA,NA,Matt Kuchar,26,184,148,36,2017,total_driving,NA
NA,NA,Graeme McDowell,17,184,174,10,2017,total_driving,NA
NA,NA,Trey Mullinax,28,184,11,173,2017,total_driving,NA
NA,NA,Steve Wheatcroft,17,184,169,15,2017,total_driving,NA
NA,NA,Alex Cejka,28,185,164,21,2017,total_driving,NA
NA,NA,Jason Day,20,185,15,170,2017,total_driving,NA
NA,NA,C.T. Pan,29,185,135,50,2017,total_driving,NA
NA,NA,Kyle Reifers,32,185,146,39,2017,total_driving,NA
NA,NA,Brian Campbell,20,186,67,119,2017,total_driving,NA
NA,NA,Chris Kirk,28,186,138,48,2017,total_driving,NA
NA,NA,David Lingmerth,23,186,114,72,2017,total_driving,NA
NA,NA,Scott Piercy,22,186,74,112,2017,total_driving,NA
NA,NA,Jordan Spieth,23,187,76,111,2017,total_driving,NA
NA,NA,Johnson Wagner,26,187,127,60,2017,total_driving,NA
NA,NA,Nick Watney,23,187,33,154,2017,total_driving,NA
NA,NA,Mackenzie Hughes,31,188,81,107,2017,total_driving,NA
NA,NA,Cameron Percy,23,188,95,93,2017,total_driving,NA
NA,NA,Kevin Tway,27,188,9,179,2017,total_driving,NA
NA,NA,K.J. Choi,25,189,163,26,2017,total_driving,NA
NA,NA,Brian Harman,30,189,116,73,2017,total_driving,NA
NA,NA,David Hearn,29,190,166,24,2017,total_driving,NA
NA,NA,Ryan Brehm,25,191,6,185,2017,total_driving,NA
NA,NA,Pat Perez,26,191,111,80,2017,total_driving,NA
NA,NA,Patrick Rodgers,27,191,15,176,2017,total_driving,NA
NA,NA,Spencer Levin,31,192,174,18,2017,total_driving,NA
NA,NA,J.T. Poston,28,192,77,115,2017,total_driving,NA
NA,NA,Brian Stuard,31,192,189,3,2017,total_driving,NA
NA,NA,Scott Stallings,27,193,56,137,2017,total_driving,NA
NA,NA,Ben Crane,26,194,178,16,2017,total_driving,NA
NA,NA,Jim Furyk,18,194,190,4,2017,total_driving,NA
NA,NA,Kelly Kraft,27,194,99,95,2017,total_driving,NA
NA,NA,Andrew Loupe,21,194,5,189,2017,total_driving,NA
NA,NA,Zac Blair,32,196,188,8,2017,total_driving,NA
NA,NA,Søren Kjeldsen,17,196,187,9,2017,total_driving,NA
NA,NA,Roberto Castro,25,198,170,28,2017,total_driving,NA
NA,NA,Ken Duke,26,198,186,12,2017,total_driving,NA
NA,NA,Andres Gonzales,24,198,45,153,2017,total_driving,NA
NA,NA,Troy Merritt,28,198,114,84,2017,total_driving,NA
NA,NA,Rafa Cabrera Bello,19,200,109,91,2017,total_driving,NA
NA,NA,Jonathan Randolph,22,200,133,67,2017,total_driving,NA
NA,NA,J.B. Holmes,23,201,14,187,2017,total_driving,NA
NA,NA,Steven Alker,23,202,183,19,2017,total_driving,NA
NA,NA,Daniel Summerhays,29,205,139,66,2017,total_driving,NA
NA,NA,Tim Wilkinson,22,206,173,33,2017,total_driving,NA
NA,NA,Geoff Ogilvy,25,210,142,68,2017,total_driving,NA
NA,NA,D.A. Points,22,211,180,31,2017,total_driving,NA
NA,NA,Brian Gay,25,212,177,35,2017,total_driving,NA
NA,NA,Jonas Blixt,25,214,120,94,2017,total_driving,NA
NA,NA,Rod Pampling,22,214,131,83,2017,total_driving,NA
NA,NA,Patrick Reed,29,214,72,142,2017,total_driving,NA
NA,NA,Robert Streb,30,214,81,133,2017,total_driving,NA
NA,NA,Martin Flores,27,215,38,177,2017,total_driving,NA
NA,NA,Harris English,27,217,31,186,2017,total_driving,NA
NA,NA,Cody Gribble,28,218,58,160,2017,total_driving,NA
NA,NA,Dominic Bozzelli,24,220,80,140,2017,total_driving,NA
NA,NA,Bill Haas,25,220,97,123,2017,total_driving,NA
NA,NA,Ollie Schniederjans,28,220,36,184,2017,total_driving,NA
NA,NA,Charl Schwartzel,18,220,49,171,2017,total_driving,NA
NA,NA,Michael Kim,28,221,116,105,2017,total_driving,NA
NA,NA,Jimmy Walker,21,222,71,151,2017,total_driving,NA
NA,NA,Fabián Gómez,21,223,148,75,2017,total_driving,NA
NA,NA,Charles Howell III,23,223,62,161,2017,total_driving,NA
NA,NA,Seung-Yul Noh,31,223,48,175,2017,total_driving,NA
NA,NA,Seamus Power,25,223,51,172,2017,total_driving,NA
NA,NA,Peter Malnati,29,224,162,62,2017,total_driving,NA
NA,NA,Retief Goosen,19,227,101,126,2017,total_driving,NA
NA,NA,Michael Thompson,21,228,152,76,2017,total_driving,NA
NA,NA,Brett Drewitt,19,229,144,85,2017,total_driving,NA
NA,NA,Ian Poulter,20,229,159,70,2017,total_driving,NA
NA,NA,Sebastián Muñoz,17,230,67,163,2017,total_driving,NA
NA,NA,Branden Grace,20,231,111,120,2017,total_driving,NA
NA,NA,Ryan Blaum,29,237,155,82,2017,total_driving,NA
NA,NA,Jason Bohn,28,237,185,52,2017,total_driving,NA
NA,NA,Stewart Cink,26,237,70,167,2017,total_driving,NA
NA,NA,Tyrone Van Aswegen,32,237,133,104,2017,total_driving,NA
NA,NA,Cameron Smith,26,239,93,146,2017,total_driving,NA
NA,NA,Brandt Snedeker,15,242,168,74,2017,total_driving,NA
NA,NA,Matt Every,30,243,55,188,2017,total_driving,NA
NA,NA,Kevin Na,26,245,157,88,2017,total_driving,NA
NA,NA,Phil Mickelson,22,246,89,157,2017,total_driving,NA
NA,NA,Mark Hubbard,27,249,160,89,2017,total_driving,NA
NA,NA,Mark Anderson,20,254,156,98,2017,total_driving,NA
NA,NA,Billy Hurley III,25,269,183,86,2017,total_driving,NA
NA,NA,Patton Kizzire,28,269,91,178,2017,total_driving,NA
NA,NA,Gonzalo Fernandez-Castaño,22,271,98,173,2017,total_driving,NA
NA,NA,Brad Fritsch,18,271,126,145,2017,total_driving,NA
NA,NA,Aaron Baddeley,20,274,93,181,2017,total_driving,NA
NA,NA,Si Woo Kim,30,277,125,152,2017,total_driving,NA
NA,NA,Chad Collins,26,278,165,113,2017,total_driving,NA
NA,NA,Nicholas Lindheim,21,282,135,147,2017,total_driving,NA
NA,NA,Greg Chalmers,28,283,181,102,2017,total_driving,NA
NA,NA,Whee Kim,27,283,118,165,2017,total_driving,NA
NA,NA,Camilo Villegas,25,286,122,164,2017,total_driving,NA
NA,NA,Cameron Tringale,28,289,167,122,2017,total_driving,NA
NA,NA,Wesley Bryan,28,297,172,125,2017,total_driving,NA
NA,NA,Tom Hoge,17,297,148,149,2017,total_driving,NA
NA,NA,Derek Fathauer,27,298,142,156,2017,total_driving,NA
NA,NA,Ryo Ishikawa,20,303,120,183,2017,total_driving,NA
NA,NA,Bryce Molder,26,314,182,132,2017,total_driving,NA
NA,NA,Ricky Barnes,31,316,151,165,2017,total_driving,NA
NA,NA,Ernie Els,20,319,157,162,2017,total_driving,NA
NA,NA,Luke Donald,18,321,178,143,2017,total_driving,NA
NA,NA,Steven Bowditch,27,322,132,190,2017,total_driving,NA
NA,NA,Carl Pettersson,27,352,170,182,2017,total_driving,NA
NA,1,Justin Rose,18,67,34,33,2018,total_driving,TRUE
NA,2,Tommy Fleetwood,19,72,23,49,2018,total_driving,NA
NA,3,Gary Woodland,27,73,7,66,2018,total_driving,NA
NA,4,Keegan Bradley,27,80,65,15,2018,total_driving,NA
NA,T5,Francesco Molinari,20,98,52,46,2018,total_driving,NA
NA,T5,Hudson Swafford,22,98,41,57,2018,total_driving,NA
NA,7,Bronson Burgoon,24,99,41,58,2018,total_driving,NA
NA,8,Rickie Fowler,20,101,61,40,2018,total_driving,NA
NA,9,Kyle Stanley,26,105,98,7,2018,total_driving,NA
NA,T10,Paul Casey,20,109,31,78,2018,total_driving,NA
NA,T10,Sam Ryder,26,109,87,22,2018,total_driving,NA
NA,12,Louis Oosthuizen,17,112,61,51,2018,total_driving,NA
NA,13,Aaron Wise,29,113,40,73,2018,total_driving,NA
NA,T14,Emiliano Grillo,25,114,106,8,2018,total_driving,NA
NA,T14,J.J. Spaun,27,114,82,32,2018,total_driving,NA
NA,16,Corey Conners,28,115,36,79,2018,total_driving,NA
NA,T17,Bryson DeChambeau,26,117,25,92,2018,total_driving,NA
NA,T17,Billy Horschel,27,117,100,17,2018,total_driving,NA
NA,T17,Adam Scott,21,117,29,88,2018,total_driving,NA
NA,T17,Xinjun Zhang,28,117,77,40,2018,total_driving,NA
NA,21,Kevin Chappell,23,118,17,101,2018,total_driving,NA
NA,22,Kevin Streelman,27,119,107,12,2018,total_driving,NA
NA,23,Brendan Steele,22,121,12,109,2018,total_driving,NA
NA,24,Rafa Cabrera Bello,20,123,107,16,2018,total_driving,NA
NA,25,Joel Dahmen,28,126,97,29,2018,total_driving,NA
NA,26,Scott Piercy,26,128,92,36,2018,total_driving,NA
NA,27,Lucas Glover,18,129,85,44,2018,total_driving,NA
NA,28,Dustin Johnson,20,131,6,125,2018,total_driving,NA
NA,29,Hideki Matsuyama,21,132,49,83,2018,total_driving,NA
NA,30,Russell Henley,23,134,125,9,2018,total_driving,NA
NA,31,Byeong Hun An,24,135,19,116,2018,total_driving,NA
NA,T32,Patrick Cantlay,23,136,38,98,2018,total_driving,NA
NA,T32,Hunter Mahan,21,136,90,46,2018,total_driving,NA
NA,T34,Tyler Duncan,31,137,112,25,2018,total_driving,NA
NA,T34,Patrick Rodgers,30,137,34,103,2018,total_driving,NA
NA,36,C.T. Pan,30,139,126,13,2018,total_driving,NA
NA,37,Henrik Stenson,16,140,139,1,2018,total_driving,NA
NA,T38,Daniel Berger,23,141,85,56,2018,total_driving,NA
NA,T38,Charles Howell III,28,141,54,87,2018,total_driving,NA
NA,40,James Hahn,26,142,77,65,2018,total_driving,NA
NA,T41,Branden Grace,18,145,74,71,2018,total_driving,NA
NA,T41,Keith Mitchell,29,145,10,135,2018,total_driving,NA
NA,T41,Jon Rahm,20,145,16,129,2018,total_driving,NA
NA,44,Ian Poulter,20,146,118,28,2018,total_driving,NA
NA,T45,Martin Laird,22,147,71,76,2018,total_driving,NA
NA,T45,Michael Thompson,19,147,93,54,2018,total_driving,NA
NA,T47,Justin Thomas,23,149,11,138,2018,total_driving,NA
NA,T47,Harold Varner III,27,149,18,131,2018,total_driving,NA
NA,49,Brice Garnett,30,150,91,59,2018,total_driving,NA
NA,50,Bubba Watson,24,151,9,142,2018,total_driving,NA
NA,T51,Kiradech Aphibarnrat,14,152,110,42,2018,total_driving,NA
NA,T51,Xander Schauffele,27,152,28,124,2018,total_driving,NA
NA,T53,Austin Cook,29,154,130,24,2018,total_driving,NA
NA,T53,Brian Harman,25,154,133,21,2018,total_driving,NA
NA,T55,Jason Day,20,155,14,141,2018,total_driving,NA
NA,T55,Russell Knox,27,155,137,18,2018,total_driving,NA
NA,T55,J.T. Poston,22,155,55,100,2018,total_driving,NA
NA,58,Matt Jones,23,156,30,126,2018,total_driving,NA
NA,T59,Satoshi Kodaira,18,157,118,39,2018,total_driving,NA
NA,T59,Shane Lowry,19,157,55,102,2018,total_driving,NA
NA,T59,Ryan Palmer,22,157,27,130,2018,total_driving,NA
NA,62,Jason Kokrak,29,158,15,143,2018,total_driving,NA
NA,T63,Sam Saunders,26,159,41,118,2018,total_driving,NA
NA,T63,Tiger Woods,18,159,32,127,2018,total_driving,NA
NA,65,Jordan Spieth,23,160,61,99,2018,total_driving,NA
NA,66,Jason Dufner,22,162,88,74,2018,total_driving,NA
NA,T67,Blayne Barber,22,163,110,53,2018,total_driving,NA
NA,T67,Brooks Koepka,17,163,8,155,2018,total_driving,NA
NA,T67,Sean O'Hair,22,163,44,119,2018,total_driving,NA
NA,70,Rory McIlroy,18,164,1,163,2018,total_driving,NA
NA,71,Abraham Ancer,30,165,96,69,2018,total_driving,NA
NA,T72,J.J. Henry,28,166,135,31,2018,total_driving,NA
NA,T72,Alex Noren,18,166,69,97,2018,total_driving,NA
NA,T74,Beau Hossler,28,167,58,109,2018,total_driving,NA
NA,T74,Ryan Moore,22,167,163,4,2018,total_driving,NA
NA,T74,Cameron Percy,16,167,99,68,2018,total_driving,NA
NA,T77,Graeme McDowell,20,171,121,50,2018,total_driving,NA
NA,T77,Adam Schenk,28,171,26,145,2018,total_driving,NA
NA,T79,Tyrrell Hatton,16,172,76,96,2018,total_driving,NA
NA,T79,Denny McCarthy,22,172,100,72,2018,total_driving,NA
NA,81,J.B. Holmes,24,174,24,150,2018,total_driving,NA
NA,T82,Kevin Kisner,25,176,146,30,2018,total_driving,NA
NA,T82,Chez Reavie,28,176,173,3,2018,total_driving,NA
NA,T82,Conrad Shindler,20,176,141,35,2018,total_driving,NA
NA,T82,Jhonattan Vegas,27,176,32,144,2018,total_driving,NA
NA,T86,Trey Mullinax,24,177,2,175,2018,total_driving,NA
NA,T86,Steve Wheatcroft,20,177,166,11,2018,total_driving,NA
NA,T88,Tony Finau,28,178,4,174,2018,total_driving,NA
NA,T88,Robert Garrigus,27,178,19,159,2018,total_driving,NA
NA,T90,Harris English,31,179,47,132,2018,total_driving,NA
NA,T90,Chesson Hadley,30,179,58,121,2018,total_driving,NA
NA,T90,Richy Werenski,32,179,135,44,2018,total_driving,NA
NA,T93,Troy Merritt,27,181,100,81,2018,total_driving,NA
NA,T93,Nick Watney,26,181,21,160,2018,total_driving,NA
NA,95,Tom Lovelady,28,183,3,180,2018,total_driving,NA
NA,96,Grayson Murray,22,184,22,162,2018,total_driving,NA
NA,97,Ethan Tracy,23,186,71,115,2018,total_driving,NA
NA,T98,Ryan Armour,32,187,185,2,2018,total_driving,NA
NA,T98,Luke List,29,187,5,182,2018,total_driving,NA
NA,T98,Pat Perez,23,187,144,43,2018,total_driving,NA
NA,T101,Fabián Gómez,28,190,142,48,2018,total_driving,NA
NA,T101,Jamie Lovemark,26,190,37,153,2018,total_driving,NA
NA,T101,Ben Silverman,28,190,152,38,2018,total_driving,NA
NA,104,Brian Gay,30,192,186,6,2018,total_driving,NA
NA,105,David Lingmerth,26,194,180,14,2018,total_driving,NA
NA,T106,Adam Hadwin,25,196,159,37,2018,total_driving,NA
NA,T106,Vaughn Taylor,25,196,176,20,2018,total_driving,NA
NA,T108,Matt Atkins,21,197,50,147,2018,total_driving,NA
NA,T108,Marc Leishman,25,197,80,117,2018,total_driving,NA
NA,110,Brian Stuard,32,198,193,5,2018,total_driving,NA
NA,111,Alex Cejka,24,199,172,27,2018,total_driving,NA
NA,112,Jim Furyk,15,200,190,10,2018,total_driving,NA
NA,T113,Kelly Kraft,31,201,167,34,2018,total_driving,NA
NA,T113,"Ted Potter, Jr.",28,201,178,23,2018,total_driving,NA
NA,T115,Stephan Jaeger,26,203,69,134,2018,total_driving,NA
NA,T115,Kevin Tway,31,203,13,190,2018,total_driving,NA
NA,T117,Bud Cauley,17,206,100,106,2018,total_driving,NA
NA,T117,Brandt Snedeker,25,206,122,84,2018,total_driving,NA
NA,T119,Ben Crane,21,207,188,19,2018,total_driving,NA
NA,T119,Charley Hoffman,25,207,67,140,2018,total_driving,NA
NA,T119,Webb Simpson,26,207,117,90,2018,total_driving,NA
NA,T122,David Hearn,21,209,183,26,2018,total_driving,NA
NA,T122,Chris Kirk,29,209,154,55,2018,total_driving,NA
NA,124,Lanto Griffin,26,215,46,169,2018,total_driving,NA
NA,T125,Brandon Harkins,30,216,38,178,2018,total_driving,NA
NA,T125,Seamus Power,28,216,45,171,2018,total_driving,NA
NA,127,Zach Johnson,25,217,154,63,2018,total_driving,NA
NA,T128,Cody Gribble,25,219,52,167,2018,total_driving,NA
NA,T128,Kevin Na,26,219,157,62,2018,total_driving,NA
NA,130,Scott Stallings,30,221,64,157,2018,total_driving,NA
NA,131,Talor Gooch,27,222,74,148,2018,total_driving,NA
NA,T132,Scott Brown,32,223,128,95,2018,total_driving,NA
NA,T132,Nate Lashley,17,223,115,108,2018,total_driving,NA
NA,T132,Shawn Stefani,25,223,65,158,2018,total_driving,NA
NA,T135,Andrew Landry,27,224,142,82,2018,total_driving,NA
NA,T135,Rory Sabbatini,27,224,130,94,2018,total_driving,NA
NA,T137,Ryan Blaum,28,225,165,60,2018,total_driving,NA
NA,T137,Chad Campbell,28,225,173,52,2018,total_driving,NA
NA,139,Ben Martin,20,227,157,70,2018,total_driving,NA
NA,T140,Stewart Cink,25,229,83,146,2018,total_driving,NA
NA,T140,Tom Hoge,31,229,140,89,2018,total_driving,NA
NA,T140,Andrew Putnam,28,229,116,113,2018,total_driving,NA
NA,T143,Mackenzie Hughes,28,231,109,122,2018,total_driving,NA
NA,T143,Nick Taylor,30,231,126,105,2018,total_driving,NA
NA,T145,Nicholas Lindheim,26,232,120,112,2018,total_driving,NA
NA,T145,Cameron Smith,24,232,81,151,2018,total_driving,NA
NA,147,Anirban Lahiri,24,233,114,119,2018,total_driving,NA
NA,T148,Martin Flores,29,234,58,176,2018,total_driving,NA
NA,T148,John Huh,29,234,170,64,2018,total_driving,NA
NA,T148,Danny Lee,30,234,148,86,2018,total_driving,NA
NA,T148,Rod Pampling,20,234,168,66,2018,total_driving,NA
NA,T152,Jonas Blixt,23,236,122,114,2018,total_driving,NA
NA,T152,Peter Uihlein,26,236,48,188,2018,total_driving,NA
NA,154,Johnson Wagner,21,237,176,61,2018,total_driving,NA
NA,155,Charl Schwartzel,20,238,67,171,2018,total_driving,NA
NA,156,Brett Stegmaier,21,239,100,139,2018,total_driving,NA
NA,157,Ollie Schniederjans,27,241,50,191,2018,total_driving,NA
NA,158,Patton Kizzire,29,242,77,165,2018,total_driving,NA
NA,159,Bill Haas,25,243,94,149,2018,total_driving,NA
NA,160,Matt Kuchar,24,244,169,75,2018,total_driving,NA
NA,161,Chris Stroud,27,245,154,91,2018,total_driving,NA
NA,162,Phil Mickelson,24,246,57,189,2018,total_driving,NA
NA,T163,Roberto Díaz,25,252,175,77,2018,total_driving,NA
NA,T163,Jonathan Randolph,25,252,159,93,2018,total_driving,NA
NA,T165,Dominic Bozzelli,20,253,89,164,2018,total_driving,NA
NA,T165,Si Woo Kim,31,253,146,107,2018,total_driving,NA
NA,T167,Patrick Reed,26,256,83,173,2018,total_driving,NA
NA,T167,Jimmy Walker,23,256,71,185,2018,total_driving,NA
NA,169,Kyle Thompson,22,260,181,79,2018,total_driving,NA
NA,170,Retief Goosen,20,264,94,170,2018,total_driving,NA
NA,171,Martin Piller,28,269,132,137,2018,total_driving,NA
NA,172,Jonathan Byrd,24,272,137,135,2018,total_driving,NA
NA,173,Zac Blair,20,277,192,85,2018,total_driving,NA
NA,174,Sung Kang,29,278,122,156,2018,total_driving,NA
NA,175,Matt Every,30,279,113,166,2018,total_driving,NA
NA,176,Whee Kim,30,283,179,104,2018,total_driving,NA
NA,177,William McGirt,26,284,161,123,2018,total_driving,NA
NA,178,Aaron Baddeley,27,291,105,186,2018,total_driving,NA
NA,T179,Peter Malnati,28,298,144,154,2018,total_driving,NA
NA,T179,D.A. Points,25,298,189,109,2018,total_driving,NA
NA,181,Tyrone Van Aswegen,31,303,151,152,2018,total_driving,NA
NA,182,Robert Streb,29,311,128,183,2018,total_driving,NA
NA,T183,Zecheng Dou,23,312,133,179,2018,total_driving,NA
NA,T183,Billy Hurley III,27,312,184,128,2018,total_driving,NA
NA,185,Greg Chalmers,20,320,187,133,2018,total_driving,NA
NA,186,Michael Kim,27,330,153,177,2018,total_driving,NA
NA,187,Andrew Yun,22,332,148,184,2018,total_driving,NA
NA,188,Ricky Barnes,22,341,148,193,2018,total_driving,NA
NA,189,Rob Oppenheim,26,343,182,161,2018,total_driving,NA
NA,190,Derek Fathauer,28,350,164,186,2018,total_driving,NA
NA,191,Daniel Summerhays,19,351,170,181,2018,total_driving,NA
NA,192,Cameron Tringale,26,353,161,192,2018,total_driving,NA
NA,193,Wesley Bryan,23,359,191,168,2018,total_driving,NA
NA,1,Brendan Steele,15,64,24,40,2019,total_driving,TRUE
NA,4,Paul Casey,14,75,62,13,2019,total_driving,NA
NA,2,Gary Woodland,16,77,8,69,2019,total_driving,NA
NA,3,Bryson DeChambeau,11,79,42,37,2019,total_driving,NA
NA,6,Louis Oosthuizen,11,84,49,35,2019,total_driving,NA
NA,5,Justin Harding,9,99,93,6,2019,total_driving,NA
NA,T9,Daniel Berger,12,103,69,34,2019,total_driving,NA
NA,12,Keegan Bradley,16,104,58,46,2019,total_driving,NA
NA,11,Emiliano Grillo,15,104,65,39,2019,total_driving,NA
NA,T7,Abraham Ancer,18,111,89,22,2019,total_driving,NA
NA,T9,Brooks Koepka,12,112,14,98,2019,total_driving,NA
NA,T7,Jon Rahm,13,114,19,95,2019,total_driving,NA
NA,15,Jason Kokrak,16,117,26,91,2019,total_driving,NA
NA,T13,Charles Howell III,18,122,43,79,2019,total_driving,NA
NA,16,Matt Kuchar,14,124,116,8,2019,total_driving,NA
NA,22,Corey Conners,17,129,85,44,2019,total_driving,NA
NA,T20,Joel Dahmen,20,132,112,20,2019,total_driving,NA
NA,T17,Troy Merritt,11,132,89,43,2019,total_driving,NA
NA,27,Hideki Matsuyama,14,134,23,111,2019,total_driving,NA
NA,19,Aaron Wise,14,134,30,104,2019,total_driving,NA
NA,T17,Tommy Fleetwood,11,136,47,89,2019,total_driving,NA
NA,T25,Alex Prugh,17,138,41,97,2019,total_driving,NA
NA,T23,Rickie Fowler,12,139,25,114,2019,total_driving,NA
NA,28,Carlos Ortiz,18,140,55,85,2019,total_driving,NA
NA,T20,Ian Poulter,12,141,109,32,2019,total_driving,NA
NA,T13,Tiger Woods,7,142,56,86,2019,total_driving,NA
NA,T30,Lucas Glover,16,146,78,68,2019,total_driving,NA
NA,T23,Jason Day,13,147,26,121,2019,total_driving,NA
NA,29,Kevin Streelman,18,148,124,24,2019,total_driving,NA
NA,T40,Bubba Watson,12,148,7,141,2019,total_driving,NA
NA,999,Thorbjørn Olesen,8,149,67,82,2019,total_driving,NA
NA,T50,Tyrrell Hatton,11,150,56,94,2019,total_driving,NA
NA,T30,Sungjae Im,23,154,93,61,2019,total_driving,NA
NA,T43,Scott Piercy,17,155,138,17,2019,total_driving,NA
NA,32,Lucas Bjerregaard,9,157,6,151,2019,total_driving,NA
NA,T25,Henrik Stenson,10,157,141,16,2019,total_driving,NA
NA,37,Justin Thomas,11,158,38,120,2019,total_driving,NA
NA,39,D.J. Trahan,10,158,51,107,2019,total_driving,NA
NA,36,Chase Wright,18,158,76,82,2019,total_driving,NA
NA,T40,Hank Lebioda,15,164,111,53,2019,total_driving,NA
NA,T40,Kramer Hickok,17,165,151,14,2019,total_driving,NA
NA,33,Rory McIlroy,11,165,2,163,2019,total_driving,NA
NA,45,Chez Reavie,18,165,163,2,2019,total_driving,NA
NA,T34,Alex Noren,12,167,50,117,2019,total_driving,NA
NA,63,Francesco Molinari,9,168,123,45,2019,total_driving,NA
NA,T48,Hunter Mahan,15,169,102,67,2019,total_driving,NA
NA,T43,Harold Varner III,18,169,35,134,2019,total_driving,NA
NA,T50,Jim Herman,15,170,144,26,2019,total_driving,NA
NA,T54,Seth Reeves,17,170,11,159,2019,total_driving,NA
NA,T48,Matt Every,9,172,112,60,2019,total_driving,NA
NA,T34,Adam Hadwin,16,172,121,51,2019,total_driving,NA
NA,T58,Keith Mitchell,18,172,40,132,2019,total_driving,NA
NA,57,Byeong Hun An,13,174,14,160,2019,total_driving,NA
NA,52,Austin Cook,14,174,151,23,2019,total_driving,NA
NA,T61,Xander Schauffele,13,174,28,146,2019,total_driving,NA
NA,T54,Roger Sloan,18,174,81,93,2019,total_driving,NA
NA,53,James Hahn,10,175,128,47,2019,total_driving,NA
NA,T58,Harris English,20,177,51,126,2019,total_driving,NA
NA,T54,Wes Roach,13,177,129,48,2019,total_driving,NA
NA,64,Webb Simpson,13,178,159,19,2019,total_driving,NA
NA,46,Tony Finau,15,179,4,175,2019,total_driving,NA
NA,70,Sung Kang,19,179,63,116,2019,total_driving,NA
NA,T58,Matt Jones,17,181,81,100,2019,total_driving,NA
NA,T61,Sam Ryder,15,182,86,96,2019,total_driving,NA
NA,65,Tyler Duncan,21,183,171,12,2019,total_driving,NA
NA,T66,Sepp Straka,15,183,39,144,2019,total_driving,NA
NA,T66,Fabián Gómez,13,184,149,35,2019,total_driving,NA
NA,T74,Bronson Burgoon,12,185,116,69,2019,total_driving,NA
NA,47,Kiradech Aphibarnrat,13,186,99,87,2019,total_driving,NA
NA,T92,Patrick Cantlay,13,186,12,174,2019,total_driving,NA
NA,T68,Russell Henley,17,186,166,20,2019,total_driving,NA
NA,T68,Andrew Landry,16,186,176,10,2019,total_driving,NA
NA,38,Adam Scott,11,187,45,142,2019,total_driving,NA
NA,T71,Kyle Stanley,17,187,133,54,2019,total_driving,NA
NA,T74,Ryan Palmer,14,188,73,115,2019,total_driving,NA
NA,T71,Jhonattan Vegas,16,188,19,169,2019,total_driving,NA
NA,T81,Russell Knox,16,189,125,64,2019,total_driving,NA
NA,T89,Adam Long,17,189,108,81,2019,total_driving,NA
NA,T76,Brice Garnett,18,190,181,9,2019,total_driving,NA
NA,T76,Kevin Kisner,15,190,161,29,2019,total_driving,NA
NA,T76,Sebastián Muñoz,17,191,64,127,2019,total_driving,NA
NA,T85,Justin Rose,9,191,21,170,2019,total_driving,NA
NA,T79,Adam Schenk,21,191,61,130,2019,total_driving,NA
NA,T79,Joaquin Niemann,17,193,48,145,2019,total_driving,NA
NA,T85,Bud Cauley,16,194,106,88,2019,total_driving,NA
NA,T81,Cameron Davis,17,194,16,178,2019,total_driving,NA
NA,T71,Sergio Garcia,10,195,37,158,2019,total_driving,NA
NA,88,Ryan Moore,15,195,190,5,2019,total_driving,NA
NA,T81,Michael Thompson,15,196,178,18,2019,total_driving,NA
NA,T81,Davis Love III,9,197,147,50,2019,total_driving,NA
NA,T95,Sam Burns,20,198,22,176,2019,total_driving,NA
NA,T89,Cameron Champ,17,198,1,197,2019,total_driving,NA
NA,98,Ben Silverman,15,199,184,15,2019,total_driving,NA
NA,T92,Josh Teater,15,199,134,65,2019,total_driving,NA
NA,T99,Matthew Fitzpatrick,9,200,158,42,2019,total_driving,NA
NA,T85,Kevin Na,14,200,125,75,2019,total_driving,NA
NA,T115,Dustin Johnson,11,202,12,190,2019,total_driving,NA
NA,T92,Nick Watney,17,202,59,143,2019,total_driving,NA
NA,101,Rory Sabbatini,17,203,129,74,2019,total_driving,NA
NA,T95,Luke List,15,204,2,202,2019,total_driving,NA
NA,T99,Denny McCarthy,18,204,132,72,2019,total_driving,NA
NA,106,Beau Hossler,18,205,80,125,2019,total_driving,NA
NA,T103,Ryan Armour,18,206,202,4,2019,total_driving,NA
NA,102,Wyndham Clark,18,206,5,201,2019,total_driving,NA
NA,T107,J.J. Spaun,18,206,129,77,2019,total_driving,NA
NA,91,Chesson Hadley,18,207,69,138,2019,total_driving,NA
NA,T107,David Hearn,13,207,200,7,2019,total_driving,NA
NA,T95,Rafa Cabrera Bello,14,208,137,71,2019,total_driving,NA
NA,T109,Nate Lashley,11,208,180,28,2019,total_driving,NA
NA,T109,Jim Furyk,13,209,208,1,2019,total_driving,NA
NA,T109,Dylan Frittelli,15,212,84,128,2019,total_driving,NA
NA,105,Haotong Li,8,212,33,179,2019,total_driving,NA
NA,113,Brian Gay,19,213,210,3,2019,total_driving,NA
NA,112,Kyoung-Hoon Lee,20,213,172,41,2019,total_driving,NA
NA,T103,Kevin Tway,17,214,32,182,2019,total_driving,NA
NA,T115,Martin Laird,16,216,93,123,2019,total_driving,NA
NA,118,Grayson Murray,14,218,9,209,2019,total_driving,NA
NA,T119,Brian Stuard,20,218,207,11,2019,total_driving,NA
NA,121,Vaughn Taylor,19,219,194,25,2019,total_driving,NA
NA,T124,Satoshi Kodaira,16,220,189,31,2019,total_driving,NA
NA,T131,Brady Schnell,13,220,193,27,2019,total_driving,NA
NA,T119,Sangmoon Bae,15,221,103,118,2019,total_driving,NA
NA,T124,Dominic Bozzelli,15,221,109,112,2019,total_driving,NA
NA,T124,Ollie Schniederjans,20,221,10,211,2019,total_driving,NA
NA,T134,Brandon Harkins,20,222,34,188,2019,total_driving,NA
NA,T122,Graeme McDowell,14,222,173,49,2019,total_driving,NA
NA,T122,Trey Mullinax,18,222,17,205,2019,total_driving,NA
NA,T136,Kyle Jones,18,224,194,30,2019,total_driving,NA
NA,T115,Marc Leishman,13,226,72,154,2019,total_driving,NA
NA,T127,Shawn Stefani,17,226,107,119,2019,total_driving,NA
NA,130,Roberto Díaz,15,227,166,61,2019,total_driving,NA
NA,T127,Branden Grace,16,227,66,161,2019,total_driving,NA
NA,T138,Patton Kizzire,16,228,92,136,2019,total_driving,NA
NA,T142,Phil Mickelson,12,228,18,210,2019,total_driving,NA
NA,153,J.T. Poston,20,228,93,135,2019,total_driving,NA
NA,T131,Matt Wallace,9,228,36,192,2019,total_driving,NA
NA,140,J.B. Holmes,16,229,29,200,2019,total_driving,NA
NA,T136,J.J. Henry,13,230,175,55,2019,total_driving,NA
NA,T134,Danny Lee,17,231,43,188,2019,total_driving,NA
NA,144,C.T. Pan,18,232,176,56,2019,total_driving,NA
NA,T145,Cameron Smith,15,234,69,165,2019,total_driving,NA
NA,T145,Scott Brown,18,235,162,73,2019,total_driving,NA
NA,T151,Zach Johnson,13,235,169,66,2019,total_driving,NA
NA,T149,Jonas Blixt,18,237,157,80,2019,total_driving,NA
NA,T147,Patrick Rodgers,14,237,54,183,2019,total_driving,NA
NA,T147,Johnson Wagner,13,237,199,38,2019,total_driving,NA
NA,141,Billy Horschel,17,238,135,103,2019,total_driving,NA
NA,999,Shane Lowry,9,238,51,187,2019,total_driving,NA
NA,T142,Martin Trainer,17,238,31,207,2019,total_driving,NA
NA,T131,Brian Harman,19,239,181,58,2019,total_driving,NA
NA,T149,Max Homa,17,241,46,195,2019,total_driving,NA
NA,158,Scott Langley,18,244,211,33,2019,total_driving,NA
NA,154,Ryan Blaum,20,247,155,92,2019,total_driving,NA
NA,T156,Roberto Castro,14,247,191,56,2019,total_driving,NA
NA,160,Hudson Swafford,18,247,81,166,2019,total_driving,NA
NA,161,Si Woo Kim,18,249,99,150,2019,total_driving,NA
NA,T127,Martin Kaymer,9,250,119,131,2019,total_driving,NA
NA,T156,Pat Perez,14,250,174,76,2019,total_driving,NA
NA,159,Joey Garber,14,252,142,110,2019,total_driving,NA
NA,162,Jim Knous,16,252,68,184,2019,total_driving,NA
NA,T163,Ben Crane,11,253,201,52,2019,total_driving,NA
NA,T151,Patrick Reed,15,254,86,168,2019,total_driving,NA
NA,T171,Kelly Kraft,20,255,146,109,2019,total_driving,NA
NA,T167,Jimmy Walker,15,255,59,196,2019,total_driving,NA
NA,T163,Tom Hoge,22,256,151,105,2019,total_driving,NA
NA,T167,Brandt Snedeker,16,256,166,90,2019,total_driving,NA
NA,T167,Rod Pampling,14,257,179,78,2019,total_driving,NA
NA,T167,Talor Gooch,9,258,78,180,2019,total_driving,NA
NA,T174,Cameron Tringale,14,258,91,167,2019,total_driving,NA
NA,166,Sam Saunders,17,259,73,186,2019,total_driving,NA
NA,155,Richy Werenski,18,260,138,122,2019,total_driving,NA
NA,T163,Jason Dufner,17,261,163,98,2019,total_driving,NA
NA,177,Seamus Power,19,261,105,156,2019,total_driving,NA
NA,T174,Alex Cejka,15,262,203,59,2019,total_driving,NA
NA,T171,Anders Albertson,17,263,125,138,2019,total_driving,NA
NA,T174,John Chin,13,263,86,177,2019,total_driving,NA
NA,T171,Charley Hoffman,16,265,103,162,2019,total_driving,NA
NA,178,Derek Fathauer,9,267,204,63,2019,total_driving,NA
NA,T184,Danny Willett,13,269,112,157,2019,total_driving,NA
NA,179,Adam Svensson,17,273,165,108,2019,total_driving,NA
NA,180,Stephan Jaeger,18,274,101,173,2019,total_driving,NA
NA,183,Mackenzie Hughes,17,279,98,181,2019,total_driving,NA
NA,T189,Jordan Spieth,14,281,77,204,2019,total_driving,NA
NA,182,Robert Streb,19,281,145,136,2019,total_driving,NA
NA,181,Peter Uihlein,19,281,75,206,2019,total_driving,NA
NA,187,Scott Stallings,17,284,93,191,2019,total_driving,NA
NA,188,Stewart Cink,12,287,115,172,2019,total_driving,NA
NA,186,Anirban Lahiri,15,287,138,149,2019,total_driving,NA
NA,191,"Ted Potter, Jr.",16,287,205,82,2019,total_driving,NA
NA,T184,Chris Kirk,17,288,186,102,2019,total_driving,NA
NA,194,Nick Taylor,18,290,135,155,2019,total_driving,NA
NA,T192,John Senden,13,291,185,106,2019,total_driving,NA
NA,T189,John Huh,13,292,192,100,2019,total_driving,NA
NA,T192,José de Jesús Rodríguez,16,292,159,133,2019,total_driving,NA
NA,195,Whee Kim,18,296,183,113,2019,total_driving,NA
NA,197,Aaron Baddeley,13,302,149,153,2019,total_driving,NA
NA,196,Bill Haas,15,303,156,147,2019,total_driving,NA
NA,199,Julián Etulain,16,310,116,194,2019,total_driving,NA
NA,201,Ernie Els,13,316,187,129,2019,total_driving,NA
NA,200,Cody Gribble,17,320,122,198,2019,total_driving,NA
NA,202,Chris Stroud,17,322,151,171,2019,total_driving,NA
NA,203,Charl Schwartzel,13,328,120,208,2019,total_driving,NA
NA,T204,D.A. Points,13,333,209,124,2019,total_driving,NA
NA,T204,Freddie Jacobson,14,335,187,148,2019,total_driving,NA
NA,207,Jonathan Byrd,12,336,196,140,2019,total_driving,NA
NA,208,Chris Thompson,11,345,142,203,2019,total_driving,NA
NA,209,Peter Malnati,16,347,148,199,2019,total_driving,NA
NA,206,Andrew Putnam,15,349,197,152,2019,total_driving,NA
NA,211,Curtis Luck,16,354,169,185,2019,total_driving,NA
NA,213,Martin Piller,9,362,198,164,2019,total_driving,NA
NA,214,Michael Kim,19,399,206,193,2019,total_driving,NA
