RANK THIS WEEK,RANK LAST WEEK,PLAYER NAME,EVENTS,TOTAL,DISTANCE RANK,ACCURACY RANK,year,measure,RANK THIS WEEK
1,1,Andrew Novak,2,35,17,18,2004,total_driving,NA
2,3,Viktor Hovland,4,63,16,47,2004,total_driving,NA
3,4,Chase Koepka,2,72,34,38,2004,total_driving,NA
4,5,John Oda,2,74,70,4,2004,total_driving,NA
5,6,D.J. Trahan,7,91,47,44,2004,total_driving,NA
6,8,Gary Woodland,4,98,94,4,2004,total_driving,NA
7,9,Branden Grace,4,99,21,78,2004,total_driving,NA
T8,10,Patrick Cantlay,3,103,86,17,2004,total_driving,NA
T8,7,Doc Redman,10,103,77,26,2004,total_driving,NA
10,2,Ryan Moore,5,105,94,11,2004,total_driving,NA
11,13,Scottie Scheffler,8,126,15,111,2004,total_driving,NA
12,T19,Kyoung-Hoon Lee,10,128,106,22,2004,total_driving,NA
13,14,Martin Laird,8,129,42,87,2004,total_driving,NA
14,11,Kevin Streelman,9,130,62,68,2004,total_driving,NA
15,25,Jhonattan Vegas,6,132,24,108,2004,total_driving,NA
T16,15,Nick Taylor,8,133,109,24,2004,total_driving,NA
T16,T23,Brendan Steele,8,133,63,70,2004,total_driving,NA
18,12,Harris English,7,135,36,99,2004,total_driving,NA
T19,T27,Harry Higgs,10,140,79,61,2004,total_driving,NA
T19,T27,Sung Kang,7,140,53,87,2004,total_driving,NA
T21,22,Emiliano Grillo,7,142,110,32,2004,total_driving,NA
T21,18,Bubba Watson,4,142,1,141,2004,total_driving,NA
23,T19,Bryson DeChambeau,3,144,13,131,2004,total_driving,NA
24,T52,Matthew Wolff,5,145,40,105,2004,total_driving,NA
25,29,Joel Dahmen,8,149,100,49,2004,total_driving,NA
26,16,Jason Kokrak,5,153,8,145,2004,total_driving,NA
27,17,Josh Teater,6,156,83,73,2004,total_driving,NA
28,T23,Cameron Champ,7,157,2,155,2004,total_driving,NA
29,33,Ryan Palmer,5,160,146,14,2004,total_driving,NA
30,T35,Adam Hadwin,5,164,121,43,2004,total_driving,NA
31,26,Sungjae Im,8,165,50,115,2004,total_driving,NA
32,31,Henrik Norlander,10,168,132,36,2004,total_driving,NA
T33,38,Boo Weekley,5,169,147,22,2004,total_driving,NA
T33,T35,Harold Varner III,7,169,18,151,2004,total_driving,NA
35,37,Lanto Griffin,10,170,40,130,2004,total_driving,NA
36,T19,Lucas Glover,7,174,98,76,2004,total_driving,NA
37,34,Scott Brown,9,175,151,24,2004,total_driving,NA
38,T44,Sebastián Muñoz,10,176,60,116,2004,total_driving,NA
T39,40,Daniel Berger,6,177,56,121,2004,total_driving,NA
T39,42,Keegan Bradley,7,177,71,106,2004,total_driving,NA
41,39,Chesson Hadley,7,179,106,73,2004,total_driving,NA
42,43,Webb Simpson,3,182,170,12,2004,total_driving,NA
43,48,Danny Lee,7,185,9,176,2004,total_driving,NA
44,T50,Pat Perez,6,186,130,56,2004,total_driving,NA
45,T52,Matthew NeSmith,9,188,154,34,2004,total_driving,NA
46,T99,Sepp Straka,10,191,92,99,2004,total_driving,NA
T47,T90,Isaiah Salinda,3,192,14,178,2004,total_driving,NA
T47,T56,John Merrick,4,192,135,57,2004,total_driving,NA
T49,T50,Jim Furyk,3,193,192,1,2004,total_driving,NA
T49,55,Chad Campbell,4,193,178,15,2004,total_driving,NA
T49,T44,Wyndham Clark,7,193,32,161,2004,total_driving,NA
52,32,Alex Noren,4,195,108,87,2004,total_driving,NA
53,NA,Rickie Fowler,2,196,194,2,2004,total_driving,NA
T54,T56,Tony Finau,5,198,12,186,2004,total_driving,NA
T54,T62,Phil Mickelson,5,198,31,167,2004,total_driving,NA
T54,T62,Aaron Wise,7,198,51,147,2004,total_driving,NA
T54,T69,Chase Seiffert,9,198,127,71,2004,total_driving,NA
T58,T73,Abraham Ancer,8,199,113,86,2004,total_driving,NA
T58,61,Adam Schenk,10,199,33,166,2004,total_driving,NA
T58,T64,Scott Harrington,9,199,34,165,2004,total_driving,NA
T61,T52,Brian Harman,8,200,143,57,2004,total_driving,NA
T61,47,Jason Dufner,7,200,140,60,2004,total_driving,NA
T61,59,Cameron Smith,6,200,77,123,2004,total_driving,NA
T64,46,Kramer Hickok,9,201,124,77,2004,total_driving,NA
T64,60,Matt Jones,8,201,49,152,2004,total_driving,NA
66,30,Robby Shelton,10,202,88,114,2004,total_driving,NA
T67,83,Grayson Murray,6,203,4,199,2004,total_driving,NA
T67,T73,Russell Knox,8,203,138,65,2004,total_driving,NA
69,41,Denny McCarthy,8,204,101,103,2004,total_driving,NA
70,T80,Sam Ryder,10,209,53,156,2004,total_driving,NA
71,58,Brice Garnett,8,214,150,64,2004,total_driving,NA
72,66,Michael Thompson,7,215,175,40,2004,total_driving,NA
73,76,Collin Morikawa,6,216,168,48,2004,total_driving,NA
T74,T69,Derek Ernst,4,217,80,137,2004,total_driving,NA
T74,T67,Adam Long,10,217,189,28,2004,total_driving,NA
T74,96,Andrew Landry,9,217,171,46,2004,total_driving,NA
77,T84,Akshay Bhatia,5,218,7,211,2004,total_driving,NA
78,T69,Rod Pampling,3,220,28,192,2004,total_driving,NA
79,136,Nick Watney,7,222,73,149,2004,total_driving,NA
T80,T84,Hideki Matsuyama,6,223,115,108,2004,total_driving,NA
T80,115,Doug Ghim,7,223,116,107,2004,total_driving,NA
T80,T90,Kristoffer Ventura,9,223,44,179,2004,total_driving,NA
T83,T73,Byeong Hun An,8,225,10,215,2004,total_driving,NA
T83,T90,Chandler Phillips,2,225,57,168,2004,total_driving,NA
T83,T69,Brian Stuard,10,225,215,10,2004,total_driving,NA
T83,T97,Alex Cejka,5,225,175,50,2004,total_driving,NA
T83,T80,Ryan Armour,9,225,217,8,2004,total_driving,NA
T88,T90,Graham DeLaet,5,226,36,190,2004,total_driving,NA
T88,T77,Tim Wilkinson,6,226,189,37,2004,total_driving,NA
T88,T86,Brandon Wu,2,226,188,38,2004,total_driving,NA
T91,T88,Hank Lebioda,9,228,104,124,2004,total_driving,NA
T91,79,Charles Howell III,9,228,69,159,2004,total_driving,NA
93,T67,Tyler McCumber,9,229,11,218,2004,total_driving,NA
94,T90,Fabián Gómez,9,230,167,63,2004,total_driving,NA
95,T90,Brendon Todd,11,231,228,3,2004,total_driving,NA
T96,49,Cameron Percy,8,233,61,172,2004,total_driving,NA
T96,T99,Adam Scott,4,233,46,187,2004,total_driving,NA
T96,T80,Luke List,9,233,80,153,2004,total_driving,NA
T96,T86,Russell Henley,8,233,179,54,2004,total_driving,NA
T96,T130,Mackenzie Hughes,8,233,101,132,2004,total_driving,NA
101,T109,J.T. Poston,9,234,175,59,2004,total_driving,NA
102,T64,Vince Covello,8,235,73,162,2004,total_driving,NA
103,T99,Xinjun Zhang,10,236,116,120,2004,total_driving,NA
104,105,K.J. Choi,3,237,233,4,2004,total_driving,NA
T105,107,Tim Herron,4,238,220,18,2004,total_driving,NA
T105,T109,Corey Conners,7,238,186,52,2004,total_driving,NA
T107,108,Keith Mitchell,7,239,135,104,2004,total_driving,NA
T107,T130,Cameron Davis,8,239,22,217,2004,total_driving,NA
T107,T99,Richy Werenski,4,239,45,194,2004,total_driving,NA
T107,T88,Vaughn Taylor,8,239,212,27,2004,total_driving,NA
111,168,Chris Baker,9,240,168,72,2004,total_driving,NA
T112,T112,Jim Herman,8,241,221,20,2004,total_driving,NA
T112,T127,Scott Piercy,8,241,105,136,2004,total_driving,NA
T114,T120,J.J. Henry,5,242,173,69,2004,total_driving,NA
T114,T103,Tyler Duncan,10,242,221,21,2004,total_driving,NA
116,T112,Davis Riley,2,243,83,160,2004,total_driving,NA
T117,T125,Bo Hoag,10,244,127,117,2004,total_driving,NA
T117,T116,Chez Reavie,9,244,228,16,2004,total_driving,NA
119,T116,Matt Kuchar,4,245,238,7,2004,total_driving,NA
T120,223,Paul Casey,4,247,160,87,2004,total_driving,NA
T120,T116,Satoshi Kodaira,6,247,234,13,2004,total_driving,NA
T120,T127,Shawn Stefani,6,247,73,174,2004,total_driving,NA
123,106,Carlos Ortiz,8,248,67,181,2004,total_driving,NA
124,T122,Ben Crane,6,249,207,42,2004,total_driving,NA
125,T130,Tom Lewis,3,252,5,247,2004,total_driving,NA
126,T139,Michael Gligic,9,253,73,180,2004,total_driving,NA
T127,T139,Scott Stallings,8,254,47,207,2004,total_driving,NA
T127,T137,Kyle Stanley,8,254,213,41,2004,total_driving,NA
T129,T137,Henrik Stenson,2,255,202,53,2004,total_driving,NA
T129,T125,Austin Cook,8,255,127,128,2004,total_driving,NA
T131,T120,Beau Hossler,8,256,29,227,2004,total_driving,NA
T131,T122,Patrick Rodgers,10,256,26,230,2004,total_driving,NA
T131,T143,Sebastian Cappelen,8,256,30,226,2004,total_driving,NA
T131,T133,Kurt Kitayama,2,256,3,253,2004,total_driving,NA
T131,T77,Vincent Whaley,7,256,103,153,2004,total_driving,NA
T131,T141,Ryan Brehm,10,256,6,250,2004,total_driving,NA
137,T122,Mark Hubbard,10,257,149,108,2004,total_driving,NA
T138,T163,Brandon Hagy,8,258,22,236,2004,total_driving,NA
T138,T109,Billy Horschel,6,258,196,62,2004,total_driving,NA
T140,T147,Sam Burns,6,259,20,239,2004,total_driving,NA
T140,T133,David Lingmerth,5,259,230,29,2004,total_driving,NA
T142,T187,Bud Cauley,6,262,125,137,2004,total_driving,NA
T142,T143,Cameron Tringale,7,262,55,207,2004,total_driving,NA
144,T143,Rikuya Hoshino,2,264,138,126,2004,total_driving,NA
145,T155,Jonathan Byrd,5,265,72,193,2004,total_driving,NA
T146,T116,Maverick McNealy,9,266,89,177,2004,total_driving,NA
T146,T147,Xander Schauffele,3,266,231,35,2004,total_driving,NA
T148,154,Whee Kim,2,267,180,87,2004,total_driving,NA
T148,T141,Lucas Bjerregaard,3,267,18,249,2004,total_driving,NA
150,T152,Chip McDaniel,2,268,59,209,2004,total_driving,NA
T151,T178,Max Homa,6,269,187,82,2004,total_driving,NA
T151,T112,Bill Haas,6,269,147,122,2004,total_driving,NA
T151,146,J.B. Holmes,3,269,224,45,2004,total_driving,NA
T154,129,Zack Sucher,6,270,24,246,2004,total_driving,NA
T154,T157,Roberto Castro,5,270,183,87,2004,total_driving,NA
156,151,Kevin Tway,6,271,27,244,2004,total_driving,NA
T157,T155,Kevin Chappell,6,272,43,229,2004,total_driving,NA
T157,T152,Dominic Bozzelli,7,272,38,234,2004,total_driving,NA
T159,T147,David Hearn,9,273,206,67,2004,total_driving,NA
T159,174,Jimmy Walker,4,273,92,181,2004,total_driving,NA
161,165,Sangmoon Bae,6,274,64,210,2004,total_driving,NA
162,167,Michael Gellerman,8,275,135,140,2004,total_driving,NA
163,T159,Kevin Kisner,7,277,227,50,2004,total_driving,NA
T164,T159,Justin Thomas,5,278,161,117,2004,total_driving,NA
T164,T187,Troy Merritt,7,278,182,96,2004,total_driving,NA
T164,T163,Freddie Jacobson,3,278,141,137,2004,total_driving,NA
167,T175,Talor Gooch,8,280,122,158,2004,total_driving,NA
168,T103,Andrew Putnam,6,283,181,102,2004,total_driving,NA
T169,T157,Si Woo Kim,8,284,99,185,2004,total_driving,NA
T169,T97,Charley Hoffman,7,284,87,197,2004,total_driving,NA
T169,169,Seamus Power,5,284,83,201,2004,total_driving,NA
172,T133,John Huh,5,285,166,119,2004,total_driving,NA
T173,T172,Jason Day,3,286,80,206,2004,total_driving,NA
T173,T172,Chris Kirk,3,286,199,87,2004,total_driving,NA
T173,T175,Rafael Campos,9,286,67,219,2004,total_driving,NA
176,T159,Nate Lashley,8,287,204,83,2004,total_driving,NA
177,177,Brandt Snedeker,4,288,155,133,2004,total_driving,NA
178,T178,Peter Uihlein,6,289,38,251,2004,total_driving,NA
179,150,Kevin Na,7,290,203,87,2004,total_driving,NA
180,T170,Ben Taylor,10,291,134,157,2004,total_driving,NA
181,162,Anirban Lahiri,8,292,118,174,2004,total_driving,NA
182,T208,Roger Sloan,8,293,158,135,2004,total_driving,NA
T183,182,Johnson Wagner,5,294,207,87,2004,total_driving,NA
T183,T183,Robert Garrigus,5,294,52,242,2004,total_driving,NA
T183,T187,Wes Roach,7,294,151,143,2004,total_driving,NA
186,181,Zach Johnson,7,299,216,83,2004,total_driving,NA
187,191,Mikumu Horikawa,3,303,237,66,2004,total_driving,NA
T188,194,Will Gordon,4,304,64,240,2004,total_driving,NA
T188,210,Rory Sabbatini,7,304,219,85,2004,total_driving,NA
T188,T183,Dylan Frittelli,9,304,193,111,2004,total_driving,NA
191,185,Nelson Ledesma,10,305,57,248,2004,total_driving,NA
192,192,Marc Leishman,5,306,90,216,2004,total_driving,NA
193,166,Joseph Bramlett,7,307,94,213,2004,total_driving,NA
194,195,Joaquin Niemann,8,308,164,144,2004,total_driving,NA
T195,T196,Graeme McDowell,5,311,236,75,2004,total_driving,NA
T195,T201,Bronson Burgoon,8,311,130,181,2004,total_driving,NA
197,T187,Brian Gay,9,312,162,150,2004,total_driving,NA
198,193,Rhein Gibson,9,313,90,223,2004,total_driving,NA
199,T196,Tom Hoge,8,314,185,129,2004,total_driving,NA
200,200,Mark Anderson,7,319,132,187,2004,total_driving,NA
201,204,Smylie Kaufman,3,320,64,256,2004,total_driving,NA
T202,199,Zac Blair,10,322,225,97,2004,total_driving,NA
T202,214,Francesco Molinari,3,322,125,197,2004,total_driving,NA
T204,T170,John Senden,5,324,120,204,2004,total_driving,NA
T204,180,Ben Martin,6,324,223,101,2004,total_driving,NA
T206,T205,James Hahn,6,325,163,162,2004,total_driving,NA
T206,186,Aaron Baddeley,6,325,198,127,2004,total_driving,NA
208,T211,J.J. Spaun,9,330,118,212,2004,total_driving,NA
T209,203,Robert Streb,9,332,141,191,2004,total_driving,NA
T209,T208,Robert Allenby,3,332,164,168,2004,total_driving,NA
211,T211,Martin Trainer,8,339,94,245,2004,total_driving,NA
212,T205,"Ted Potter, Jr.",7,340,151,189,2004,total_driving,NA
213,T201,Chris Stroud,6,341,194,147,2004,total_driving,NA
T214,T205,Rob Oppenheim,10,342,200,142,2004,total_driving,NA
T214,198,Matt Every,7,342,122,220,2004,total_driving,NA
T214,213,Morgan Hoffmann,4,342,143,199,2004,total_driving,NA
217,215,Roberto Díaz,2,345,110,235,2004,total_driving,NA
218,216,Stewart Cink,4,350,112,238,2004,total_driving,NA
219,217,C.T. Pan,5,353,189,164,2004,total_driving,NA
220,T218,Patton Kizzire,9,354,158,196,2004,total_driving,NA
221,222,Hudson Swafford,4,356,183,173,2004,total_driving,NA
222,T218,George McNeill,6,359,145,214,2004,total_driving,NA
223,220,Patrick Reed,4,363,239,124,2004,total_driving,NA
224,221,Jamie Lovemark,4,365,114,251,2004,total_driving,NA
225,224,Luke Donald,2,378,232,146,2004,total_driving,NA
226,226,Bo Van Pelt,7,387,155,232,2004,total_driving,NA
227,225,Davis Love III,3,400,172,228,2004,total_driving,NA
228,228,Arjun Atwal,5,404,173,231,2004,total_driving,NA
T229,231,Daniel Chopra,3,411,157,254,2004,total_driving,NA
T229,227,Kevin Stadler,6,411,217,194,2004,total_driving,NA
231,229,John Rollins,4,414,209,205,2004,total_driving,NA
232,230,Parker McLachlin,4,421,201,220,2004,total_driving,NA
233,232,Peter Malnati,9,422,197,225,2004,total_driving,NA
234,233,Michael Kim,8,435,211,224,2004,total_driving,NA
235,235,Tommy Gainey,4,442,209,233,2004,total_driving,NA
236,234,D.A. Points,4,446,226,220,2004,total_driving,NA
237,236,Ricky Barnes,6,451,214,237,2004,total_driving,NA
238,237,Brendon de Jonge,3,462,205,257,2004,total_driving,NA
239,238,Shugo Imahira,2,490,235,255,2004,total_driving,NA
1,1,Andrew Novak,2,35,17,18,2005,total_driving,NA
2,3,Viktor Hovland,4,63,16,47,2005,total_driving,NA
3,4,Chase Koepka,2,72,34,38,2005,total_driving,NA
4,5,John Oda,2,74,70,4,2005,total_driving,NA
5,6,D.J. Trahan,7,91,47,44,2005,total_driving,NA
6,8,Gary Woodland,4,98,94,4,2005,total_driving,NA
7,9,Branden Grace,4,99,21,78,2005,total_driving,NA
T8,10,Patrick Cantlay,3,103,86,17,2005,total_driving,NA
T8,7,Doc Redman,10,103,77,26,2005,total_driving,NA
10,2,Ryan Moore,5,105,94,11,2005,total_driving,NA
11,13,Scottie Scheffler,8,126,15,111,2005,total_driving,NA
12,T19,Kyoung-Hoon Lee,10,128,106,22,2005,total_driving,NA
13,14,Martin Laird,8,129,42,87,2005,total_driving,NA
14,11,Kevin Streelman,9,130,62,68,2005,total_driving,NA
15,25,Jhonattan Vegas,6,132,24,108,2005,total_driving,NA
T16,15,Nick Taylor,8,133,109,24,2005,total_driving,NA
T16,T23,Brendan Steele,8,133,63,70,2005,total_driving,NA
18,12,Harris English,7,135,36,99,2005,total_driving,NA
T19,T27,Harry Higgs,10,140,79,61,2005,total_driving,NA
T19,T27,Sung Kang,7,140,53,87,2005,total_driving,NA
T21,22,Emiliano Grillo,7,142,110,32,2005,total_driving,NA
T21,18,Bubba Watson,4,142,1,141,2005,total_driving,NA
23,T19,Bryson DeChambeau,3,144,13,131,2005,total_driving,NA
24,T52,Matthew Wolff,5,145,40,105,2005,total_driving,NA
25,29,Joel Dahmen,8,149,100,49,2005,total_driving,NA
26,16,Jason Kokrak,5,153,8,145,2005,total_driving,NA
27,17,Josh Teater,6,156,83,73,2005,total_driving,NA
28,T23,Cameron Champ,7,157,2,155,2005,total_driving,NA
29,33,Ryan Palmer,5,160,146,14,2005,total_driving,NA
30,T35,Adam Hadwin,5,164,121,43,2005,total_driving,NA
31,26,Sungjae Im,8,165,50,115,2005,total_driving,NA
32,31,Henrik Norlander,10,168,132,36,2005,total_driving,NA
T33,38,Boo Weekley,5,169,147,22,2005,total_driving,NA
T33,T35,Harold Varner III,7,169,18,151,2005,total_driving,NA
35,37,Lanto Griffin,10,170,40,130,2005,total_driving,NA
36,T19,Lucas Glover,7,174,98,76,2005,total_driving,NA
37,34,Scott Brown,9,175,151,24,2005,total_driving,NA
38,T44,Sebastián Muñoz,10,176,60,116,2005,total_driving,NA
T39,40,Daniel Berger,6,177,56,121,2005,total_driving,NA
T39,42,Keegan Bradley,7,177,71,106,2005,total_driving,NA
41,39,Chesson Hadley,7,179,106,73,2005,total_driving,NA
42,43,Webb Simpson,3,182,170,12,2005,total_driving,NA
43,48,Danny Lee,7,185,9,176,2005,total_driving,NA
44,T50,Pat Perez,6,186,130,56,2005,total_driving,NA
45,T52,Matthew NeSmith,9,188,154,34,2005,total_driving,NA
46,T99,Sepp Straka,10,191,92,99,2005,total_driving,NA
T47,T90,Isaiah Salinda,3,192,14,178,2005,total_driving,NA
T47,T56,John Merrick,4,192,135,57,2005,total_driving,NA
T49,T50,Jim Furyk,3,193,192,1,2005,total_driving,NA
T49,55,Chad Campbell,4,193,178,15,2005,total_driving,NA
T49,T44,Wyndham Clark,7,193,32,161,2005,total_driving,NA
52,32,Alex Noren,4,195,108,87,2005,total_driving,NA
53,NA,Rickie Fowler,2,196,194,2,2005,total_driving,NA
T54,T56,Tony Finau,5,198,12,186,2005,total_driving,NA
T54,T62,Phil Mickelson,5,198,31,167,2005,total_driving,NA
T54,T62,Aaron Wise,7,198,51,147,2005,total_driving,NA
T54,T69,Chase Seiffert,9,198,127,71,2005,total_driving,NA
T58,T73,Abraham Ancer,8,199,113,86,2005,total_driving,NA
T58,61,Adam Schenk,10,199,33,166,2005,total_driving,NA
T58,T64,Scott Harrington,9,199,34,165,2005,total_driving,NA
T61,T52,Brian Harman,8,200,143,57,2005,total_driving,NA
T61,47,Jason Dufner,7,200,140,60,2005,total_driving,NA
T61,59,Cameron Smith,6,200,77,123,2005,total_driving,NA
T64,46,Kramer Hickok,9,201,124,77,2005,total_driving,NA
T64,60,Matt Jones,8,201,49,152,2005,total_driving,NA
66,30,Robby Shelton,10,202,88,114,2005,total_driving,NA
T67,83,Grayson Murray,6,203,4,199,2005,total_driving,NA
T67,T73,Russell Knox,8,203,138,65,2005,total_driving,NA
69,41,Denny McCarthy,8,204,101,103,2005,total_driving,NA
70,T80,Sam Ryder,10,209,53,156,2005,total_driving,NA
71,58,Brice Garnett,8,214,150,64,2005,total_driving,NA
72,66,Michael Thompson,7,215,175,40,2005,total_driving,NA
73,76,Collin Morikawa,6,216,168,48,2005,total_driving,NA
T74,T69,Derek Ernst,4,217,80,137,2005,total_driving,NA
T74,T67,Adam Long,10,217,189,28,2005,total_driving,NA
T74,96,Andrew Landry,9,217,171,46,2005,total_driving,NA
77,T84,Akshay Bhatia,5,218,7,211,2005,total_driving,NA
78,T69,Rod Pampling,3,220,28,192,2005,total_driving,NA
79,136,Nick Watney,7,222,73,149,2005,total_driving,NA
T80,T84,Hideki Matsuyama,6,223,115,108,2005,total_driving,NA
T80,115,Doug Ghim,7,223,116,107,2005,total_driving,NA
T80,T90,Kristoffer Ventura,9,223,44,179,2005,total_driving,NA
T83,T73,Byeong Hun An,8,225,10,215,2005,total_driving,NA
T83,T90,Chandler Phillips,2,225,57,168,2005,total_driving,NA
T83,T69,Brian Stuard,10,225,215,10,2005,total_driving,NA
T83,T97,Alex Cejka,5,225,175,50,2005,total_driving,NA
T83,T80,Ryan Armour,9,225,217,8,2005,total_driving,NA
T88,T90,Graham DeLaet,5,226,36,190,2005,total_driving,NA
T88,T77,Tim Wilkinson,6,226,189,37,2005,total_driving,NA
T88,T86,Brandon Wu,2,226,188,38,2005,total_driving,NA
T91,T88,Hank Lebioda,9,228,104,124,2005,total_driving,NA
T91,79,Charles Howell III,9,228,69,159,2005,total_driving,NA
93,T67,Tyler McCumber,9,229,11,218,2005,total_driving,NA
94,T90,Fabián Gómez,9,230,167,63,2005,total_driving,NA
95,T90,Brendon Todd,11,231,228,3,2005,total_driving,NA
T96,49,Cameron Percy,8,233,61,172,2005,total_driving,NA
T96,T99,Adam Scott,4,233,46,187,2005,total_driving,NA
T96,T80,Luke List,9,233,80,153,2005,total_driving,NA
T96,T86,Russell Henley,8,233,179,54,2005,total_driving,NA
T96,T130,Mackenzie Hughes,8,233,101,132,2005,total_driving,NA
101,T109,J.T. Poston,9,234,175,59,2005,total_driving,NA
102,T64,Vince Covello,8,235,73,162,2005,total_driving,NA
103,T99,Xinjun Zhang,10,236,116,120,2005,total_driving,NA
104,105,K.J. Choi,3,237,233,4,2005,total_driving,NA
T105,107,Tim Herron,4,238,220,18,2005,total_driving,NA
T105,T109,Corey Conners,7,238,186,52,2005,total_driving,NA
T107,108,Keith Mitchell,7,239,135,104,2005,total_driving,NA
T107,T130,Cameron Davis,8,239,22,217,2005,total_driving,NA
T107,T99,Richy Werenski,4,239,45,194,2005,total_driving,NA
T107,T88,Vaughn Taylor,8,239,212,27,2005,total_driving,NA
111,168,Chris Baker,9,240,168,72,2005,total_driving,NA
T112,T112,Jim Herman,8,241,221,20,2005,total_driving,NA
T112,T127,Scott Piercy,8,241,105,136,2005,total_driving,NA
T114,T120,J.J. Henry,5,242,173,69,2005,total_driving,NA
T114,T103,Tyler Duncan,10,242,221,21,2005,total_driving,NA
116,T112,Davis Riley,2,243,83,160,2005,total_driving,NA
T117,T125,Bo Hoag,10,244,127,117,2005,total_driving,NA
T117,T116,Chez Reavie,9,244,228,16,2005,total_driving,NA
119,T116,Matt Kuchar,4,245,238,7,2005,total_driving,NA
T120,223,Paul Casey,4,247,160,87,2005,total_driving,NA
T120,T116,Satoshi Kodaira,6,247,234,13,2005,total_driving,NA
T120,T127,Shawn Stefani,6,247,73,174,2005,total_driving,NA
123,106,Carlos Ortiz,8,248,67,181,2005,total_driving,NA
124,T122,Ben Crane,6,249,207,42,2005,total_driving,NA
125,T130,Tom Lewis,3,252,5,247,2005,total_driving,NA
126,T139,Michael Gligic,9,253,73,180,2005,total_driving,NA
T127,T139,Scott Stallings,8,254,47,207,2005,total_driving,NA
T127,T137,Kyle Stanley,8,254,213,41,2005,total_driving,NA
T129,T137,Henrik Stenson,2,255,202,53,2005,total_driving,NA
T129,T125,Austin Cook,8,255,127,128,2005,total_driving,NA
T131,T120,Beau Hossler,8,256,29,227,2005,total_driving,NA
T131,T122,Patrick Rodgers,10,256,26,230,2005,total_driving,NA
T131,T143,Sebastian Cappelen,8,256,30,226,2005,total_driving,NA
T131,T133,Kurt Kitayama,2,256,3,253,2005,total_driving,NA
T131,T77,Vincent Whaley,7,256,103,153,2005,total_driving,NA
T131,T141,Ryan Brehm,10,256,6,250,2005,total_driving,NA
137,T122,Mark Hubbard,10,257,149,108,2005,total_driving,NA
T138,T163,Brandon Hagy,8,258,22,236,2005,total_driving,NA
T138,T109,Billy Horschel,6,258,196,62,2005,total_driving,NA
T140,T147,Sam Burns,6,259,20,239,2005,total_driving,NA
T140,T133,David Lingmerth,5,259,230,29,2005,total_driving,NA
T142,T187,Bud Cauley,6,262,125,137,2005,total_driving,NA
T142,T143,Cameron Tringale,7,262,55,207,2005,total_driving,NA
144,T143,Rikuya Hoshino,2,264,138,126,2005,total_driving,NA
145,T155,Jonathan Byrd,5,265,72,193,2005,total_driving,NA
T146,T116,Maverick McNealy,9,266,89,177,2005,total_driving,NA
T146,T147,Xander Schauffele,3,266,231,35,2005,total_driving,NA
T148,154,Whee Kim,2,267,180,87,2005,total_driving,NA
T148,T141,Lucas Bjerregaard,3,267,18,249,2005,total_driving,NA
150,T152,Chip McDaniel,2,268,59,209,2005,total_driving,NA
T151,T178,Max Homa,6,269,187,82,2005,total_driving,NA
T151,T112,Bill Haas,6,269,147,122,2005,total_driving,NA
T151,146,J.B. Holmes,3,269,224,45,2005,total_driving,NA
T154,129,Zack Sucher,6,270,24,246,2005,total_driving,NA
T154,T157,Roberto Castro,5,270,183,87,2005,total_driving,NA
156,151,Kevin Tway,6,271,27,244,2005,total_driving,NA
T157,T155,Kevin Chappell,6,272,43,229,2005,total_driving,NA
T157,T152,Dominic Bozzelli,7,272,38,234,2005,total_driving,NA
T159,T147,David Hearn,9,273,206,67,2005,total_driving,NA
T159,174,Jimmy Walker,4,273,92,181,2005,total_driving,NA
161,165,Sangmoon Bae,6,274,64,210,2005,total_driving,NA
162,167,Michael Gellerman,8,275,135,140,2005,total_driving,NA
163,T159,Kevin Kisner,7,277,227,50,2005,total_driving,NA
T164,T159,Justin Thomas,5,278,161,117,2005,total_driving,NA
T164,T187,Troy Merritt,7,278,182,96,2005,total_driving,NA
T164,T163,Freddie Jacobson,3,278,141,137,2005,total_driving,NA
167,T175,Talor Gooch,8,280,122,158,2005,total_driving,NA
168,T103,Andrew Putnam,6,283,181,102,2005,total_driving,NA
T169,T157,Si Woo Kim,8,284,99,185,2005,total_driving,NA
T169,T97,Charley Hoffman,7,284,87,197,2005,total_driving,NA
T169,169,Seamus Power,5,284,83,201,2005,total_driving,NA
172,T133,John Huh,5,285,166,119,2005,total_driving,NA
T173,T172,Jason Day,3,286,80,206,2005,total_driving,NA
T173,T172,Chris Kirk,3,286,199,87,2005,total_driving,NA
T173,T175,Rafael Campos,9,286,67,219,2005,total_driving,NA
176,T159,Nate Lashley,8,287,204,83,2005,total_driving,NA
177,177,Brandt Snedeker,4,288,155,133,2005,total_driving,NA
178,T178,Peter Uihlein,6,289,38,251,2005,total_driving,NA
179,150,Kevin Na,7,290,203,87,2005,total_driving,NA
180,T170,Ben Taylor,10,291,134,157,2005,total_driving,NA
181,162,Anirban Lahiri,8,292,118,174,2005,total_driving,NA
182,T208,Roger Sloan,8,293,158,135,2005,total_driving,NA
T183,182,Johnson Wagner,5,294,207,87,2005,total_driving,NA
T183,T183,Robert Garrigus,5,294,52,242,2005,total_driving,NA
T183,T187,Wes Roach,7,294,151,143,2005,total_driving,NA
186,181,Zach Johnson,7,299,216,83,2005,total_driving,NA
187,191,Mikumu Horikawa,3,303,237,66,2005,total_driving,NA
T188,194,Will Gordon,4,304,64,240,2005,total_driving,NA
T188,210,Rory Sabbatini,7,304,219,85,2005,total_driving,NA
T188,T183,Dylan Frittelli,9,304,193,111,2005,total_driving,NA
191,185,Nelson Ledesma,10,305,57,248,2005,total_driving,NA
192,192,Marc Leishman,5,306,90,216,2005,total_driving,NA
193,166,Joseph Bramlett,7,307,94,213,2005,total_driving,NA
194,195,Joaquin Niemann,8,308,164,144,2005,total_driving,NA
T195,T196,Graeme McDowell,5,311,236,75,2005,total_driving,NA
T195,T201,Bronson Burgoon,8,311,130,181,2005,total_driving,NA
197,T187,Brian Gay,9,312,162,150,2005,total_driving,NA
198,193,Rhein Gibson,9,313,90,223,2005,total_driving,NA
199,T196,Tom Hoge,8,314,185,129,2005,total_driving,NA
200,200,Mark Anderson,7,319,132,187,2005,total_driving,NA
201,204,Smylie Kaufman,3,320,64,256,2005,total_driving,NA
T202,199,Zac Blair,10,322,225,97,2005,total_driving,NA
T202,214,Francesco Molinari,3,322,125,197,2005,total_driving,NA
T204,T170,John Senden,5,324,120,204,2005,total_driving,NA
T204,180,Ben Martin,6,324,223,101,2005,total_driving,NA
T206,T205,James Hahn,6,325,163,162,2005,total_driving,NA
T206,186,Aaron Baddeley,6,325,198,127,2005,total_driving,NA
208,T211,J.J. Spaun,9,330,118,212,2005,total_driving,NA
T209,203,Robert Streb,9,332,141,191,2005,total_driving,NA
T209,T208,Robert Allenby,3,332,164,168,2005,total_driving,NA
211,T211,Martin Trainer,8,339,94,245,2005,total_driving,NA
212,T205,"Ted Potter, Jr.",7,340,151,189,2005,total_driving,NA
213,T201,Chris Stroud,6,341,194,147,2005,total_driving,NA
T214,T205,Rob Oppenheim,10,342,200,142,2005,total_driving,NA
T214,198,Matt Every,7,342,122,220,2005,total_driving,NA
T214,213,Morgan Hoffmann,4,342,143,199,2005,total_driving,NA
217,215,Roberto Díaz,2,345,110,235,2005,total_driving,NA
218,216,Stewart Cink,4,350,112,238,2005,total_driving,NA
219,217,C.T. Pan,5,353,189,164,2005,total_driving,NA
220,T218,Patton Kizzire,9,354,158,196,2005,total_driving,NA
221,222,Hudson Swafford,4,356,183,173,2005,total_driving,NA
222,T218,George McNeill,6,359,145,214,2005,total_driving,NA
223,220,Patrick Reed,4,363,239,124,2005,total_driving,NA
224,221,Jamie Lovemark,4,365,114,251,2005,total_driving,NA
225,224,Luke Donald,2,378,232,146,2005,total_driving,NA
226,226,Bo Van Pelt,7,387,155,232,2005,total_driving,NA
227,225,Davis Love III,3,400,172,228,2005,total_driving,NA
228,228,Arjun Atwal,5,404,173,231,2005,total_driving,NA
T229,231,Daniel Chopra,3,411,157,254,2005,total_driving,NA
T229,227,Kevin Stadler,6,411,217,194,2005,total_driving,NA
231,229,John Rollins,4,414,209,205,2005,total_driving,NA
232,230,Parker McLachlin,4,421,201,220,2005,total_driving,NA
233,232,Peter Malnati,9,422,197,225,2005,total_driving,NA
234,233,Michael Kim,8,435,211,224,2005,total_driving,NA
235,235,Tommy Gainey,4,442,209,233,2005,total_driving,NA
236,234,D.A. Points,4,446,226,220,2005,total_driving,NA
237,236,Ricky Barnes,6,451,214,237,2005,total_driving,NA
238,237,Brendon de Jonge,3,462,205,257,2005,total_driving,NA
239,238,Shugo Imahira,2,490,235,255,2005,total_driving,NA
1,1,Andrew Novak,2,35,17,18,2006,total_driving,NA
2,3,Viktor Hovland,4,63,16,47,2006,total_driving,NA
3,4,Chase Koepka,2,72,34,38,2006,total_driving,NA
4,5,John Oda,2,74,70,4,2006,total_driving,NA
5,6,D.J. Trahan,7,91,47,44,2006,total_driving,NA
6,8,Gary Woodland,4,98,94,4,2006,total_driving,NA
7,9,Branden Grace,4,99,21,78,2006,total_driving,NA
T8,10,Patrick Cantlay,3,103,86,17,2006,total_driving,NA
T8,7,Doc Redman,10,103,77,26,2006,total_driving,NA
10,2,Ryan Moore,5,105,94,11,2006,total_driving,NA
11,13,Scottie Scheffler,8,126,15,111,2006,total_driving,NA
12,T19,Kyoung-Hoon Lee,10,128,106,22,2006,total_driving,NA
13,14,Martin Laird,8,129,42,87,2006,total_driving,NA
14,11,Kevin Streelman,9,130,62,68,2006,total_driving,NA
15,25,Jhonattan Vegas,6,132,24,108,2006,total_driving,NA
T16,15,Nick Taylor,8,133,109,24,2006,total_driving,NA
T16,T23,Brendan Steele,8,133,63,70,2006,total_driving,NA
18,12,Harris English,7,135,36,99,2006,total_driving,NA
T19,T27,Harry Higgs,10,140,79,61,2006,total_driving,NA
T19,T27,Sung Kang,7,140,53,87,2006,total_driving,NA
T21,22,Emiliano Grillo,7,142,110,32,2006,total_driving,NA
T21,18,Bubba Watson,4,142,1,141,2006,total_driving,NA
23,T19,Bryson DeChambeau,3,144,13,131,2006,total_driving,NA
24,T52,Matthew Wolff,5,145,40,105,2006,total_driving,NA
25,29,Joel Dahmen,8,149,100,49,2006,total_driving,NA
26,16,Jason Kokrak,5,153,8,145,2006,total_driving,NA
27,17,Josh Teater,6,156,83,73,2006,total_driving,NA
28,T23,Cameron Champ,7,157,2,155,2006,total_driving,NA
29,33,Ryan Palmer,5,160,146,14,2006,total_driving,NA
30,T35,Adam Hadwin,5,164,121,43,2006,total_driving,NA
31,26,Sungjae Im,8,165,50,115,2006,total_driving,NA
32,31,Henrik Norlander,10,168,132,36,2006,total_driving,NA
T33,38,Boo Weekley,5,169,147,22,2006,total_driving,NA
T33,T35,Harold Varner III,7,169,18,151,2006,total_driving,NA
35,37,Lanto Griffin,10,170,40,130,2006,total_driving,NA
36,T19,Lucas Glover,7,174,98,76,2006,total_driving,NA
37,34,Scott Brown,9,175,151,24,2006,total_driving,NA
38,T44,Sebastián Muñoz,10,176,60,116,2006,total_driving,NA
T39,40,Daniel Berger,6,177,56,121,2006,total_driving,NA
T39,42,Keegan Bradley,7,177,71,106,2006,total_driving,NA
41,39,Chesson Hadley,7,179,106,73,2006,total_driving,NA
42,43,Webb Simpson,3,182,170,12,2006,total_driving,NA
43,48,Danny Lee,7,185,9,176,2006,total_driving,NA
44,T50,Pat Perez,6,186,130,56,2006,total_driving,NA
45,T52,Matthew NeSmith,9,188,154,34,2006,total_driving,NA
46,T99,Sepp Straka,10,191,92,99,2006,total_driving,NA
T47,T90,Isaiah Salinda,3,192,14,178,2006,total_driving,NA
T47,T56,John Merrick,4,192,135,57,2006,total_driving,NA
T49,T50,Jim Furyk,3,193,192,1,2006,total_driving,NA
T49,55,Chad Campbell,4,193,178,15,2006,total_driving,NA
T49,T44,Wyndham Clark,7,193,32,161,2006,total_driving,NA
52,32,Alex Noren,4,195,108,87,2006,total_driving,NA
53,NA,Rickie Fowler,2,196,194,2,2006,total_driving,NA
T54,T56,Tony Finau,5,198,12,186,2006,total_driving,NA
T54,T62,Phil Mickelson,5,198,31,167,2006,total_driving,NA
T54,T62,Aaron Wise,7,198,51,147,2006,total_driving,NA
T54,T69,Chase Seiffert,9,198,127,71,2006,total_driving,NA
T58,T73,Abraham Ancer,8,199,113,86,2006,total_driving,NA
T58,61,Adam Schenk,10,199,33,166,2006,total_driving,NA
T58,T64,Scott Harrington,9,199,34,165,2006,total_driving,NA
T61,T52,Brian Harman,8,200,143,57,2006,total_driving,NA
T61,47,Jason Dufner,7,200,140,60,2006,total_driving,NA
T61,59,Cameron Smith,6,200,77,123,2006,total_driving,NA
T64,46,Kramer Hickok,9,201,124,77,2006,total_driving,NA
T64,60,Matt Jones,8,201,49,152,2006,total_driving,NA
66,30,Robby Shelton,10,202,88,114,2006,total_driving,NA
T67,83,Grayson Murray,6,203,4,199,2006,total_driving,NA
T67,T73,Russell Knox,8,203,138,65,2006,total_driving,NA
69,41,Denny McCarthy,8,204,101,103,2006,total_driving,NA
70,T80,Sam Ryder,10,209,53,156,2006,total_driving,NA
71,58,Brice Garnett,8,214,150,64,2006,total_driving,NA
72,66,Michael Thompson,7,215,175,40,2006,total_driving,NA
73,76,Collin Morikawa,6,216,168,48,2006,total_driving,NA
T74,T69,Derek Ernst,4,217,80,137,2006,total_driving,NA
T74,T67,Adam Long,10,217,189,28,2006,total_driving,NA
T74,96,Andrew Landry,9,217,171,46,2006,total_driving,NA
77,T84,Akshay Bhatia,5,218,7,211,2006,total_driving,NA
78,T69,Rod Pampling,3,220,28,192,2006,total_driving,NA
79,136,Nick Watney,7,222,73,149,2006,total_driving,NA
T80,T84,Hideki Matsuyama,6,223,115,108,2006,total_driving,NA
T80,115,Doug Ghim,7,223,116,107,2006,total_driving,NA
T80,T90,Kristoffer Ventura,9,223,44,179,2006,total_driving,NA
T83,T73,Byeong Hun An,8,225,10,215,2006,total_driving,NA
T83,T90,Chandler Phillips,2,225,57,168,2006,total_driving,NA
T83,T69,Brian Stuard,10,225,215,10,2006,total_driving,NA
T83,T97,Alex Cejka,5,225,175,50,2006,total_driving,NA
T83,T80,Ryan Armour,9,225,217,8,2006,total_driving,NA
T88,T90,Graham DeLaet,5,226,36,190,2006,total_driving,NA
T88,T77,Tim Wilkinson,6,226,189,37,2006,total_driving,NA
T88,T86,Brandon Wu,2,226,188,38,2006,total_driving,NA
T91,T88,Hank Lebioda,9,228,104,124,2006,total_driving,NA
T91,79,Charles Howell III,9,228,69,159,2006,total_driving,NA
93,T67,Tyler McCumber,9,229,11,218,2006,total_driving,NA
94,T90,Fabián Gómez,9,230,167,63,2006,total_driving,NA
95,T90,Brendon Todd,11,231,228,3,2006,total_driving,NA
T96,49,Cameron Percy,8,233,61,172,2006,total_driving,NA
T96,T99,Adam Scott,4,233,46,187,2006,total_driving,NA
T96,T80,Luke List,9,233,80,153,2006,total_driving,NA
T96,T86,Russell Henley,8,233,179,54,2006,total_driving,NA
T96,T130,Mackenzie Hughes,8,233,101,132,2006,total_driving,NA
101,T109,J.T. Poston,9,234,175,59,2006,total_driving,NA
102,T64,Vince Covello,8,235,73,162,2006,total_driving,NA
103,T99,Xinjun Zhang,10,236,116,120,2006,total_driving,NA
104,105,K.J. Choi,3,237,233,4,2006,total_driving,NA
T105,107,Tim Herron,4,238,220,18,2006,total_driving,NA
T105,T109,Corey Conners,7,238,186,52,2006,total_driving,NA
T107,108,Keith Mitchell,7,239,135,104,2006,total_driving,NA
T107,T130,Cameron Davis,8,239,22,217,2006,total_driving,NA
T107,T99,Richy Werenski,4,239,45,194,2006,total_driving,NA
T107,T88,Vaughn Taylor,8,239,212,27,2006,total_driving,NA
111,168,Chris Baker,9,240,168,72,2006,total_driving,NA
T112,T112,Jim Herman,8,241,221,20,2006,total_driving,NA
T112,T127,Scott Piercy,8,241,105,136,2006,total_driving,NA
T114,T120,J.J. Henry,5,242,173,69,2006,total_driving,NA
T114,T103,Tyler Duncan,10,242,221,21,2006,total_driving,NA
116,T112,Davis Riley,2,243,83,160,2006,total_driving,NA
T117,T125,Bo Hoag,10,244,127,117,2006,total_driving,NA
T117,T116,Chez Reavie,9,244,228,16,2006,total_driving,NA
119,T116,Matt Kuchar,4,245,238,7,2006,total_driving,NA
T120,223,Paul Casey,4,247,160,87,2006,total_driving,NA
T120,T116,Satoshi Kodaira,6,247,234,13,2006,total_driving,NA
T120,T127,Shawn Stefani,6,247,73,174,2006,total_driving,NA
123,106,Carlos Ortiz,8,248,67,181,2006,total_driving,NA
124,T122,Ben Crane,6,249,207,42,2006,total_driving,NA
125,T130,Tom Lewis,3,252,5,247,2006,total_driving,NA
126,T139,Michael Gligic,9,253,73,180,2006,total_driving,NA
T127,T139,Scott Stallings,8,254,47,207,2006,total_driving,NA
T127,T137,Kyle Stanley,8,254,213,41,2006,total_driving,NA
T129,T137,Henrik Stenson,2,255,202,53,2006,total_driving,NA
T129,T125,Austin Cook,8,255,127,128,2006,total_driving,NA
T131,T120,Beau Hossler,8,256,29,227,2006,total_driving,NA
T131,T122,Patrick Rodgers,10,256,26,230,2006,total_driving,NA
T131,T143,Sebastian Cappelen,8,256,30,226,2006,total_driving,NA
T131,T133,Kurt Kitayama,2,256,3,253,2006,total_driving,NA
T131,T77,Vincent Whaley,7,256,103,153,2006,total_driving,NA
T131,T141,Ryan Brehm,10,256,6,250,2006,total_driving,NA
137,T122,Mark Hubbard,10,257,149,108,2006,total_driving,NA
T138,T163,Brandon Hagy,8,258,22,236,2006,total_driving,NA
T138,T109,Billy Horschel,6,258,196,62,2006,total_driving,NA
T140,T147,Sam Burns,6,259,20,239,2006,total_driving,NA
T140,T133,David Lingmerth,5,259,230,29,2006,total_driving,NA
T142,T187,Bud Cauley,6,262,125,137,2006,total_driving,NA
T142,T143,Cameron Tringale,7,262,55,207,2006,total_driving,NA
144,T143,Rikuya Hoshino,2,264,138,126,2006,total_driving,NA
145,T155,Jonathan Byrd,5,265,72,193,2006,total_driving,NA
T146,T116,Maverick McNealy,9,266,89,177,2006,total_driving,NA
T146,T147,Xander Schauffele,3,266,231,35,2006,total_driving,NA
T148,154,Whee Kim,2,267,180,87,2006,total_driving,NA
T148,T141,Lucas Bjerregaard,3,267,18,249,2006,total_driving,NA
150,T152,Chip McDaniel,2,268,59,209,2006,total_driving,NA
T151,T178,Max Homa,6,269,187,82,2006,total_driving,NA
T151,T112,Bill Haas,6,269,147,122,2006,total_driving,NA
T151,146,J.B. Holmes,3,269,224,45,2006,total_driving,NA
T154,129,Zack Sucher,6,270,24,246,2006,total_driving,NA
T154,T157,Roberto Castro,5,270,183,87,2006,total_driving,NA
156,151,Kevin Tway,6,271,27,244,2006,total_driving,NA
T157,T155,Kevin Chappell,6,272,43,229,2006,total_driving,NA
T157,T152,Dominic Bozzelli,7,272,38,234,2006,total_driving,NA
T159,T147,David Hearn,9,273,206,67,2006,total_driving,NA
T159,174,Jimmy Walker,4,273,92,181,2006,total_driving,NA
161,165,Sangmoon Bae,6,274,64,210,2006,total_driving,NA
162,167,Michael Gellerman,8,275,135,140,2006,total_driving,NA
163,T159,Kevin Kisner,7,277,227,50,2006,total_driving,NA
T164,T159,Justin Thomas,5,278,161,117,2006,total_driving,NA
T164,T187,Troy Merritt,7,278,182,96,2006,total_driving,NA
T164,T163,Freddie Jacobson,3,278,141,137,2006,total_driving,NA
167,T175,Talor Gooch,8,280,122,158,2006,total_driving,NA
168,T103,Andrew Putnam,6,283,181,102,2006,total_driving,NA
T169,T157,Si Woo Kim,8,284,99,185,2006,total_driving,NA
T169,T97,Charley Hoffman,7,284,87,197,2006,total_driving,NA
T169,169,Seamus Power,5,284,83,201,2006,total_driving,NA
172,T133,John Huh,5,285,166,119,2006,total_driving,NA
T173,T172,Jason Day,3,286,80,206,2006,total_driving,NA
T173,T172,Chris Kirk,3,286,199,87,2006,total_driving,NA
T173,T175,Rafael Campos,9,286,67,219,2006,total_driving,NA
176,T159,Nate Lashley,8,287,204,83,2006,total_driving,NA
177,177,Brandt Snedeker,4,288,155,133,2006,total_driving,NA
178,T178,Peter Uihlein,6,289,38,251,2006,total_driving,NA
179,150,Kevin Na,7,290,203,87,2006,total_driving,NA
180,T170,Ben Taylor,10,291,134,157,2006,total_driving,NA
181,162,Anirban Lahiri,8,292,118,174,2006,total_driving,NA
182,T208,Roger Sloan,8,293,158,135,2006,total_driving,NA
T183,182,Johnson Wagner,5,294,207,87,2006,total_driving,NA
T183,T183,Robert Garrigus,5,294,52,242,2006,total_driving,NA
T183,T187,Wes Roach,7,294,151,143,2006,total_driving,NA
186,181,Zach Johnson,7,299,216,83,2006,total_driving,NA
187,191,Mikumu Horikawa,3,303,237,66,2006,total_driving,NA
T188,194,Will Gordon,4,304,64,240,2006,total_driving,NA
T188,210,Rory Sabbatini,7,304,219,85,2006,total_driving,NA
T188,T183,Dylan Frittelli,9,304,193,111,2006,total_driving,NA
191,185,Nelson Ledesma,10,305,57,248,2006,total_driving,NA
192,192,Marc Leishman,5,306,90,216,2006,total_driving,NA
193,166,Joseph Bramlett,7,307,94,213,2006,total_driving,NA
194,195,Joaquin Niemann,8,308,164,144,2006,total_driving,NA
T195,T196,Graeme McDowell,5,311,236,75,2006,total_driving,NA
T195,T201,Bronson Burgoon,8,311,130,181,2006,total_driving,NA
197,T187,Brian Gay,9,312,162,150,2006,total_driving,NA
198,193,Rhein Gibson,9,313,90,223,2006,total_driving,NA
199,T196,Tom Hoge,8,314,185,129,2006,total_driving,NA
200,200,Mark Anderson,7,319,132,187,2006,total_driving,NA
201,204,Smylie Kaufman,3,320,64,256,2006,total_driving,NA
T202,199,Zac Blair,10,322,225,97,2006,total_driving,NA
T202,214,Francesco Molinari,3,322,125,197,2006,total_driving,NA
T204,T170,John Senden,5,324,120,204,2006,total_driving,NA
T204,180,Ben Martin,6,324,223,101,2006,total_driving,NA
T206,T205,James Hahn,6,325,163,162,2006,total_driving,NA
T206,186,Aaron Baddeley,6,325,198,127,2006,total_driving,NA
208,T211,J.J. Spaun,9,330,118,212,2006,total_driving,NA
T209,203,Robert Streb,9,332,141,191,2006,total_driving,NA
T209,T208,Robert Allenby,3,332,164,168,2006,total_driving,NA
211,T211,Martin Trainer,8,339,94,245,2006,total_driving,NA
212,T205,"Ted Potter, Jr.",7,340,151,189,2006,total_driving,NA
213,T201,Chris Stroud,6,341,194,147,2006,total_driving,NA
T214,T205,Rob Oppenheim,10,342,200,142,2006,total_driving,NA
T214,198,Matt Every,7,342,122,220,2006,total_driving,NA
T214,213,Morgan Hoffmann,4,342,143,199,2006,total_driving,NA
217,215,Roberto Díaz,2,345,110,235,2006,total_driving,NA
218,216,Stewart Cink,4,350,112,238,2006,total_driving,NA
219,217,C.T. Pan,5,353,189,164,2006,total_driving,NA
220,T218,Patton Kizzire,9,354,158,196,2006,total_driving,NA
221,222,Hudson Swafford,4,356,183,173,2006,total_driving,NA
222,T218,George McNeill,6,359,145,214,2006,total_driving,NA
223,220,Patrick Reed,4,363,239,124,2006,total_driving,NA
224,221,Jamie Lovemark,4,365,114,251,2006,total_driving,NA
225,224,Luke Donald,2,378,232,146,2006,total_driving,NA
226,226,Bo Van Pelt,7,387,155,232,2006,total_driving,NA
227,225,Davis Love III,3,400,172,228,2006,total_driving,NA
228,228,Arjun Atwal,5,404,173,231,2006,total_driving,NA
T229,231,Daniel Chopra,3,411,157,254,2006,total_driving,NA
T229,227,Kevin Stadler,6,411,217,194,2006,total_driving,NA
231,229,John Rollins,4,414,209,205,2006,total_driving,NA
232,230,Parker McLachlin,4,421,201,220,2006,total_driving,NA
233,232,Peter Malnati,9,422,197,225,2006,total_driving,NA
234,233,Michael Kim,8,435,211,224,2006,total_driving,NA
235,235,Tommy Gainey,4,442,209,233,2006,total_driving,NA
236,234,D.A. Points,4,446,226,220,2006,total_driving,NA
237,236,Ricky Barnes,6,451,214,237,2006,total_driving,NA
238,237,Brendon de Jonge,3,462,205,257,2006,total_driving,NA
239,238,Shugo Imahira,2,490,235,255,2006,total_driving,NA
1,1,Andrew Novak,2,35,17,18,2007,total_driving,NA
2,3,Viktor Hovland,4,63,16,47,2007,total_driving,NA
3,4,Chase Koepka,2,72,34,38,2007,total_driving,NA
4,5,John Oda,2,74,70,4,2007,total_driving,NA
5,6,D.J. Trahan,7,91,47,44,2007,total_driving,NA
6,8,Gary Woodland,4,98,94,4,2007,total_driving,NA
7,9,Branden Grace,4,99,21,78,2007,total_driving,NA
T8,10,Patrick Cantlay,3,103,86,17,2007,total_driving,NA
T8,7,Doc Redman,10,103,77,26,2007,total_driving,NA
10,2,Ryan Moore,5,105,94,11,2007,total_driving,NA
11,13,Scottie Scheffler,8,126,15,111,2007,total_driving,NA
12,T19,Kyoung-Hoon Lee,10,128,106,22,2007,total_driving,NA
13,14,Martin Laird,8,129,42,87,2007,total_driving,NA
14,11,Kevin Streelman,9,130,62,68,2007,total_driving,NA
15,25,Jhonattan Vegas,6,132,24,108,2007,total_driving,NA
T16,15,Nick Taylor,8,133,109,24,2007,total_driving,NA
T16,T23,Brendan Steele,8,133,63,70,2007,total_driving,NA
18,12,Harris English,7,135,36,99,2007,total_driving,NA
T19,T27,Harry Higgs,10,140,79,61,2007,total_driving,NA
T19,T27,Sung Kang,7,140,53,87,2007,total_driving,NA
T21,22,Emiliano Grillo,7,142,110,32,2007,total_driving,NA
T21,18,Bubba Watson,4,142,1,141,2007,total_driving,NA
23,T19,Bryson DeChambeau,3,144,13,131,2007,total_driving,NA
24,T52,Matthew Wolff,5,145,40,105,2007,total_driving,NA
25,29,Joel Dahmen,8,149,100,49,2007,total_driving,NA
26,16,Jason Kokrak,5,153,8,145,2007,total_driving,NA
27,17,Josh Teater,6,156,83,73,2007,total_driving,NA
28,T23,Cameron Champ,7,157,2,155,2007,total_driving,NA
29,33,Ryan Palmer,5,160,146,14,2007,total_driving,NA
30,T35,Adam Hadwin,5,164,121,43,2007,total_driving,NA
31,26,Sungjae Im,8,165,50,115,2007,total_driving,NA
32,31,Henrik Norlander,10,168,132,36,2007,total_driving,NA
T33,38,Boo Weekley,5,169,147,22,2007,total_driving,NA
T33,T35,Harold Varner III,7,169,18,151,2007,total_driving,NA
35,37,Lanto Griffin,10,170,40,130,2007,total_driving,NA
36,T19,Lucas Glover,7,174,98,76,2007,total_driving,NA
37,34,Scott Brown,9,175,151,24,2007,total_driving,NA
38,T44,Sebastián Muñoz,10,176,60,116,2007,total_driving,NA
T39,40,Daniel Berger,6,177,56,121,2007,total_driving,NA
T39,42,Keegan Bradley,7,177,71,106,2007,total_driving,NA
41,39,Chesson Hadley,7,179,106,73,2007,total_driving,NA
42,43,Webb Simpson,3,182,170,12,2007,total_driving,NA
43,48,Danny Lee,7,185,9,176,2007,total_driving,NA
44,T50,Pat Perez,6,186,130,56,2007,total_driving,NA
45,T52,Matthew NeSmith,9,188,154,34,2007,total_driving,NA
46,T99,Sepp Straka,10,191,92,99,2007,total_driving,NA
T47,T90,Isaiah Salinda,3,192,14,178,2007,total_driving,NA
T47,T56,John Merrick,4,192,135,57,2007,total_driving,NA
T49,T50,Jim Furyk,3,193,192,1,2007,total_driving,NA
T49,55,Chad Campbell,4,193,178,15,2007,total_driving,NA
T49,T44,Wyndham Clark,7,193,32,161,2007,total_driving,NA
52,32,Alex Noren,4,195,108,87,2007,total_driving,NA
53,NA,Rickie Fowler,2,196,194,2,2007,total_driving,NA
T54,T56,Tony Finau,5,198,12,186,2007,total_driving,NA
T54,T62,Phil Mickelson,5,198,31,167,2007,total_driving,NA
T54,T62,Aaron Wise,7,198,51,147,2007,total_driving,NA
T54,T69,Chase Seiffert,9,198,127,71,2007,total_driving,NA
T58,T73,Abraham Ancer,8,199,113,86,2007,total_driving,NA
T58,61,Adam Schenk,10,199,33,166,2007,total_driving,NA
T58,T64,Scott Harrington,9,199,34,165,2007,total_driving,NA
T61,T52,Brian Harman,8,200,143,57,2007,total_driving,NA
T61,47,Jason Dufner,7,200,140,60,2007,total_driving,NA
T61,59,Cameron Smith,6,200,77,123,2007,total_driving,NA
T64,46,Kramer Hickok,9,201,124,77,2007,total_driving,NA
T64,60,Matt Jones,8,201,49,152,2007,total_driving,NA
66,30,Robby Shelton,10,202,88,114,2007,total_driving,NA
T67,83,Grayson Murray,6,203,4,199,2007,total_driving,NA
T67,T73,Russell Knox,8,203,138,65,2007,total_driving,NA
69,41,Denny McCarthy,8,204,101,103,2007,total_driving,NA
70,T80,Sam Ryder,10,209,53,156,2007,total_driving,NA
71,58,Brice Garnett,8,214,150,64,2007,total_driving,NA
72,66,Michael Thompson,7,215,175,40,2007,total_driving,NA
73,76,Collin Morikawa,6,216,168,48,2007,total_driving,NA
T74,T69,Derek Ernst,4,217,80,137,2007,total_driving,NA
T74,T67,Adam Long,10,217,189,28,2007,total_driving,NA
T74,96,Andrew Landry,9,217,171,46,2007,total_driving,NA
77,T84,Akshay Bhatia,5,218,7,211,2007,total_driving,NA
78,T69,Rod Pampling,3,220,28,192,2007,total_driving,NA
79,136,Nick Watney,7,222,73,149,2007,total_driving,NA
T80,T84,Hideki Matsuyama,6,223,115,108,2007,total_driving,NA
T80,115,Doug Ghim,7,223,116,107,2007,total_driving,NA
T80,T90,Kristoffer Ventura,9,223,44,179,2007,total_driving,NA
T83,T73,Byeong Hun An,8,225,10,215,2007,total_driving,NA
T83,T90,Chandler Phillips,2,225,57,168,2007,total_driving,NA
T83,T69,Brian Stuard,10,225,215,10,2007,total_driving,NA
T83,T97,Alex Cejka,5,225,175,50,2007,total_driving,NA
T83,T80,Ryan Armour,9,225,217,8,2007,total_driving,NA
T88,T90,Graham DeLaet,5,226,36,190,2007,total_driving,NA
T88,T77,Tim Wilkinson,6,226,189,37,2007,total_driving,NA
T88,T86,Brandon Wu,2,226,188,38,2007,total_driving,NA
T91,T88,Hank Lebioda,9,228,104,124,2007,total_driving,NA
T91,79,Charles Howell III,9,228,69,159,2007,total_driving,NA
93,T67,Tyler McCumber,9,229,11,218,2007,total_driving,NA
94,T90,Fabián Gómez,9,230,167,63,2007,total_driving,NA
95,T90,Brendon Todd,11,231,228,3,2007,total_driving,NA
T96,49,Cameron Percy,8,233,61,172,2007,total_driving,NA
T96,T99,Adam Scott,4,233,46,187,2007,total_driving,NA
T96,T80,Luke List,9,233,80,153,2007,total_driving,NA
T96,T86,Russell Henley,8,233,179,54,2007,total_driving,NA
T96,T130,Mackenzie Hughes,8,233,101,132,2007,total_driving,NA
101,T109,J.T. Poston,9,234,175,59,2007,total_driving,NA
102,T64,Vince Covello,8,235,73,162,2007,total_driving,NA
103,T99,Xinjun Zhang,10,236,116,120,2007,total_driving,NA
104,105,K.J. Choi,3,237,233,4,2007,total_driving,NA
T105,107,Tim Herron,4,238,220,18,2007,total_driving,NA
T105,T109,Corey Conners,7,238,186,52,2007,total_driving,NA
T107,108,Keith Mitchell,7,239,135,104,2007,total_driving,NA
T107,T130,Cameron Davis,8,239,22,217,2007,total_driving,NA
T107,T99,Richy Werenski,4,239,45,194,2007,total_driving,NA
T107,T88,Vaughn Taylor,8,239,212,27,2007,total_driving,NA
111,168,Chris Baker,9,240,168,72,2007,total_driving,NA
T112,T112,Jim Herman,8,241,221,20,2007,total_driving,NA
T112,T127,Scott Piercy,8,241,105,136,2007,total_driving,NA
T114,T120,J.J. Henry,5,242,173,69,2007,total_driving,NA
T114,T103,Tyler Duncan,10,242,221,21,2007,total_driving,NA
116,T112,Davis Riley,2,243,83,160,2007,total_driving,NA
T117,T125,Bo Hoag,10,244,127,117,2007,total_driving,NA
T117,T116,Chez Reavie,9,244,228,16,2007,total_driving,NA
119,T116,Matt Kuchar,4,245,238,7,2007,total_driving,NA
T120,223,Paul Casey,4,247,160,87,2007,total_driving,NA
T120,T116,Satoshi Kodaira,6,247,234,13,2007,total_driving,NA
T120,T127,Shawn Stefani,6,247,73,174,2007,total_driving,NA
123,106,Carlos Ortiz,8,248,67,181,2007,total_driving,NA
124,T122,Ben Crane,6,249,207,42,2007,total_driving,NA
125,T130,Tom Lewis,3,252,5,247,2007,total_driving,NA
126,T139,Michael Gligic,9,253,73,180,2007,total_driving,NA
T127,T139,Scott Stallings,8,254,47,207,2007,total_driving,NA
T127,T137,Kyle Stanley,8,254,213,41,2007,total_driving,NA
T129,T137,Henrik Stenson,2,255,202,53,2007,total_driving,NA
T129,T125,Austin Cook,8,255,127,128,2007,total_driving,NA
T131,T120,Beau Hossler,8,256,29,227,2007,total_driving,NA
T131,T122,Patrick Rodgers,10,256,26,230,2007,total_driving,NA
T131,T143,Sebastian Cappelen,8,256,30,226,2007,total_driving,NA
T131,T133,Kurt Kitayama,2,256,3,253,2007,total_driving,NA
T131,T77,Vincent Whaley,7,256,103,153,2007,total_driving,NA
T131,T141,Ryan Brehm,10,256,6,250,2007,total_driving,NA
137,T122,Mark Hubbard,10,257,149,108,2007,total_driving,NA
T138,T163,Brandon Hagy,8,258,22,236,2007,total_driving,NA
T138,T109,Billy Horschel,6,258,196,62,2007,total_driving,NA
T140,T147,Sam Burns,6,259,20,239,2007,total_driving,NA
T140,T133,David Lingmerth,5,259,230,29,2007,total_driving,NA
T142,T187,Bud Cauley,6,262,125,137,2007,total_driving,NA
T142,T143,Cameron Tringale,7,262,55,207,2007,total_driving,NA
144,T143,Rikuya Hoshino,2,264,138,126,2007,total_driving,NA
145,T155,Jonathan Byrd,5,265,72,193,2007,total_driving,NA
T146,T116,Maverick McNealy,9,266,89,177,2007,total_driving,NA
T146,T147,Xander Schauffele,3,266,231,35,2007,total_driving,NA
T148,154,Whee Kim,2,267,180,87,2007,total_driving,NA
T148,T141,Lucas Bjerregaard,3,267,18,249,2007,total_driving,NA
150,T152,Chip McDaniel,2,268,59,209,2007,total_driving,NA
T151,T178,Max Homa,6,269,187,82,2007,total_driving,NA
T151,T112,Bill Haas,6,269,147,122,2007,total_driving,NA
T151,146,J.B. Holmes,3,269,224,45,2007,total_driving,NA
T154,129,Zack Sucher,6,270,24,246,2007,total_driving,NA
T154,T157,Roberto Castro,5,270,183,87,2007,total_driving,NA
156,151,Kevin Tway,6,271,27,244,2007,total_driving,NA
T157,T155,Kevin Chappell,6,272,43,229,2007,total_driving,NA
T157,T152,Dominic Bozzelli,7,272,38,234,2007,total_driving,NA
T159,T147,David Hearn,9,273,206,67,2007,total_driving,NA
T159,174,Jimmy Walker,4,273,92,181,2007,total_driving,NA
161,165,Sangmoon Bae,6,274,64,210,2007,total_driving,NA
162,167,Michael Gellerman,8,275,135,140,2007,total_driving,NA
163,T159,Kevin Kisner,7,277,227,50,2007,total_driving,NA
T164,T159,Justin Thomas,5,278,161,117,2007,total_driving,NA
T164,T187,Troy Merritt,7,278,182,96,2007,total_driving,NA
T164,T163,Freddie Jacobson,3,278,141,137,2007,total_driving,NA
167,T175,Talor Gooch,8,280,122,158,2007,total_driving,NA
168,T103,Andrew Putnam,6,283,181,102,2007,total_driving,NA
T169,T157,Si Woo Kim,8,284,99,185,2007,total_driving,NA
T169,T97,Charley Hoffman,7,284,87,197,2007,total_driving,NA
T169,169,Seamus Power,5,284,83,201,2007,total_driving,NA
172,T133,John Huh,5,285,166,119,2007,total_driving,NA
T173,T172,Jason Day,3,286,80,206,2007,total_driving,NA
T173,T172,Chris Kirk,3,286,199,87,2007,total_driving,NA
T173,T175,Rafael Campos,9,286,67,219,2007,total_driving,NA
176,T159,Nate Lashley,8,287,204,83,2007,total_driving,NA
177,177,Brandt Snedeker,4,288,155,133,2007,total_driving,NA
178,T178,Peter Uihlein,6,289,38,251,2007,total_driving,NA
179,150,Kevin Na,7,290,203,87,2007,total_driving,NA
180,T170,Ben Taylor,10,291,134,157,2007,total_driving,NA
181,162,Anirban Lahiri,8,292,118,174,2007,total_driving,NA
182,T208,Roger Sloan,8,293,158,135,2007,total_driving,NA
T183,182,Johnson Wagner,5,294,207,87,2007,total_driving,NA
T183,T183,Robert Garrigus,5,294,52,242,2007,total_driving,NA
T183,T187,Wes Roach,7,294,151,143,2007,total_driving,NA
186,181,Zach Johnson,7,299,216,83,2007,total_driving,NA
187,191,Mikumu Horikawa,3,303,237,66,2007,total_driving,NA
T188,194,Will Gordon,4,304,64,240,2007,total_driving,NA
T188,210,Rory Sabbatini,7,304,219,85,2007,total_driving,NA
T188,T183,Dylan Frittelli,9,304,193,111,2007,total_driving,NA
191,185,Nelson Ledesma,10,305,57,248,2007,total_driving,NA
192,192,Marc Leishman,5,306,90,216,2007,total_driving,NA
193,166,Joseph Bramlett,7,307,94,213,2007,total_driving,NA
194,195,Joaquin Niemann,8,308,164,144,2007,total_driving,NA
T195,T196,Graeme McDowell,5,311,236,75,2007,total_driving,NA
T195,T201,Bronson Burgoon,8,311,130,181,2007,total_driving,NA
197,T187,Brian Gay,9,312,162,150,2007,total_driving,NA
198,193,Rhein Gibson,9,313,90,223,2007,total_driving,NA
199,T196,Tom Hoge,8,314,185,129,2007,total_driving,NA
200,200,Mark Anderson,7,319,132,187,2007,total_driving,NA
201,204,Smylie Kaufman,3,320,64,256,2007,total_driving,NA
T202,199,Zac Blair,10,322,225,97,2007,total_driving,NA
T202,214,Francesco Molinari,3,322,125,197,2007,total_driving,NA
T204,T170,John Senden,5,324,120,204,2007,total_driving,NA
T204,180,Ben Martin,6,324,223,101,2007,total_driving,NA
T206,T205,James Hahn,6,325,163,162,2007,total_driving,NA
T206,186,Aaron Baddeley,6,325,198,127,2007,total_driving,NA
208,T211,J.J. Spaun,9,330,118,212,2007,total_driving,NA
T209,203,Robert Streb,9,332,141,191,2007,total_driving,NA
T209,T208,Robert Allenby,3,332,164,168,2007,total_driving,NA
211,T211,Martin Trainer,8,339,94,245,2007,total_driving,NA
212,T205,"Ted Potter, Jr.",7,340,151,189,2007,total_driving,NA
213,T201,Chris Stroud,6,341,194,147,2007,total_driving,NA
T214,T205,Rob Oppenheim,10,342,200,142,2007,total_driving,NA
T214,198,Matt Every,7,342,122,220,2007,total_driving,NA
T214,213,Morgan Hoffmann,4,342,143,199,2007,total_driving,NA
217,215,Roberto Díaz,2,345,110,235,2007,total_driving,NA
218,216,Stewart Cink,4,350,112,238,2007,total_driving,NA
219,217,C.T. Pan,5,353,189,164,2007,total_driving,NA
220,T218,Patton Kizzire,9,354,158,196,2007,total_driving,NA
221,222,Hudson Swafford,4,356,183,173,2007,total_driving,NA
222,T218,George McNeill,6,359,145,214,2007,total_driving,NA
223,220,Patrick Reed,4,363,239,124,2007,total_driving,NA
224,221,Jamie Lovemark,4,365,114,251,2007,total_driving,NA
225,224,Luke Donald,2,378,232,146,2007,total_driving,NA
226,226,Bo Van Pelt,7,387,155,232,2007,total_driving,NA
227,225,Davis Love III,3,400,172,228,2007,total_driving,NA
228,228,Arjun Atwal,5,404,173,231,2007,total_driving,NA
T229,231,Daniel Chopra,3,411,157,254,2007,total_driving,NA
T229,227,Kevin Stadler,6,411,217,194,2007,total_driving,NA
231,229,John Rollins,4,414,209,205,2007,total_driving,NA
232,230,Parker McLachlin,4,421,201,220,2007,total_driving,NA
233,232,Peter Malnati,9,422,197,225,2007,total_driving,NA
234,233,Michael Kim,8,435,211,224,2007,total_driving,NA
235,235,Tommy Gainey,4,442,209,233,2007,total_driving,NA
236,234,D.A. Points,4,446,226,220,2007,total_driving,NA
237,236,Ricky Barnes,6,451,214,237,2007,total_driving,NA
238,237,Brendon de Jonge,3,462,205,257,2007,total_driving,NA
239,238,Shugo Imahira,2,490,235,255,2007,total_driving,NA
1,1,Andrew Novak,2,35,17,18,2008,total_driving,NA
2,3,Viktor Hovland,4,63,16,47,2008,total_driving,NA
3,4,Chase Koepka,2,72,34,38,2008,total_driving,NA
4,5,John Oda,2,74,70,4,2008,total_driving,NA
5,6,D.J. Trahan,7,91,47,44,2008,total_driving,NA
6,8,Gary Woodland,4,98,94,4,2008,total_driving,NA
7,9,Branden Grace,4,99,21,78,2008,total_driving,NA
T8,10,Patrick Cantlay,3,103,86,17,2008,total_driving,NA
T8,7,Doc Redman,10,103,77,26,2008,total_driving,NA
10,2,Ryan Moore,5,105,94,11,2008,total_driving,NA
11,13,Scottie Scheffler,8,126,15,111,2008,total_driving,NA
12,T19,Kyoung-Hoon Lee,10,128,106,22,2008,total_driving,NA
13,14,Martin Laird,8,129,42,87,2008,total_driving,NA
14,11,Kevin Streelman,9,130,62,68,2008,total_driving,NA
15,25,Jhonattan Vegas,6,132,24,108,2008,total_driving,NA
T16,15,Nick Taylor,8,133,109,24,2008,total_driving,NA
T16,T23,Brendan Steele,8,133,63,70,2008,total_driving,NA
18,12,Harris English,7,135,36,99,2008,total_driving,NA
T19,T27,Harry Higgs,10,140,79,61,2008,total_driving,NA
T19,T27,Sung Kang,7,140,53,87,2008,total_driving,NA
T21,22,Emiliano Grillo,7,142,110,32,2008,total_driving,NA
T21,18,Bubba Watson,4,142,1,141,2008,total_driving,NA
23,T19,Bryson DeChambeau,3,144,13,131,2008,total_driving,NA
24,T52,Matthew Wolff,5,145,40,105,2008,total_driving,NA
25,29,Joel Dahmen,8,149,100,49,2008,total_driving,NA
26,16,Jason Kokrak,5,153,8,145,2008,total_driving,NA
27,17,Josh Teater,6,156,83,73,2008,total_driving,NA
28,T23,Cameron Champ,7,157,2,155,2008,total_driving,NA
29,33,Ryan Palmer,5,160,146,14,2008,total_driving,NA
30,T35,Adam Hadwin,5,164,121,43,2008,total_driving,NA
31,26,Sungjae Im,8,165,50,115,2008,total_driving,NA
32,31,Henrik Norlander,10,168,132,36,2008,total_driving,NA
T33,38,Boo Weekley,5,169,147,22,2008,total_driving,NA
T33,T35,Harold Varner III,7,169,18,151,2008,total_driving,NA
35,37,Lanto Griffin,10,170,40,130,2008,total_driving,NA
36,T19,Lucas Glover,7,174,98,76,2008,total_driving,NA
37,34,Scott Brown,9,175,151,24,2008,total_driving,NA
38,T44,Sebastián Muñoz,10,176,60,116,2008,total_driving,NA
T39,40,Daniel Berger,6,177,56,121,2008,total_driving,NA
T39,42,Keegan Bradley,7,177,71,106,2008,total_driving,NA
41,39,Chesson Hadley,7,179,106,73,2008,total_driving,NA
42,43,Webb Simpson,3,182,170,12,2008,total_driving,NA
43,48,Danny Lee,7,185,9,176,2008,total_driving,NA
44,T50,Pat Perez,6,186,130,56,2008,total_driving,NA
45,T52,Matthew NeSmith,9,188,154,34,2008,total_driving,NA
46,T99,Sepp Straka,10,191,92,99,2008,total_driving,NA
T47,T90,Isaiah Salinda,3,192,14,178,2008,total_driving,NA
T47,T56,John Merrick,4,192,135,57,2008,total_driving,NA
T49,T50,Jim Furyk,3,193,192,1,2008,total_driving,NA
T49,55,Chad Campbell,4,193,178,15,2008,total_driving,NA
T49,T44,Wyndham Clark,7,193,32,161,2008,total_driving,NA
52,32,Alex Noren,4,195,108,87,2008,total_driving,NA
53,NA,Rickie Fowler,2,196,194,2,2008,total_driving,NA
T54,T56,Tony Finau,5,198,12,186,2008,total_driving,NA
T54,T62,Phil Mickelson,5,198,31,167,2008,total_driving,NA
T54,T62,Aaron Wise,7,198,51,147,2008,total_driving,NA
T54,T69,Chase Seiffert,9,198,127,71,2008,total_driving,NA
T58,T73,Abraham Ancer,8,199,113,86,2008,total_driving,NA
T58,61,Adam Schenk,10,199,33,166,2008,total_driving,NA
T58,T64,Scott Harrington,9,199,34,165,2008,total_driving,NA
T61,T52,Brian Harman,8,200,143,57,2008,total_driving,NA
T61,47,Jason Dufner,7,200,140,60,2008,total_driving,NA
T61,59,Cameron Smith,6,200,77,123,2008,total_driving,NA
T64,46,Kramer Hickok,9,201,124,77,2008,total_driving,NA
T64,60,Matt Jones,8,201,49,152,2008,total_driving,NA
66,30,Robby Shelton,10,202,88,114,2008,total_driving,NA
T67,83,Grayson Murray,6,203,4,199,2008,total_driving,NA
T67,T73,Russell Knox,8,203,138,65,2008,total_driving,NA
69,41,Denny McCarthy,8,204,101,103,2008,total_driving,NA
70,T80,Sam Ryder,10,209,53,156,2008,total_driving,NA
71,58,Brice Garnett,8,214,150,64,2008,total_driving,NA
72,66,Michael Thompson,7,215,175,40,2008,total_driving,NA
73,76,Collin Morikawa,6,216,168,48,2008,total_driving,NA
T74,T69,Derek Ernst,4,217,80,137,2008,total_driving,NA
T74,T67,Adam Long,10,217,189,28,2008,total_driving,NA
T74,96,Andrew Landry,9,217,171,46,2008,total_driving,NA
77,T84,Akshay Bhatia,5,218,7,211,2008,total_driving,NA
78,T69,Rod Pampling,3,220,28,192,2008,total_driving,NA
79,136,Nick Watney,7,222,73,149,2008,total_driving,NA
T80,T84,Hideki Matsuyama,6,223,115,108,2008,total_driving,NA
T80,115,Doug Ghim,7,223,116,107,2008,total_driving,NA
T80,T90,Kristoffer Ventura,9,223,44,179,2008,total_driving,NA
T83,T73,Byeong Hun An,8,225,10,215,2008,total_driving,NA
T83,T90,Chandler Phillips,2,225,57,168,2008,total_driving,NA
T83,T69,Brian Stuard,10,225,215,10,2008,total_driving,NA
T83,T97,Alex Cejka,5,225,175,50,2008,total_driving,NA
T83,T80,Ryan Armour,9,225,217,8,2008,total_driving,NA
T88,T90,Graham DeLaet,5,226,36,190,2008,total_driving,NA
T88,T77,Tim Wilkinson,6,226,189,37,2008,total_driving,NA
T88,T86,Brandon Wu,2,226,188,38,2008,total_driving,NA
T91,T88,Hank Lebioda,9,228,104,124,2008,total_driving,NA
T91,79,Charles Howell III,9,228,69,159,2008,total_driving,NA
93,T67,Tyler McCumber,9,229,11,218,2008,total_driving,NA
94,T90,Fabián Gómez,9,230,167,63,2008,total_driving,NA
95,T90,Brendon Todd,11,231,228,3,2008,total_driving,NA
T96,49,Cameron Percy,8,233,61,172,2008,total_driving,NA
T96,T99,Adam Scott,4,233,46,187,2008,total_driving,NA
T96,T80,Luke List,9,233,80,153,2008,total_driving,NA
T96,T86,Russell Henley,8,233,179,54,2008,total_driving,NA
T96,T130,Mackenzie Hughes,8,233,101,132,2008,total_driving,NA
101,T109,J.T. Poston,9,234,175,59,2008,total_driving,NA
102,T64,Vince Covello,8,235,73,162,2008,total_driving,NA
103,T99,Xinjun Zhang,10,236,116,120,2008,total_driving,NA
104,105,K.J. Choi,3,237,233,4,2008,total_driving,NA
T105,107,Tim Herron,4,238,220,18,2008,total_driving,NA
T105,T109,Corey Conners,7,238,186,52,2008,total_driving,NA
T107,108,Keith Mitchell,7,239,135,104,2008,total_driving,NA
T107,T130,Cameron Davis,8,239,22,217,2008,total_driving,NA
T107,T99,Richy Werenski,4,239,45,194,2008,total_driving,NA
T107,T88,Vaughn Taylor,8,239,212,27,2008,total_driving,NA
111,168,Chris Baker,9,240,168,72,2008,total_driving,NA
T112,T112,Jim Herman,8,241,221,20,2008,total_driving,NA
T112,T127,Scott Piercy,8,241,105,136,2008,total_driving,NA
T114,T120,J.J. Henry,5,242,173,69,2008,total_driving,NA
T114,T103,Tyler Duncan,10,242,221,21,2008,total_driving,NA
116,T112,Davis Riley,2,243,83,160,2008,total_driving,NA
T117,T125,Bo Hoag,10,244,127,117,2008,total_driving,NA
T117,T116,Chez Reavie,9,244,228,16,2008,total_driving,NA
119,T116,Matt Kuchar,4,245,238,7,2008,total_driving,NA
T120,223,Paul Casey,4,247,160,87,2008,total_driving,NA
T120,T116,Satoshi Kodaira,6,247,234,13,2008,total_driving,NA
T120,T127,Shawn Stefani,6,247,73,174,2008,total_driving,NA
123,106,Carlos Ortiz,8,248,67,181,2008,total_driving,NA
124,T122,Ben Crane,6,249,207,42,2008,total_driving,NA
125,T130,Tom Lewis,3,252,5,247,2008,total_driving,NA
126,T139,Michael Gligic,9,253,73,180,2008,total_driving,NA
T127,T139,Scott Stallings,8,254,47,207,2008,total_driving,NA
T127,T137,Kyle Stanley,8,254,213,41,2008,total_driving,NA
T129,T137,Henrik Stenson,2,255,202,53,2008,total_driving,NA
T129,T125,Austin Cook,8,255,127,128,2008,total_driving,NA
T131,T120,Beau Hossler,8,256,29,227,2008,total_driving,NA
T131,T122,Patrick Rodgers,10,256,26,230,2008,total_driving,NA
T131,T143,Sebastian Cappelen,8,256,30,226,2008,total_driving,NA
T131,T133,Kurt Kitayama,2,256,3,253,2008,total_driving,NA
T131,T77,Vincent Whaley,7,256,103,153,2008,total_driving,NA
T131,T141,Ryan Brehm,10,256,6,250,2008,total_driving,NA
137,T122,Mark Hubbard,10,257,149,108,2008,total_driving,NA
T138,T163,Brandon Hagy,8,258,22,236,2008,total_driving,NA
T138,T109,Billy Horschel,6,258,196,62,2008,total_driving,NA
T140,T147,Sam Burns,6,259,20,239,2008,total_driving,NA
T140,T133,David Lingmerth,5,259,230,29,2008,total_driving,NA
T142,T187,Bud Cauley,6,262,125,137,2008,total_driving,NA
T142,T143,Cameron Tringale,7,262,55,207,2008,total_driving,NA
144,T143,Rikuya Hoshino,2,264,138,126,2008,total_driving,NA
145,T155,Jonathan Byrd,5,265,72,193,2008,total_driving,NA
T146,T116,Maverick McNealy,9,266,89,177,2008,total_driving,NA
T146,T147,Xander Schauffele,3,266,231,35,2008,total_driving,NA
T148,154,Whee Kim,2,267,180,87,2008,total_driving,NA
T148,T141,Lucas Bjerregaard,3,267,18,249,2008,total_driving,NA
150,T152,Chip McDaniel,2,268,59,209,2008,total_driving,NA
T151,T178,Max Homa,6,269,187,82,2008,total_driving,NA
T151,T112,Bill Haas,6,269,147,122,2008,total_driving,NA
T151,146,J.B. Holmes,3,269,224,45,2008,total_driving,NA
T154,129,Zack Sucher,6,270,24,246,2008,total_driving,NA
T154,T157,Roberto Castro,5,270,183,87,2008,total_driving,NA
156,151,Kevin Tway,6,271,27,244,2008,total_driving,NA
T157,T155,Kevin Chappell,6,272,43,229,2008,total_driving,NA
T157,T152,Dominic Bozzelli,7,272,38,234,2008,total_driving,NA
T159,T147,David Hearn,9,273,206,67,2008,total_driving,NA
T159,174,Jimmy Walker,4,273,92,181,2008,total_driving,NA
161,165,Sangmoon Bae,6,274,64,210,2008,total_driving,NA
162,167,Michael Gellerman,8,275,135,140,2008,total_driving,NA
163,T159,Kevin Kisner,7,277,227,50,2008,total_driving,NA
T164,T159,Justin Thomas,5,278,161,117,2008,total_driving,NA
T164,T187,Troy Merritt,7,278,182,96,2008,total_driving,NA
T164,T163,Freddie Jacobson,3,278,141,137,2008,total_driving,NA
167,T175,Talor Gooch,8,280,122,158,2008,total_driving,NA
168,T103,Andrew Putnam,6,283,181,102,2008,total_driving,NA
T169,T157,Si Woo Kim,8,284,99,185,2008,total_driving,NA
T169,T97,Charley Hoffman,7,284,87,197,2008,total_driving,NA
T169,169,Seamus Power,5,284,83,201,2008,total_driving,NA
172,T133,John Huh,5,285,166,119,2008,total_driving,NA
T173,T172,Jason Day,3,286,80,206,2008,total_driving,NA
T173,T172,Chris Kirk,3,286,199,87,2008,total_driving,NA
T173,T175,Rafael Campos,9,286,67,219,2008,total_driving,NA
176,T159,Nate Lashley,8,287,204,83,2008,total_driving,NA
177,177,Brandt Snedeker,4,288,155,133,2008,total_driving,NA
178,T178,Peter Uihlein,6,289,38,251,2008,total_driving,NA
179,150,Kevin Na,7,290,203,87,2008,total_driving,NA
180,T170,Ben Taylor,10,291,134,157,2008,total_driving,NA
181,162,Anirban Lahiri,8,292,118,174,2008,total_driving,NA
182,T208,Roger Sloan,8,293,158,135,2008,total_driving,NA
T183,182,Johnson Wagner,5,294,207,87,2008,total_driving,NA
T183,T183,Robert Garrigus,5,294,52,242,2008,total_driving,NA
T183,T187,Wes Roach,7,294,151,143,2008,total_driving,NA
186,181,Zach Johnson,7,299,216,83,2008,total_driving,NA
187,191,Mikumu Horikawa,3,303,237,66,2008,total_driving,NA
T188,194,Will Gordon,4,304,64,240,2008,total_driving,NA
T188,210,Rory Sabbatini,7,304,219,85,2008,total_driving,NA
T188,T183,Dylan Frittelli,9,304,193,111,2008,total_driving,NA
191,185,Nelson Ledesma,10,305,57,248,2008,total_driving,NA
192,192,Marc Leishman,5,306,90,216,2008,total_driving,NA
193,166,Joseph Bramlett,7,307,94,213,2008,total_driving,NA
194,195,Joaquin Niemann,8,308,164,144,2008,total_driving,NA
T195,T196,Graeme McDowell,5,311,236,75,2008,total_driving,NA
T195,T201,Bronson Burgoon,8,311,130,181,2008,total_driving,NA
197,T187,Brian Gay,9,312,162,150,2008,total_driving,NA
198,193,Rhein Gibson,9,313,90,223,2008,total_driving,NA
199,T196,Tom Hoge,8,314,185,129,2008,total_driving,NA
200,200,Mark Anderson,7,319,132,187,2008,total_driving,NA
201,204,Smylie Kaufman,3,320,64,256,2008,total_driving,NA
T202,199,Zac Blair,10,322,225,97,2008,total_driving,NA
T202,214,Francesco Molinari,3,322,125,197,2008,total_driving,NA
T204,T170,John Senden,5,324,120,204,2008,total_driving,NA
T204,180,Ben Martin,6,324,223,101,2008,total_driving,NA
T206,T205,James Hahn,6,325,163,162,2008,total_driving,NA
T206,186,Aaron Baddeley,6,325,198,127,2008,total_driving,NA
208,T211,J.J. Spaun,9,330,118,212,2008,total_driving,NA
T209,203,Robert Streb,9,332,141,191,2008,total_driving,NA
T209,T208,Robert Allenby,3,332,164,168,2008,total_driving,NA
211,T211,Martin Trainer,8,339,94,245,2008,total_driving,NA
212,T205,"Ted Potter, Jr.",7,340,151,189,2008,total_driving,NA
213,T201,Chris Stroud,6,341,194,147,2008,total_driving,NA
T214,T205,Rob Oppenheim,10,342,200,142,2008,total_driving,NA
T214,198,Matt Every,7,342,122,220,2008,total_driving,NA
T214,213,Morgan Hoffmann,4,342,143,199,2008,total_driving,NA
217,215,Roberto Díaz,2,345,110,235,2008,total_driving,NA
218,216,Stewart Cink,4,350,112,238,2008,total_driving,NA
219,217,C.T. Pan,5,353,189,164,2008,total_driving,NA
220,T218,Patton Kizzire,9,354,158,196,2008,total_driving,NA
221,222,Hudson Swafford,4,356,183,173,2008,total_driving,NA
222,T218,George McNeill,6,359,145,214,2008,total_driving,NA
223,220,Patrick Reed,4,363,239,124,2008,total_driving,NA
224,221,Jamie Lovemark,4,365,114,251,2008,total_driving,NA
225,224,Luke Donald,2,378,232,146,2008,total_driving,NA
226,226,Bo Van Pelt,7,387,155,232,2008,total_driving,NA
227,225,Davis Love III,3,400,172,228,2008,total_driving,NA
228,228,Arjun Atwal,5,404,173,231,2008,total_driving,NA
T229,231,Daniel Chopra,3,411,157,254,2008,total_driving,NA
T229,227,Kevin Stadler,6,411,217,194,2008,total_driving,NA
231,229,John Rollins,4,414,209,205,2008,total_driving,NA
232,230,Parker McLachlin,4,421,201,220,2008,total_driving,NA
233,232,Peter Malnati,9,422,197,225,2008,total_driving,NA
234,233,Michael Kim,8,435,211,224,2008,total_driving,NA
235,235,Tommy Gainey,4,442,209,233,2008,total_driving,NA
236,234,D.A. Points,4,446,226,220,2008,total_driving,NA
237,236,Ricky Barnes,6,451,214,237,2008,total_driving,NA
238,237,Brendon de Jonge,3,462,205,257,2008,total_driving,NA
239,238,Shugo Imahira,2,490,235,255,2008,total_driving,NA
1,1,Andrew Novak,2,35,17,18,2009,total_driving,NA
2,3,Viktor Hovland,4,63,16,47,2009,total_driving,NA
3,4,Chase Koepka,2,72,34,38,2009,total_driving,NA
4,5,John Oda,2,74,70,4,2009,total_driving,NA
5,6,D.J. Trahan,7,91,47,44,2009,total_driving,NA
6,8,Gary Woodland,4,98,94,4,2009,total_driving,NA
7,9,Branden Grace,4,99,21,78,2009,total_driving,NA
T8,10,Patrick Cantlay,3,103,86,17,2009,total_driving,NA
T8,7,Doc Redman,10,103,77,26,2009,total_driving,NA
10,2,Ryan Moore,5,105,94,11,2009,total_driving,NA
11,13,Scottie Scheffler,8,126,15,111,2009,total_driving,NA
12,T19,Kyoung-Hoon Lee,10,128,106,22,2009,total_driving,NA
13,14,Martin Laird,8,129,42,87,2009,total_driving,NA
14,11,Kevin Streelman,9,130,62,68,2009,total_driving,NA
15,25,Jhonattan Vegas,6,132,24,108,2009,total_driving,NA
T16,15,Nick Taylor,8,133,109,24,2009,total_driving,NA
T16,T23,Brendan Steele,8,133,63,70,2009,total_driving,NA
18,12,Harris English,7,135,36,99,2009,total_driving,NA
T19,T27,Harry Higgs,10,140,79,61,2009,total_driving,NA
T19,T27,Sung Kang,7,140,53,87,2009,total_driving,NA
T21,22,Emiliano Grillo,7,142,110,32,2009,total_driving,NA
T21,18,Bubba Watson,4,142,1,141,2009,total_driving,NA
23,T19,Bryson DeChambeau,3,144,13,131,2009,total_driving,NA
24,T52,Matthew Wolff,5,145,40,105,2009,total_driving,NA
25,29,Joel Dahmen,8,149,100,49,2009,total_driving,NA
26,16,Jason Kokrak,5,153,8,145,2009,total_driving,NA
27,17,Josh Teater,6,156,83,73,2009,total_driving,NA
28,T23,Cameron Champ,7,157,2,155,2009,total_driving,NA
29,33,Ryan Palmer,5,160,146,14,2009,total_driving,NA
30,T35,Adam Hadwin,5,164,121,43,2009,total_driving,NA
31,26,Sungjae Im,8,165,50,115,2009,total_driving,NA
32,31,Henrik Norlander,10,168,132,36,2009,total_driving,NA
T33,38,Boo Weekley,5,169,147,22,2009,total_driving,NA
T33,T35,Harold Varner III,7,169,18,151,2009,total_driving,NA
35,37,Lanto Griffin,10,170,40,130,2009,total_driving,NA
36,T19,Lucas Glover,7,174,98,76,2009,total_driving,NA
37,34,Scott Brown,9,175,151,24,2009,total_driving,NA
38,T44,Sebastián Muñoz,10,176,60,116,2009,total_driving,NA
T39,40,Daniel Berger,6,177,56,121,2009,total_driving,NA
T39,42,Keegan Bradley,7,177,71,106,2009,total_driving,NA
41,39,Chesson Hadley,7,179,106,73,2009,total_driving,NA
42,43,Webb Simpson,3,182,170,12,2009,total_driving,NA
43,48,Danny Lee,7,185,9,176,2009,total_driving,NA
44,T50,Pat Perez,6,186,130,56,2009,total_driving,NA
45,T52,Matthew NeSmith,9,188,154,34,2009,total_driving,NA
46,T99,Sepp Straka,10,191,92,99,2009,total_driving,NA
T47,T90,Isaiah Salinda,3,192,14,178,2009,total_driving,NA
T47,T56,John Merrick,4,192,135,57,2009,total_driving,NA
T49,T50,Jim Furyk,3,193,192,1,2009,total_driving,NA
T49,55,Chad Campbell,4,193,178,15,2009,total_driving,NA
T49,T44,Wyndham Clark,7,193,32,161,2009,total_driving,NA
52,32,Alex Noren,4,195,108,87,2009,total_driving,NA
53,NA,Rickie Fowler,2,196,194,2,2009,total_driving,NA
T54,T56,Tony Finau,5,198,12,186,2009,total_driving,NA
T54,T62,Phil Mickelson,5,198,31,167,2009,total_driving,NA
T54,T62,Aaron Wise,7,198,51,147,2009,total_driving,NA
T54,T69,Chase Seiffert,9,198,127,71,2009,total_driving,NA
T58,T73,Abraham Ancer,8,199,113,86,2009,total_driving,NA
T58,61,Adam Schenk,10,199,33,166,2009,total_driving,NA
T58,T64,Scott Harrington,9,199,34,165,2009,total_driving,NA
T61,T52,Brian Harman,8,200,143,57,2009,total_driving,NA
T61,47,Jason Dufner,7,200,140,60,2009,total_driving,NA
T61,59,Cameron Smith,6,200,77,123,2009,total_driving,NA
T64,46,Kramer Hickok,9,201,124,77,2009,total_driving,NA
T64,60,Matt Jones,8,201,49,152,2009,total_driving,NA
66,30,Robby Shelton,10,202,88,114,2009,total_driving,NA
T67,83,Grayson Murray,6,203,4,199,2009,total_driving,NA
T67,T73,Russell Knox,8,203,138,65,2009,total_driving,NA
69,41,Denny McCarthy,8,204,101,103,2009,total_driving,NA
70,T80,Sam Ryder,10,209,53,156,2009,total_driving,NA
71,58,Brice Garnett,8,214,150,64,2009,total_driving,NA
72,66,Michael Thompson,7,215,175,40,2009,total_driving,NA
73,76,Collin Morikawa,6,216,168,48,2009,total_driving,NA
T74,T69,Derek Ernst,4,217,80,137,2009,total_driving,NA
T74,T67,Adam Long,10,217,189,28,2009,total_driving,NA
T74,96,Andrew Landry,9,217,171,46,2009,total_driving,NA
77,T84,Akshay Bhatia,5,218,7,211,2009,total_driving,NA
78,T69,Rod Pampling,3,220,28,192,2009,total_driving,NA
79,136,Nick Watney,7,222,73,149,2009,total_driving,NA
T80,T84,Hideki Matsuyama,6,223,115,108,2009,total_driving,NA
T80,115,Doug Ghim,7,223,116,107,2009,total_driving,NA
T80,T90,Kristoffer Ventura,9,223,44,179,2009,total_driving,NA
T83,T73,Byeong Hun An,8,225,10,215,2009,total_driving,NA
T83,T90,Chandler Phillips,2,225,57,168,2009,total_driving,NA
T83,T69,Brian Stuard,10,225,215,10,2009,total_driving,NA
T83,T97,Alex Cejka,5,225,175,50,2009,total_driving,NA
T83,T80,Ryan Armour,9,225,217,8,2009,total_driving,NA
T88,T90,Graham DeLaet,5,226,36,190,2009,total_driving,NA
T88,T77,Tim Wilkinson,6,226,189,37,2009,total_driving,NA
T88,T86,Brandon Wu,2,226,188,38,2009,total_driving,NA
T91,T88,Hank Lebioda,9,228,104,124,2009,total_driving,NA
T91,79,Charles Howell III,9,228,69,159,2009,total_driving,NA
93,T67,Tyler McCumber,9,229,11,218,2009,total_driving,NA
94,T90,Fabián Gómez,9,230,167,63,2009,total_driving,NA
95,T90,Brendon Todd,11,231,228,3,2009,total_driving,NA
T96,49,Cameron Percy,8,233,61,172,2009,total_driving,NA
T96,T99,Adam Scott,4,233,46,187,2009,total_driving,NA
T96,T80,Luke List,9,233,80,153,2009,total_driving,NA
T96,T86,Russell Henley,8,233,179,54,2009,total_driving,NA
T96,T130,Mackenzie Hughes,8,233,101,132,2009,total_driving,NA
101,T109,J.T. Poston,9,234,175,59,2009,total_driving,NA
102,T64,Vince Covello,8,235,73,162,2009,total_driving,NA
103,T99,Xinjun Zhang,10,236,116,120,2009,total_driving,NA
104,105,K.J. Choi,3,237,233,4,2009,total_driving,NA
T105,107,Tim Herron,4,238,220,18,2009,total_driving,NA
T105,T109,Corey Conners,7,238,186,52,2009,total_driving,NA
T107,108,Keith Mitchell,7,239,135,104,2009,total_driving,NA
T107,T130,Cameron Davis,8,239,22,217,2009,total_driving,NA
T107,T99,Richy Werenski,4,239,45,194,2009,total_driving,NA
T107,T88,Vaughn Taylor,8,239,212,27,2009,total_driving,NA
111,168,Chris Baker,9,240,168,72,2009,total_driving,NA
T112,T112,Jim Herman,8,241,221,20,2009,total_driving,NA
T112,T127,Scott Piercy,8,241,105,136,2009,total_driving,NA
T114,T120,J.J. Henry,5,242,173,69,2009,total_driving,NA
T114,T103,Tyler Duncan,10,242,221,21,2009,total_driving,NA
116,T112,Davis Riley,2,243,83,160,2009,total_driving,NA
T117,T125,Bo Hoag,10,244,127,117,2009,total_driving,NA
T117,T116,Chez Reavie,9,244,228,16,2009,total_driving,NA
119,T116,Matt Kuchar,4,245,238,7,2009,total_driving,NA
T120,223,Paul Casey,4,247,160,87,2009,total_driving,NA
T120,T116,Satoshi Kodaira,6,247,234,13,2009,total_driving,NA
T120,T127,Shawn Stefani,6,247,73,174,2009,total_driving,NA
123,106,Carlos Ortiz,8,248,67,181,2009,total_driving,NA
124,T122,Ben Crane,6,249,207,42,2009,total_driving,NA
125,T130,Tom Lewis,3,252,5,247,2009,total_driving,NA
126,T139,Michael Gligic,9,253,73,180,2009,total_driving,NA
T127,T139,Scott Stallings,8,254,47,207,2009,total_driving,NA
T127,T137,Kyle Stanley,8,254,213,41,2009,total_driving,NA
T129,T137,Henrik Stenson,2,255,202,53,2009,total_driving,NA
T129,T125,Austin Cook,8,255,127,128,2009,total_driving,NA
T131,T120,Beau Hossler,8,256,29,227,2009,total_driving,NA
T131,T122,Patrick Rodgers,10,256,26,230,2009,total_driving,NA
T131,T143,Sebastian Cappelen,8,256,30,226,2009,total_driving,NA
T131,T133,Kurt Kitayama,2,256,3,253,2009,total_driving,NA
T131,T77,Vincent Whaley,7,256,103,153,2009,total_driving,NA
T131,T141,Ryan Brehm,10,256,6,250,2009,total_driving,NA
137,T122,Mark Hubbard,10,257,149,108,2009,total_driving,NA
T138,T163,Brandon Hagy,8,258,22,236,2009,total_driving,NA
T138,T109,Billy Horschel,6,258,196,62,2009,total_driving,NA
T140,T147,Sam Burns,6,259,20,239,2009,total_driving,NA
T140,T133,David Lingmerth,5,259,230,29,2009,total_driving,NA
T142,T187,Bud Cauley,6,262,125,137,2009,total_driving,NA
T142,T143,Cameron Tringale,7,262,55,207,2009,total_driving,NA
144,T143,Rikuya Hoshino,2,264,138,126,2009,total_driving,NA
145,T155,Jonathan Byrd,5,265,72,193,2009,total_driving,NA
T146,T116,Maverick McNealy,9,266,89,177,2009,total_driving,NA
T146,T147,Xander Schauffele,3,266,231,35,2009,total_driving,NA
T148,154,Whee Kim,2,267,180,87,2009,total_driving,NA
T148,T141,Lucas Bjerregaard,3,267,18,249,2009,total_driving,NA
150,T152,Chip McDaniel,2,268,59,209,2009,total_driving,NA
T151,T178,Max Homa,6,269,187,82,2009,total_driving,NA
T151,T112,Bill Haas,6,269,147,122,2009,total_driving,NA
T151,146,J.B. Holmes,3,269,224,45,2009,total_driving,NA
T154,129,Zack Sucher,6,270,24,246,2009,total_driving,NA
T154,T157,Roberto Castro,5,270,183,87,2009,total_driving,NA
156,151,Kevin Tway,6,271,27,244,2009,total_driving,NA
T157,T155,Kevin Chappell,6,272,43,229,2009,total_driving,NA
T157,T152,Dominic Bozzelli,7,272,38,234,2009,total_driving,NA
T159,T147,David Hearn,9,273,206,67,2009,total_driving,NA
T159,174,Jimmy Walker,4,273,92,181,2009,total_driving,NA
161,165,Sangmoon Bae,6,274,64,210,2009,total_driving,NA
162,167,Michael Gellerman,8,275,135,140,2009,total_driving,NA
163,T159,Kevin Kisner,7,277,227,50,2009,total_driving,NA
T164,T159,Justin Thomas,5,278,161,117,2009,total_driving,NA
T164,T187,Troy Merritt,7,278,182,96,2009,total_driving,NA
T164,T163,Freddie Jacobson,3,278,141,137,2009,total_driving,NA
167,T175,Talor Gooch,8,280,122,158,2009,total_driving,NA
168,T103,Andrew Putnam,6,283,181,102,2009,total_driving,NA
T169,T157,Si Woo Kim,8,284,99,185,2009,total_driving,NA
T169,T97,Charley Hoffman,7,284,87,197,2009,total_driving,NA
T169,169,Seamus Power,5,284,83,201,2009,total_driving,NA
172,T133,John Huh,5,285,166,119,2009,total_driving,NA
T173,T172,Jason Day,3,286,80,206,2009,total_driving,NA
T173,T172,Chris Kirk,3,286,199,87,2009,total_driving,NA
T173,T175,Rafael Campos,9,286,67,219,2009,total_driving,NA
176,T159,Nate Lashley,8,287,204,83,2009,total_driving,NA
177,177,Brandt Snedeker,4,288,155,133,2009,total_driving,NA
178,T178,Peter Uihlein,6,289,38,251,2009,total_driving,NA
179,150,Kevin Na,7,290,203,87,2009,total_driving,NA
180,T170,Ben Taylor,10,291,134,157,2009,total_driving,NA
181,162,Anirban Lahiri,8,292,118,174,2009,total_driving,NA
182,T208,Roger Sloan,8,293,158,135,2009,total_driving,NA
T183,182,Johnson Wagner,5,294,207,87,2009,total_driving,NA
T183,T183,Robert Garrigus,5,294,52,242,2009,total_driving,NA
T183,T187,Wes Roach,7,294,151,143,2009,total_driving,NA
186,181,Zach Johnson,7,299,216,83,2009,total_driving,NA
187,191,Mikumu Horikawa,3,303,237,66,2009,total_driving,NA
T188,194,Will Gordon,4,304,64,240,2009,total_driving,NA
T188,210,Rory Sabbatini,7,304,219,85,2009,total_driving,NA
T188,T183,Dylan Frittelli,9,304,193,111,2009,total_driving,NA
191,185,Nelson Ledesma,10,305,57,248,2009,total_driving,NA
192,192,Marc Leishman,5,306,90,216,2009,total_driving,NA
193,166,Joseph Bramlett,7,307,94,213,2009,total_driving,NA
194,195,Joaquin Niemann,8,308,164,144,2009,total_driving,NA
T195,T196,Graeme McDowell,5,311,236,75,2009,total_driving,NA
T195,T201,Bronson Burgoon,8,311,130,181,2009,total_driving,NA
197,T187,Brian Gay,9,312,162,150,2009,total_driving,NA
198,193,Rhein Gibson,9,313,90,223,2009,total_driving,NA
199,T196,Tom Hoge,8,314,185,129,2009,total_driving,NA
200,200,Mark Anderson,7,319,132,187,2009,total_driving,NA
201,204,Smylie Kaufman,3,320,64,256,2009,total_driving,NA
T202,199,Zac Blair,10,322,225,97,2009,total_driving,NA
T202,214,Francesco Molinari,3,322,125,197,2009,total_driving,NA
T204,T170,John Senden,5,324,120,204,2009,total_driving,NA
T204,180,Ben Martin,6,324,223,101,2009,total_driving,NA
T206,T205,James Hahn,6,325,163,162,2009,total_driving,NA
T206,186,Aaron Baddeley,6,325,198,127,2009,total_driving,NA
208,T211,J.J. Spaun,9,330,118,212,2009,total_driving,NA
T209,203,Robert Streb,9,332,141,191,2009,total_driving,NA
T209,T208,Robert Allenby,3,332,164,168,2009,total_driving,NA
211,T211,Martin Trainer,8,339,94,245,2009,total_driving,NA
212,T205,"Ted Potter, Jr.",7,340,151,189,2009,total_driving,NA
213,T201,Chris Stroud,6,341,194,147,2009,total_driving,NA
T214,T205,Rob Oppenheim,10,342,200,142,2009,total_driving,NA
T214,198,Matt Every,7,342,122,220,2009,total_driving,NA
T214,213,Morgan Hoffmann,4,342,143,199,2009,total_driving,NA
217,215,Roberto Díaz,2,345,110,235,2009,total_driving,NA
218,216,Stewart Cink,4,350,112,238,2009,total_driving,NA
219,217,C.T. Pan,5,353,189,164,2009,total_driving,NA
220,T218,Patton Kizzire,9,354,158,196,2009,total_driving,NA
221,222,Hudson Swafford,4,356,183,173,2009,total_driving,NA
222,T218,George McNeill,6,359,145,214,2009,total_driving,NA
223,220,Patrick Reed,4,363,239,124,2009,total_driving,NA
224,221,Jamie Lovemark,4,365,114,251,2009,total_driving,NA
225,224,Luke Donald,2,378,232,146,2009,total_driving,NA
226,226,Bo Van Pelt,7,387,155,232,2009,total_driving,NA
227,225,Davis Love III,3,400,172,228,2009,total_driving,NA
228,228,Arjun Atwal,5,404,173,231,2009,total_driving,NA
T229,231,Daniel Chopra,3,411,157,254,2009,total_driving,NA
T229,227,Kevin Stadler,6,411,217,194,2009,total_driving,NA
231,229,John Rollins,4,414,209,205,2009,total_driving,NA
232,230,Parker McLachlin,4,421,201,220,2009,total_driving,NA
233,232,Peter Malnati,9,422,197,225,2009,total_driving,NA
234,233,Michael Kim,8,435,211,224,2009,total_driving,NA
235,235,Tommy Gainey,4,442,209,233,2009,total_driving,NA
236,234,D.A. Points,4,446,226,220,2009,total_driving,NA
237,236,Ricky Barnes,6,451,214,237,2009,total_driving,NA
238,237,Brendon de Jonge,3,462,205,257,2009,total_driving,NA
239,238,Shugo Imahira,2,490,235,255,2009,total_driving,NA
1,1,Andrew Novak,2,35,17,18,2010,total_driving,NA
2,3,Viktor Hovland,4,63,16,47,2010,total_driving,NA
3,4,Chase Koepka,2,72,34,38,2010,total_driving,NA
4,5,John Oda,2,74,70,4,2010,total_driving,NA
5,6,D.J. Trahan,7,91,47,44,2010,total_driving,NA
6,8,Gary Woodland,4,98,94,4,2010,total_driving,NA
7,9,Branden Grace,4,99,21,78,2010,total_driving,NA
T8,10,Patrick Cantlay,3,103,86,17,2010,total_driving,NA
T8,7,Doc Redman,10,103,77,26,2010,total_driving,NA
10,2,Ryan Moore,5,105,94,11,2010,total_driving,NA
11,13,Scottie Scheffler,8,126,15,111,2010,total_driving,NA
12,T19,Kyoung-Hoon Lee,10,128,106,22,2010,total_driving,NA
13,14,Martin Laird,8,129,42,87,2010,total_driving,NA
14,11,Kevin Streelman,9,130,62,68,2010,total_driving,NA
15,25,Jhonattan Vegas,6,132,24,108,2010,total_driving,NA
T16,15,Nick Taylor,8,133,109,24,2010,total_driving,NA
T16,T23,Brendan Steele,8,133,63,70,2010,total_driving,NA
18,12,Harris English,7,135,36,99,2010,total_driving,NA
T19,T27,Harry Higgs,10,140,79,61,2010,total_driving,NA
T19,T27,Sung Kang,7,140,53,87,2010,total_driving,NA
T21,22,Emiliano Grillo,7,142,110,32,2010,total_driving,NA
T21,18,Bubba Watson,4,142,1,141,2010,total_driving,NA
23,T19,Bryson DeChambeau,3,144,13,131,2010,total_driving,NA
24,T52,Matthew Wolff,5,145,40,105,2010,total_driving,NA
25,29,Joel Dahmen,8,149,100,49,2010,total_driving,NA
26,16,Jason Kokrak,5,153,8,145,2010,total_driving,NA
27,17,Josh Teater,6,156,83,73,2010,total_driving,NA
28,T23,Cameron Champ,7,157,2,155,2010,total_driving,NA
29,33,Ryan Palmer,5,160,146,14,2010,total_driving,NA
30,T35,Adam Hadwin,5,164,121,43,2010,total_driving,NA
31,26,Sungjae Im,8,165,50,115,2010,total_driving,NA
32,31,Henrik Norlander,10,168,132,36,2010,total_driving,NA
T33,38,Boo Weekley,5,169,147,22,2010,total_driving,NA
T33,T35,Harold Varner III,7,169,18,151,2010,total_driving,NA
35,37,Lanto Griffin,10,170,40,130,2010,total_driving,NA
36,T19,Lucas Glover,7,174,98,76,2010,total_driving,NA
37,34,Scott Brown,9,175,151,24,2010,total_driving,NA
38,T44,Sebastián Muñoz,10,176,60,116,2010,total_driving,NA
T39,40,Daniel Berger,6,177,56,121,2010,total_driving,NA
T39,42,Keegan Bradley,7,177,71,106,2010,total_driving,NA
41,39,Chesson Hadley,7,179,106,73,2010,total_driving,NA
42,43,Webb Simpson,3,182,170,12,2010,total_driving,NA
43,48,Danny Lee,7,185,9,176,2010,total_driving,NA
44,T50,Pat Perez,6,186,130,56,2010,total_driving,NA
45,T52,Matthew NeSmith,9,188,154,34,2010,total_driving,NA
46,T99,Sepp Straka,10,191,92,99,2010,total_driving,NA
T47,T90,Isaiah Salinda,3,192,14,178,2010,total_driving,NA
T47,T56,John Merrick,4,192,135,57,2010,total_driving,NA
T49,T50,Jim Furyk,3,193,192,1,2010,total_driving,NA
T49,55,Chad Campbell,4,193,178,15,2010,total_driving,NA
T49,T44,Wyndham Clark,7,193,32,161,2010,total_driving,NA
52,32,Alex Noren,4,195,108,87,2010,total_driving,NA
53,NA,Rickie Fowler,2,196,194,2,2010,total_driving,NA
T54,T56,Tony Finau,5,198,12,186,2010,total_driving,NA
T54,T62,Phil Mickelson,5,198,31,167,2010,total_driving,NA
T54,T62,Aaron Wise,7,198,51,147,2010,total_driving,NA
T54,T69,Chase Seiffert,9,198,127,71,2010,total_driving,NA
T58,T73,Abraham Ancer,8,199,113,86,2010,total_driving,NA
T58,61,Adam Schenk,10,199,33,166,2010,total_driving,NA
T58,T64,Scott Harrington,9,199,34,165,2010,total_driving,NA
T61,T52,Brian Harman,8,200,143,57,2010,total_driving,NA
T61,47,Jason Dufner,7,200,140,60,2010,total_driving,NA
T61,59,Cameron Smith,6,200,77,123,2010,total_driving,NA
T64,46,Kramer Hickok,9,201,124,77,2010,total_driving,NA
T64,60,Matt Jones,8,201,49,152,2010,total_driving,NA
66,30,Robby Shelton,10,202,88,114,2010,total_driving,NA
T67,83,Grayson Murray,6,203,4,199,2010,total_driving,NA
T67,T73,Russell Knox,8,203,138,65,2010,total_driving,NA
69,41,Denny McCarthy,8,204,101,103,2010,total_driving,NA
70,T80,Sam Ryder,10,209,53,156,2010,total_driving,NA
71,58,Brice Garnett,8,214,150,64,2010,total_driving,NA
72,66,Michael Thompson,7,215,175,40,2010,total_driving,NA
73,76,Collin Morikawa,6,216,168,48,2010,total_driving,NA
T74,T69,Derek Ernst,4,217,80,137,2010,total_driving,NA
T74,T67,Adam Long,10,217,189,28,2010,total_driving,NA
T74,96,Andrew Landry,9,217,171,46,2010,total_driving,NA
77,T84,Akshay Bhatia,5,218,7,211,2010,total_driving,NA
78,T69,Rod Pampling,3,220,28,192,2010,total_driving,NA
79,136,Nick Watney,7,222,73,149,2010,total_driving,NA
T80,T84,Hideki Matsuyama,6,223,115,108,2010,total_driving,NA
T80,115,Doug Ghim,7,223,116,107,2010,total_driving,NA
T80,T90,Kristoffer Ventura,9,223,44,179,2010,total_driving,NA
T83,T73,Byeong Hun An,8,225,10,215,2010,total_driving,NA
T83,T90,Chandler Phillips,2,225,57,168,2010,total_driving,NA
T83,T69,Brian Stuard,10,225,215,10,2010,total_driving,NA
T83,T97,Alex Cejka,5,225,175,50,2010,total_driving,NA
T83,T80,Ryan Armour,9,225,217,8,2010,total_driving,NA
T88,T90,Graham DeLaet,5,226,36,190,2010,total_driving,NA
T88,T77,Tim Wilkinson,6,226,189,37,2010,total_driving,NA
T88,T86,Brandon Wu,2,226,188,38,2010,total_driving,NA
T91,T88,Hank Lebioda,9,228,104,124,2010,total_driving,NA
T91,79,Charles Howell III,9,228,69,159,2010,total_driving,NA
93,T67,Tyler McCumber,9,229,11,218,2010,total_driving,NA
94,T90,Fabián Gómez,9,230,167,63,2010,total_driving,NA
95,T90,Brendon Todd,11,231,228,3,2010,total_driving,NA
T96,49,Cameron Percy,8,233,61,172,2010,total_driving,NA
T96,T99,Adam Scott,4,233,46,187,2010,total_driving,NA
T96,T80,Luke List,9,233,80,153,2010,total_driving,NA
T96,T86,Russell Henley,8,233,179,54,2010,total_driving,NA
T96,T130,Mackenzie Hughes,8,233,101,132,2010,total_driving,NA
101,T109,J.T. Poston,9,234,175,59,2010,total_driving,NA
102,T64,Vince Covello,8,235,73,162,2010,total_driving,NA
103,T99,Xinjun Zhang,10,236,116,120,2010,total_driving,NA
104,105,K.J. Choi,3,237,233,4,2010,total_driving,NA
T105,107,Tim Herron,4,238,220,18,2010,total_driving,NA
T105,T109,Corey Conners,7,238,186,52,2010,total_driving,NA
T107,108,Keith Mitchell,7,239,135,104,2010,total_driving,NA
T107,T130,Cameron Davis,8,239,22,217,2010,total_driving,NA
T107,T99,Richy Werenski,4,239,45,194,2010,total_driving,NA
T107,T88,Vaughn Taylor,8,239,212,27,2010,total_driving,NA
111,168,Chris Baker,9,240,168,72,2010,total_driving,NA
T112,T112,Jim Herman,8,241,221,20,2010,total_driving,NA
T112,T127,Scott Piercy,8,241,105,136,2010,total_driving,NA
T114,T120,J.J. Henry,5,242,173,69,2010,total_driving,NA
T114,T103,Tyler Duncan,10,242,221,21,2010,total_driving,NA
116,T112,Davis Riley,2,243,83,160,2010,total_driving,NA
T117,T125,Bo Hoag,10,244,127,117,2010,total_driving,NA
T117,T116,Chez Reavie,9,244,228,16,2010,total_driving,NA
119,T116,Matt Kuchar,4,245,238,7,2010,total_driving,NA
T120,223,Paul Casey,4,247,160,87,2010,total_driving,NA
T120,T116,Satoshi Kodaira,6,247,234,13,2010,total_driving,NA
T120,T127,Shawn Stefani,6,247,73,174,2010,total_driving,NA
123,106,Carlos Ortiz,8,248,67,181,2010,total_driving,NA
124,T122,Ben Crane,6,249,207,42,2010,total_driving,NA
125,T130,Tom Lewis,3,252,5,247,2010,total_driving,NA
126,T139,Michael Gligic,9,253,73,180,2010,total_driving,NA
T127,T139,Scott Stallings,8,254,47,207,2010,total_driving,NA
T127,T137,Kyle Stanley,8,254,213,41,2010,total_driving,NA
T129,T137,Henrik Stenson,2,255,202,53,2010,total_driving,NA
T129,T125,Austin Cook,8,255,127,128,2010,total_driving,NA
T131,T120,Beau Hossler,8,256,29,227,2010,total_driving,NA
T131,T122,Patrick Rodgers,10,256,26,230,2010,total_driving,NA
T131,T143,Sebastian Cappelen,8,256,30,226,2010,total_driving,NA
T131,T133,Kurt Kitayama,2,256,3,253,2010,total_driving,NA
T131,T77,Vincent Whaley,7,256,103,153,2010,total_driving,NA
T131,T141,Ryan Brehm,10,256,6,250,2010,total_driving,NA
137,T122,Mark Hubbard,10,257,149,108,2010,total_driving,NA
T138,T163,Brandon Hagy,8,258,22,236,2010,total_driving,NA
T138,T109,Billy Horschel,6,258,196,62,2010,total_driving,NA
T140,T147,Sam Burns,6,259,20,239,2010,total_driving,NA
T140,T133,David Lingmerth,5,259,230,29,2010,total_driving,NA
T142,T187,Bud Cauley,6,262,125,137,2010,total_driving,NA
T142,T143,Cameron Tringale,7,262,55,207,2010,total_driving,NA
144,T143,Rikuya Hoshino,2,264,138,126,2010,total_driving,NA
145,T155,Jonathan Byrd,5,265,72,193,2010,total_driving,NA
T146,T116,Maverick McNealy,9,266,89,177,2010,total_driving,NA
T146,T147,Xander Schauffele,3,266,231,35,2010,total_driving,NA
T148,154,Whee Kim,2,267,180,87,2010,total_driving,NA
T148,T141,Lucas Bjerregaard,3,267,18,249,2010,total_driving,NA
150,T152,Chip McDaniel,2,268,59,209,2010,total_driving,NA
T151,T178,Max Homa,6,269,187,82,2010,total_driving,NA
T151,T112,Bill Haas,6,269,147,122,2010,total_driving,NA
T151,146,J.B. Holmes,3,269,224,45,2010,total_driving,NA
T154,129,Zack Sucher,6,270,24,246,2010,total_driving,NA
T154,T157,Roberto Castro,5,270,183,87,2010,total_driving,NA
156,151,Kevin Tway,6,271,27,244,2010,total_driving,NA
T157,T155,Kevin Chappell,6,272,43,229,2010,total_driving,NA
T157,T152,Dominic Bozzelli,7,272,38,234,2010,total_driving,NA
T159,T147,David Hearn,9,273,206,67,2010,total_driving,NA
T159,174,Jimmy Walker,4,273,92,181,2010,total_driving,NA
161,165,Sangmoon Bae,6,274,64,210,2010,total_driving,NA
162,167,Michael Gellerman,8,275,135,140,2010,total_driving,NA
163,T159,Kevin Kisner,7,277,227,50,2010,total_driving,NA
T164,T159,Justin Thomas,5,278,161,117,2010,total_driving,NA
T164,T187,Troy Merritt,7,278,182,96,2010,total_driving,NA
T164,T163,Freddie Jacobson,3,278,141,137,2010,total_driving,NA
167,T175,Talor Gooch,8,280,122,158,2010,total_driving,NA
168,T103,Andrew Putnam,6,283,181,102,2010,total_driving,NA
T169,T157,Si Woo Kim,8,284,99,185,2010,total_driving,NA
T169,T97,Charley Hoffman,7,284,87,197,2010,total_driving,NA
T169,169,Seamus Power,5,284,83,201,2010,total_driving,NA
172,T133,John Huh,5,285,166,119,2010,total_driving,NA
T173,T172,Jason Day,3,286,80,206,2010,total_driving,NA
T173,T172,Chris Kirk,3,286,199,87,2010,total_driving,NA
T173,T175,Rafael Campos,9,286,67,219,2010,total_driving,NA
176,T159,Nate Lashley,8,287,204,83,2010,total_driving,NA
177,177,Brandt Snedeker,4,288,155,133,2010,total_driving,NA
178,T178,Peter Uihlein,6,289,38,251,2010,total_driving,NA
179,150,Kevin Na,7,290,203,87,2010,total_driving,NA
180,T170,Ben Taylor,10,291,134,157,2010,total_driving,NA
181,162,Anirban Lahiri,8,292,118,174,2010,total_driving,NA
182,T208,Roger Sloan,8,293,158,135,2010,total_driving,NA
T183,182,Johnson Wagner,5,294,207,87,2010,total_driving,NA
T183,T183,Robert Garrigus,5,294,52,242,2010,total_driving,NA
T183,T187,Wes Roach,7,294,151,143,2010,total_driving,NA
186,181,Zach Johnson,7,299,216,83,2010,total_driving,NA
187,191,Mikumu Horikawa,3,303,237,66,2010,total_driving,NA
T188,194,Will Gordon,4,304,64,240,2010,total_driving,NA
T188,210,Rory Sabbatini,7,304,219,85,2010,total_driving,NA
T188,T183,Dylan Frittelli,9,304,193,111,2010,total_driving,NA
191,185,Nelson Ledesma,10,305,57,248,2010,total_driving,NA
192,192,Marc Leishman,5,306,90,216,2010,total_driving,NA
193,166,Joseph Bramlett,7,307,94,213,2010,total_driving,NA
194,195,Joaquin Niemann,8,308,164,144,2010,total_driving,NA
T195,T196,Graeme McDowell,5,311,236,75,2010,total_driving,NA
T195,T201,Bronson Burgoon,8,311,130,181,2010,total_driving,NA
197,T187,Brian Gay,9,312,162,150,2010,total_driving,NA
198,193,Rhein Gibson,9,313,90,223,2010,total_driving,NA
199,T196,Tom Hoge,8,314,185,129,2010,total_driving,NA
200,200,Mark Anderson,7,319,132,187,2010,total_driving,NA
201,204,Smylie Kaufman,3,320,64,256,2010,total_driving,NA
T202,199,Zac Blair,10,322,225,97,2010,total_driving,NA
T202,214,Francesco Molinari,3,322,125,197,2010,total_driving,NA
T204,T170,John Senden,5,324,120,204,2010,total_driving,NA
T204,180,Ben Martin,6,324,223,101,2010,total_driving,NA
T206,T205,James Hahn,6,325,163,162,2010,total_driving,NA
T206,186,Aaron Baddeley,6,325,198,127,2010,total_driving,NA
208,T211,J.J. Spaun,9,330,118,212,2010,total_driving,NA
T209,203,Robert Streb,9,332,141,191,2010,total_driving,NA
T209,T208,Robert Allenby,3,332,164,168,2010,total_driving,NA
211,T211,Martin Trainer,8,339,94,245,2010,total_driving,NA
212,T205,"Ted Potter, Jr.",7,340,151,189,2010,total_driving,NA
213,T201,Chris Stroud,6,341,194,147,2010,total_driving,NA
T214,T205,Rob Oppenheim,10,342,200,142,2010,total_driving,NA
T214,198,Matt Every,7,342,122,220,2010,total_driving,NA
T214,213,Morgan Hoffmann,4,342,143,199,2010,total_driving,NA
217,215,Roberto Díaz,2,345,110,235,2010,total_driving,NA
218,216,Stewart Cink,4,350,112,238,2010,total_driving,NA
219,217,C.T. Pan,5,353,189,164,2010,total_driving,NA
220,T218,Patton Kizzire,9,354,158,196,2010,total_driving,NA
221,222,Hudson Swafford,4,356,183,173,2010,total_driving,NA
222,T218,George McNeill,6,359,145,214,2010,total_driving,NA
223,220,Patrick Reed,4,363,239,124,2010,total_driving,NA
224,221,Jamie Lovemark,4,365,114,251,2010,total_driving,NA
225,224,Luke Donald,2,378,232,146,2010,total_driving,NA
226,226,Bo Van Pelt,7,387,155,232,2010,total_driving,NA
227,225,Davis Love III,3,400,172,228,2010,total_driving,NA
228,228,Arjun Atwal,5,404,173,231,2010,total_driving,NA
T229,231,Daniel Chopra,3,411,157,254,2010,total_driving,NA
T229,227,Kevin Stadler,6,411,217,194,2010,total_driving,NA
231,229,John Rollins,4,414,209,205,2010,total_driving,NA
232,230,Parker McLachlin,4,421,201,220,2010,total_driving,NA
233,232,Peter Malnati,9,422,197,225,2010,total_driving,NA
234,233,Michael Kim,8,435,211,224,2010,total_driving,NA
235,235,Tommy Gainey,4,442,209,233,2010,total_driving,NA
236,234,D.A. Points,4,446,226,220,2010,total_driving,NA
237,236,Ricky Barnes,6,451,214,237,2010,total_driving,NA
238,237,Brendon de Jonge,3,462,205,257,2010,total_driving,NA
239,238,Shugo Imahira,2,490,235,255,2010,total_driving,NA
1,1,Andrew Novak,2,35,17,18,2011,total_driving,NA
2,3,Viktor Hovland,4,63,16,47,2011,total_driving,NA
3,4,Chase Koepka,2,72,34,38,2011,total_driving,NA
4,5,John Oda,2,74,70,4,2011,total_driving,NA
5,6,D.J. Trahan,7,91,47,44,2011,total_driving,NA
6,8,Gary Woodland,4,98,94,4,2011,total_driving,NA
7,9,Branden Grace,4,99,21,78,2011,total_driving,NA
T8,10,Patrick Cantlay,3,103,86,17,2011,total_driving,NA
T8,7,Doc Redman,10,103,77,26,2011,total_driving,NA
10,2,Ryan Moore,5,105,94,11,2011,total_driving,NA
11,13,Scottie Scheffler,8,126,15,111,2011,total_driving,NA
12,T19,Kyoung-Hoon Lee,10,128,106,22,2011,total_driving,NA
13,14,Martin Laird,8,129,42,87,2011,total_driving,NA
14,11,Kevin Streelman,9,130,62,68,2011,total_driving,NA
15,25,Jhonattan Vegas,6,132,24,108,2011,total_driving,NA
T16,15,Nick Taylor,8,133,109,24,2011,total_driving,NA
T16,T23,Brendan Steele,8,133,63,70,2011,total_driving,NA
18,12,Harris English,7,135,36,99,2011,total_driving,NA
T19,T27,Harry Higgs,10,140,79,61,2011,total_driving,NA
T19,T27,Sung Kang,7,140,53,87,2011,total_driving,NA
T21,22,Emiliano Grillo,7,142,110,32,2011,total_driving,NA
T21,18,Bubba Watson,4,142,1,141,2011,total_driving,NA
23,T19,Bryson DeChambeau,3,144,13,131,2011,total_driving,NA
24,T52,Matthew Wolff,5,145,40,105,2011,total_driving,NA
25,29,Joel Dahmen,8,149,100,49,2011,total_driving,NA
26,16,Jason Kokrak,5,153,8,145,2011,total_driving,NA
27,17,Josh Teater,6,156,83,73,2011,total_driving,NA
28,T23,Cameron Champ,7,157,2,155,2011,total_driving,NA
29,33,Ryan Palmer,5,160,146,14,2011,total_driving,NA
30,T35,Adam Hadwin,5,164,121,43,2011,total_driving,NA
31,26,Sungjae Im,8,165,50,115,2011,total_driving,NA
32,31,Henrik Norlander,10,168,132,36,2011,total_driving,NA
T33,38,Boo Weekley,5,169,147,22,2011,total_driving,NA
T33,T35,Harold Varner III,7,169,18,151,2011,total_driving,NA
35,37,Lanto Griffin,10,170,40,130,2011,total_driving,NA
36,T19,Lucas Glover,7,174,98,76,2011,total_driving,NA
37,34,Scott Brown,9,175,151,24,2011,total_driving,NA
38,T44,Sebastián Muñoz,10,176,60,116,2011,total_driving,NA
T39,40,Daniel Berger,6,177,56,121,2011,total_driving,NA
T39,42,Keegan Bradley,7,177,71,106,2011,total_driving,NA
41,39,Chesson Hadley,7,179,106,73,2011,total_driving,NA
42,43,Webb Simpson,3,182,170,12,2011,total_driving,NA
43,48,Danny Lee,7,185,9,176,2011,total_driving,NA
44,T50,Pat Perez,6,186,130,56,2011,total_driving,NA
45,T52,Matthew NeSmith,9,188,154,34,2011,total_driving,NA
46,T99,Sepp Straka,10,191,92,99,2011,total_driving,NA
T47,T90,Isaiah Salinda,3,192,14,178,2011,total_driving,NA
T47,T56,John Merrick,4,192,135,57,2011,total_driving,NA
T49,T50,Jim Furyk,3,193,192,1,2011,total_driving,NA
T49,55,Chad Campbell,4,193,178,15,2011,total_driving,NA
T49,T44,Wyndham Clark,7,193,32,161,2011,total_driving,NA
52,32,Alex Noren,4,195,108,87,2011,total_driving,NA
53,NA,Rickie Fowler,2,196,194,2,2011,total_driving,NA
T54,T56,Tony Finau,5,198,12,186,2011,total_driving,NA
T54,T62,Phil Mickelson,5,198,31,167,2011,total_driving,NA
T54,T62,Aaron Wise,7,198,51,147,2011,total_driving,NA
T54,T69,Chase Seiffert,9,198,127,71,2011,total_driving,NA
T58,T73,Abraham Ancer,8,199,113,86,2011,total_driving,NA
T58,61,Adam Schenk,10,199,33,166,2011,total_driving,NA
T58,T64,Scott Harrington,9,199,34,165,2011,total_driving,NA
T61,T52,Brian Harman,8,200,143,57,2011,total_driving,NA
T61,47,Jason Dufner,7,200,140,60,2011,total_driving,NA
T61,59,Cameron Smith,6,200,77,123,2011,total_driving,NA
T64,46,Kramer Hickok,9,201,124,77,2011,total_driving,NA
T64,60,Matt Jones,8,201,49,152,2011,total_driving,NA
66,30,Robby Shelton,10,202,88,114,2011,total_driving,NA
T67,83,Grayson Murray,6,203,4,199,2011,total_driving,NA
T67,T73,Russell Knox,8,203,138,65,2011,total_driving,NA
69,41,Denny McCarthy,8,204,101,103,2011,total_driving,NA
70,T80,Sam Ryder,10,209,53,156,2011,total_driving,NA
71,58,Brice Garnett,8,214,150,64,2011,total_driving,NA
72,66,Michael Thompson,7,215,175,40,2011,total_driving,NA
73,76,Collin Morikawa,6,216,168,48,2011,total_driving,NA
T74,T69,Derek Ernst,4,217,80,137,2011,total_driving,NA
T74,T67,Adam Long,10,217,189,28,2011,total_driving,NA
T74,96,Andrew Landry,9,217,171,46,2011,total_driving,NA
77,T84,Akshay Bhatia,5,218,7,211,2011,total_driving,NA
78,T69,Rod Pampling,3,220,28,192,2011,total_driving,NA
79,136,Nick Watney,7,222,73,149,2011,total_driving,NA
T80,T84,Hideki Matsuyama,6,223,115,108,2011,total_driving,NA
T80,115,Doug Ghim,7,223,116,107,2011,total_driving,NA
T80,T90,Kristoffer Ventura,9,223,44,179,2011,total_driving,NA
T83,T73,Byeong Hun An,8,225,10,215,2011,total_driving,NA
T83,T90,Chandler Phillips,2,225,57,168,2011,total_driving,NA
T83,T69,Brian Stuard,10,225,215,10,2011,total_driving,NA
T83,T97,Alex Cejka,5,225,175,50,2011,total_driving,NA
T83,T80,Ryan Armour,9,225,217,8,2011,total_driving,NA
T88,T90,Graham DeLaet,5,226,36,190,2011,total_driving,NA
T88,T77,Tim Wilkinson,6,226,189,37,2011,total_driving,NA
T88,T86,Brandon Wu,2,226,188,38,2011,total_driving,NA
T91,T88,Hank Lebioda,9,228,104,124,2011,total_driving,NA
T91,79,Charles Howell III,9,228,69,159,2011,total_driving,NA
93,T67,Tyler McCumber,9,229,11,218,2011,total_driving,NA
94,T90,Fabián Gómez,9,230,167,63,2011,total_driving,NA
95,T90,Brendon Todd,11,231,228,3,2011,total_driving,NA
T96,49,Cameron Percy,8,233,61,172,2011,total_driving,NA
T96,T99,Adam Scott,4,233,46,187,2011,total_driving,NA
T96,T80,Luke List,9,233,80,153,2011,total_driving,NA
T96,T86,Russell Henley,8,233,179,54,2011,total_driving,NA
T96,T130,Mackenzie Hughes,8,233,101,132,2011,total_driving,NA
101,T109,J.T. Poston,9,234,175,59,2011,total_driving,NA
102,T64,Vince Covello,8,235,73,162,2011,total_driving,NA
103,T99,Xinjun Zhang,10,236,116,120,2011,total_driving,NA
104,105,K.J. Choi,3,237,233,4,2011,total_driving,NA
T105,107,Tim Herron,4,238,220,18,2011,total_driving,NA
T105,T109,Corey Conners,7,238,186,52,2011,total_driving,NA
T107,108,Keith Mitchell,7,239,135,104,2011,total_driving,NA
T107,T130,Cameron Davis,8,239,22,217,2011,total_driving,NA
T107,T99,Richy Werenski,4,239,45,194,2011,total_driving,NA
T107,T88,Vaughn Taylor,8,239,212,27,2011,total_driving,NA
111,168,Chris Baker,9,240,168,72,2011,total_driving,NA
T112,T112,Jim Herman,8,241,221,20,2011,total_driving,NA
T112,T127,Scott Piercy,8,241,105,136,2011,total_driving,NA
T114,T120,J.J. Henry,5,242,173,69,2011,total_driving,NA
T114,T103,Tyler Duncan,10,242,221,21,2011,total_driving,NA
116,T112,Davis Riley,2,243,83,160,2011,total_driving,NA
T117,T125,Bo Hoag,10,244,127,117,2011,total_driving,NA
T117,T116,Chez Reavie,9,244,228,16,2011,total_driving,NA
119,T116,Matt Kuchar,4,245,238,7,2011,total_driving,NA
T120,223,Paul Casey,4,247,160,87,2011,total_driving,NA
T120,T116,Satoshi Kodaira,6,247,234,13,2011,total_driving,NA
T120,T127,Shawn Stefani,6,247,73,174,2011,total_driving,NA
123,106,Carlos Ortiz,8,248,67,181,2011,total_driving,NA
124,T122,Ben Crane,6,249,207,42,2011,total_driving,NA
125,T130,Tom Lewis,3,252,5,247,2011,total_driving,NA
126,T139,Michael Gligic,9,253,73,180,2011,total_driving,NA
T127,T139,Scott Stallings,8,254,47,207,2011,total_driving,NA
T127,T137,Kyle Stanley,8,254,213,41,2011,total_driving,NA
T129,T137,Henrik Stenson,2,255,202,53,2011,total_driving,NA
T129,T125,Austin Cook,8,255,127,128,2011,total_driving,NA
T131,T120,Beau Hossler,8,256,29,227,2011,total_driving,NA
T131,T122,Patrick Rodgers,10,256,26,230,2011,total_driving,NA
T131,T143,Sebastian Cappelen,8,256,30,226,2011,total_driving,NA
T131,T133,Kurt Kitayama,2,256,3,253,2011,total_driving,NA
T131,T77,Vincent Whaley,7,256,103,153,2011,total_driving,NA
T131,T141,Ryan Brehm,10,256,6,250,2011,total_driving,NA
137,T122,Mark Hubbard,10,257,149,108,2011,total_driving,NA
T138,T163,Brandon Hagy,8,258,22,236,2011,total_driving,NA
T138,T109,Billy Horschel,6,258,196,62,2011,total_driving,NA
T140,T147,Sam Burns,6,259,20,239,2011,total_driving,NA
T140,T133,David Lingmerth,5,259,230,29,2011,total_driving,NA
T142,T187,Bud Cauley,6,262,125,137,2011,total_driving,NA
T142,T143,Cameron Tringale,7,262,55,207,2011,total_driving,NA
144,T143,Rikuya Hoshino,2,264,138,126,2011,total_driving,NA
145,T155,Jonathan Byrd,5,265,72,193,2011,total_driving,NA
T146,T116,Maverick McNealy,9,266,89,177,2011,total_driving,NA
T146,T147,Xander Schauffele,3,266,231,35,2011,total_driving,NA
T148,154,Whee Kim,2,267,180,87,2011,total_driving,NA
T148,T141,Lucas Bjerregaard,3,267,18,249,2011,total_driving,NA
150,T152,Chip McDaniel,2,268,59,209,2011,total_driving,NA
T151,T178,Max Homa,6,269,187,82,2011,total_driving,NA
T151,T112,Bill Haas,6,269,147,122,2011,total_driving,NA
T151,146,J.B. Holmes,3,269,224,45,2011,total_driving,NA
T154,129,Zack Sucher,6,270,24,246,2011,total_driving,NA
T154,T157,Roberto Castro,5,270,183,87,2011,total_driving,NA
156,151,Kevin Tway,6,271,27,244,2011,total_driving,NA
T157,T155,Kevin Chappell,6,272,43,229,2011,total_driving,NA
T157,T152,Dominic Bozzelli,7,272,38,234,2011,total_driving,NA
T159,T147,David Hearn,9,273,206,67,2011,total_driving,NA
T159,174,Jimmy Walker,4,273,92,181,2011,total_driving,NA
161,165,Sangmoon Bae,6,274,64,210,2011,total_driving,NA
162,167,Michael Gellerman,8,275,135,140,2011,total_driving,NA
163,T159,Kevin Kisner,7,277,227,50,2011,total_driving,NA
T164,T159,Justin Thomas,5,278,161,117,2011,total_driving,NA
T164,T187,Troy Merritt,7,278,182,96,2011,total_driving,NA
T164,T163,Freddie Jacobson,3,278,141,137,2011,total_driving,NA
167,T175,Talor Gooch,8,280,122,158,2011,total_driving,NA
168,T103,Andrew Putnam,6,283,181,102,2011,total_driving,NA
T169,T157,Si Woo Kim,8,284,99,185,2011,total_driving,NA
T169,T97,Charley Hoffman,7,284,87,197,2011,total_driving,NA
T169,169,Seamus Power,5,284,83,201,2011,total_driving,NA
172,T133,John Huh,5,285,166,119,2011,total_driving,NA
T173,T172,Jason Day,3,286,80,206,2011,total_driving,NA
T173,T172,Chris Kirk,3,286,199,87,2011,total_driving,NA
T173,T175,Rafael Campos,9,286,67,219,2011,total_driving,NA
176,T159,Nate Lashley,8,287,204,83,2011,total_driving,NA
177,177,Brandt Snedeker,4,288,155,133,2011,total_driving,NA
178,T178,Peter Uihlein,6,289,38,251,2011,total_driving,NA
179,150,Kevin Na,7,290,203,87,2011,total_driving,NA
180,T170,Ben Taylor,10,291,134,157,2011,total_driving,NA
181,162,Anirban Lahiri,8,292,118,174,2011,total_driving,NA
182,T208,Roger Sloan,8,293,158,135,2011,total_driving,NA
T183,182,Johnson Wagner,5,294,207,87,2011,total_driving,NA
T183,T183,Robert Garrigus,5,294,52,242,2011,total_driving,NA
T183,T187,Wes Roach,7,294,151,143,2011,total_driving,NA
186,181,Zach Johnson,7,299,216,83,2011,total_driving,NA
187,191,Mikumu Horikawa,3,303,237,66,2011,total_driving,NA
T188,194,Will Gordon,4,304,64,240,2011,total_driving,NA
T188,210,Rory Sabbatini,7,304,219,85,2011,total_driving,NA
T188,T183,Dylan Frittelli,9,304,193,111,2011,total_driving,NA
191,185,Nelson Ledesma,10,305,57,248,2011,total_driving,NA
192,192,Marc Leishman,5,306,90,216,2011,total_driving,NA
193,166,Joseph Bramlett,7,307,94,213,2011,total_driving,NA
194,195,Joaquin Niemann,8,308,164,144,2011,total_driving,NA
T195,T196,Graeme McDowell,5,311,236,75,2011,total_driving,NA
T195,T201,Bronson Burgoon,8,311,130,181,2011,total_driving,NA
197,T187,Brian Gay,9,312,162,150,2011,total_driving,NA
198,193,Rhein Gibson,9,313,90,223,2011,total_driving,NA
199,T196,Tom Hoge,8,314,185,129,2011,total_driving,NA
200,200,Mark Anderson,7,319,132,187,2011,total_driving,NA
201,204,Smylie Kaufman,3,320,64,256,2011,total_driving,NA
T202,199,Zac Blair,10,322,225,97,2011,total_driving,NA
T202,214,Francesco Molinari,3,322,125,197,2011,total_driving,NA
T204,T170,John Senden,5,324,120,204,2011,total_driving,NA
T204,180,Ben Martin,6,324,223,101,2011,total_driving,NA
T206,T205,James Hahn,6,325,163,162,2011,total_driving,NA
T206,186,Aaron Baddeley,6,325,198,127,2011,total_driving,NA
208,T211,J.J. Spaun,9,330,118,212,2011,total_driving,NA
T209,203,Robert Streb,9,332,141,191,2011,total_driving,NA
T209,T208,Robert Allenby,3,332,164,168,2011,total_driving,NA
211,T211,Martin Trainer,8,339,94,245,2011,total_driving,NA
212,T205,"Ted Potter, Jr.",7,340,151,189,2011,total_driving,NA
213,T201,Chris Stroud,6,341,194,147,2011,total_driving,NA
T214,T205,Rob Oppenheim,10,342,200,142,2011,total_driving,NA
T214,198,Matt Every,7,342,122,220,2011,total_driving,NA
T214,213,Morgan Hoffmann,4,342,143,199,2011,total_driving,NA
217,215,Roberto Díaz,2,345,110,235,2011,total_driving,NA
218,216,Stewart Cink,4,350,112,238,2011,total_driving,NA
219,217,C.T. Pan,5,353,189,164,2011,total_driving,NA
220,T218,Patton Kizzire,9,354,158,196,2011,total_driving,NA
221,222,Hudson Swafford,4,356,183,173,2011,total_driving,NA
222,T218,George McNeill,6,359,145,214,2011,total_driving,NA
223,220,Patrick Reed,4,363,239,124,2011,total_driving,NA
224,221,Jamie Lovemark,4,365,114,251,2011,total_driving,NA
225,224,Luke Donald,2,378,232,146,2011,total_driving,NA
226,226,Bo Van Pelt,7,387,155,232,2011,total_driving,NA
227,225,Davis Love III,3,400,172,228,2011,total_driving,NA
228,228,Arjun Atwal,5,404,173,231,2011,total_driving,NA
T229,231,Daniel Chopra,3,411,157,254,2011,total_driving,NA
T229,227,Kevin Stadler,6,411,217,194,2011,total_driving,NA
231,229,John Rollins,4,414,209,205,2011,total_driving,NA
232,230,Parker McLachlin,4,421,201,220,2011,total_driving,NA
233,232,Peter Malnati,9,422,197,225,2011,total_driving,NA
234,233,Michael Kim,8,435,211,224,2011,total_driving,NA
235,235,Tommy Gainey,4,442,209,233,2011,total_driving,NA
236,234,D.A. Points,4,446,226,220,2011,total_driving,NA
237,236,Ricky Barnes,6,451,214,237,2011,total_driving,NA
238,237,Brendon de Jonge,3,462,205,257,2011,total_driving,NA
239,238,Shugo Imahira,2,490,235,255,2011,total_driving,NA
1,1,Andrew Novak,2,35,17,18,2012,total_driving,NA
2,3,Viktor Hovland,4,63,16,47,2012,total_driving,NA
3,4,Chase Koepka,2,72,34,38,2012,total_driving,NA
4,5,John Oda,2,74,70,4,2012,total_driving,NA
5,6,D.J. Trahan,7,91,47,44,2012,total_driving,NA
6,8,Gary Woodland,4,98,94,4,2012,total_driving,NA
7,9,Branden Grace,4,99,21,78,2012,total_driving,NA
T8,10,Patrick Cantlay,3,103,86,17,2012,total_driving,NA
T8,7,Doc Redman,10,103,77,26,2012,total_driving,NA
10,2,Ryan Moore,5,105,94,11,2012,total_driving,NA
11,13,Scottie Scheffler,8,126,15,111,2012,total_driving,NA
12,T19,Kyoung-Hoon Lee,10,128,106,22,2012,total_driving,NA
13,14,Martin Laird,8,129,42,87,2012,total_driving,NA
14,11,Kevin Streelman,9,130,62,68,2012,total_driving,NA
15,25,Jhonattan Vegas,6,132,24,108,2012,total_driving,NA
T16,15,Nick Taylor,8,133,109,24,2012,total_driving,NA
T16,T23,Brendan Steele,8,133,63,70,2012,total_driving,NA
18,12,Harris English,7,135,36,99,2012,total_driving,NA
T19,T27,Harry Higgs,10,140,79,61,2012,total_driving,NA
T19,T27,Sung Kang,7,140,53,87,2012,total_driving,NA
T21,22,Emiliano Grillo,7,142,110,32,2012,total_driving,NA
T21,18,Bubba Watson,4,142,1,141,2012,total_driving,NA
23,T19,Bryson DeChambeau,3,144,13,131,2012,total_driving,NA
24,T52,Matthew Wolff,5,145,40,105,2012,total_driving,NA
25,29,Joel Dahmen,8,149,100,49,2012,total_driving,NA
26,16,Jason Kokrak,5,153,8,145,2012,total_driving,NA
27,17,Josh Teater,6,156,83,73,2012,total_driving,NA
28,T23,Cameron Champ,7,157,2,155,2012,total_driving,NA
29,33,Ryan Palmer,5,160,146,14,2012,total_driving,NA
30,T35,Adam Hadwin,5,164,121,43,2012,total_driving,NA
31,26,Sungjae Im,8,165,50,115,2012,total_driving,NA
32,31,Henrik Norlander,10,168,132,36,2012,total_driving,NA
T33,38,Boo Weekley,5,169,147,22,2012,total_driving,NA
T33,T35,Harold Varner III,7,169,18,151,2012,total_driving,NA
35,37,Lanto Griffin,10,170,40,130,2012,total_driving,NA
36,T19,Lucas Glover,7,174,98,76,2012,total_driving,NA
37,34,Scott Brown,9,175,151,24,2012,total_driving,NA
38,T44,Sebastián Muñoz,10,176,60,116,2012,total_driving,NA
T39,40,Daniel Berger,6,177,56,121,2012,total_driving,NA
T39,42,Keegan Bradley,7,177,71,106,2012,total_driving,NA
41,39,Chesson Hadley,7,179,106,73,2012,total_driving,NA
42,43,Webb Simpson,3,182,170,12,2012,total_driving,NA
43,48,Danny Lee,7,185,9,176,2012,total_driving,NA
44,T50,Pat Perez,6,186,130,56,2012,total_driving,NA
45,T52,Matthew NeSmith,9,188,154,34,2012,total_driving,NA
46,T99,Sepp Straka,10,191,92,99,2012,total_driving,NA
T47,T90,Isaiah Salinda,3,192,14,178,2012,total_driving,NA
T47,T56,John Merrick,4,192,135,57,2012,total_driving,NA
T49,T50,Jim Furyk,3,193,192,1,2012,total_driving,NA
T49,55,Chad Campbell,4,193,178,15,2012,total_driving,NA
T49,T44,Wyndham Clark,7,193,32,161,2012,total_driving,NA
52,32,Alex Noren,4,195,108,87,2012,total_driving,NA
53,NA,Rickie Fowler,2,196,194,2,2012,total_driving,NA
T54,T56,Tony Finau,5,198,12,186,2012,total_driving,NA
T54,T62,Phil Mickelson,5,198,31,167,2012,total_driving,NA
T54,T62,Aaron Wise,7,198,51,147,2012,total_driving,NA
T54,T69,Chase Seiffert,9,198,127,71,2012,total_driving,NA
T58,T73,Abraham Ancer,8,199,113,86,2012,total_driving,NA
T58,61,Adam Schenk,10,199,33,166,2012,total_driving,NA
T58,T64,Scott Harrington,9,199,34,165,2012,total_driving,NA
T61,T52,Brian Harman,8,200,143,57,2012,total_driving,NA
T61,47,Jason Dufner,7,200,140,60,2012,total_driving,NA
T61,59,Cameron Smith,6,200,77,123,2012,total_driving,NA
T64,46,Kramer Hickok,9,201,124,77,2012,total_driving,NA
T64,60,Matt Jones,8,201,49,152,2012,total_driving,NA
66,30,Robby Shelton,10,202,88,114,2012,total_driving,NA
T67,83,Grayson Murray,6,203,4,199,2012,total_driving,NA
T67,T73,Russell Knox,8,203,138,65,2012,total_driving,NA
69,41,Denny McCarthy,8,204,101,103,2012,total_driving,NA
70,T80,Sam Ryder,10,209,53,156,2012,total_driving,NA
71,58,Brice Garnett,8,214,150,64,2012,total_driving,NA
72,66,Michael Thompson,7,215,175,40,2012,total_driving,NA
73,76,Collin Morikawa,6,216,168,48,2012,total_driving,NA
T74,T69,Derek Ernst,4,217,80,137,2012,total_driving,NA
T74,T67,Adam Long,10,217,189,28,2012,total_driving,NA
T74,96,Andrew Landry,9,217,171,46,2012,total_driving,NA
77,T84,Akshay Bhatia,5,218,7,211,2012,total_driving,NA
78,T69,Rod Pampling,3,220,28,192,2012,total_driving,NA
79,136,Nick Watney,7,222,73,149,2012,total_driving,NA
T80,T84,Hideki Matsuyama,6,223,115,108,2012,total_driving,NA
T80,115,Doug Ghim,7,223,116,107,2012,total_driving,NA
T80,T90,Kristoffer Ventura,9,223,44,179,2012,total_driving,NA
T83,T73,Byeong Hun An,8,225,10,215,2012,total_driving,NA
T83,T90,Chandler Phillips,2,225,57,168,2012,total_driving,NA
T83,T69,Brian Stuard,10,225,215,10,2012,total_driving,NA
T83,T97,Alex Cejka,5,225,175,50,2012,total_driving,NA
T83,T80,Ryan Armour,9,225,217,8,2012,total_driving,NA
T88,T90,Graham DeLaet,5,226,36,190,2012,total_driving,NA
T88,T77,Tim Wilkinson,6,226,189,37,2012,total_driving,NA
T88,T86,Brandon Wu,2,226,188,38,2012,total_driving,NA
T91,T88,Hank Lebioda,9,228,104,124,2012,total_driving,NA
T91,79,Charles Howell III,9,228,69,159,2012,total_driving,NA
93,T67,Tyler McCumber,9,229,11,218,2012,total_driving,NA
94,T90,Fabián Gómez,9,230,167,63,2012,total_driving,NA
95,T90,Brendon Todd,11,231,228,3,2012,total_driving,NA
T96,49,Cameron Percy,8,233,61,172,2012,total_driving,NA
T96,T99,Adam Scott,4,233,46,187,2012,total_driving,NA
T96,T80,Luke List,9,233,80,153,2012,total_driving,NA
T96,T86,Russell Henley,8,233,179,54,2012,total_driving,NA
T96,T130,Mackenzie Hughes,8,233,101,132,2012,total_driving,NA
101,T109,J.T. Poston,9,234,175,59,2012,total_driving,NA
102,T64,Vince Covello,8,235,73,162,2012,total_driving,NA
103,T99,Xinjun Zhang,10,236,116,120,2012,total_driving,NA
104,105,K.J. Choi,3,237,233,4,2012,total_driving,NA
T105,107,Tim Herron,4,238,220,18,2012,total_driving,NA
T105,T109,Corey Conners,7,238,186,52,2012,total_driving,NA
T107,108,Keith Mitchell,7,239,135,104,2012,total_driving,NA
T107,T130,Cameron Davis,8,239,22,217,2012,total_driving,NA
T107,T99,Richy Werenski,4,239,45,194,2012,total_driving,NA
T107,T88,Vaughn Taylor,8,239,212,27,2012,total_driving,NA
111,168,Chris Baker,9,240,168,72,2012,total_driving,NA
T112,T112,Jim Herman,8,241,221,20,2012,total_driving,NA
T112,T127,Scott Piercy,8,241,105,136,2012,total_driving,NA
T114,T120,J.J. Henry,5,242,173,69,2012,total_driving,NA
T114,T103,Tyler Duncan,10,242,221,21,2012,total_driving,NA
116,T112,Davis Riley,2,243,83,160,2012,total_driving,NA
T117,T125,Bo Hoag,10,244,127,117,2012,total_driving,NA
T117,T116,Chez Reavie,9,244,228,16,2012,total_driving,NA
119,T116,Matt Kuchar,4,245,238,7,2012,total_driving,NA
T120,223,Paul Casey,4,247,160,87,2012,total_driving,NA
T120,T116,Satoshi Kodaira,6,247,234,13,2012,total_driving,NA
T120,T127,Shawn Stefani,6,247,73,174,2012,total_driving,NA
123,106,Carlos Ortiz,8,248,67,181,2012,total_driving,NA
124,T122,Ben Crane,6,249,207,42,2012,total_driving,NA
125,T130,Tom Lewis,3,252,5,247,2012,total_driving,NA
126,T139,Michael Gligic,9,253,73,180,2012,total_driving,NA
T127,T139,Scott Stallings,8,254,47,207,2012,total_driving,NA
T127,T137,Kyle Stanley,8,254,213,41,2012,total_driving,NA
T129,T137,Henrik Stenson,2,255,202,53,2012,total_driving,NA
T129,T125,Austin Cook,8,255,127,128,2012,total_driving,NA
T131,T120,Beau Hossler,8,256,29,227,2012,total_driving,NA
T131,T122,Patrick Rodgers,10,256,26,230,2012,total_driving,NA
T131,T143,Sebastian Cappelen,8,256,30,226,2012,total_driving,NA
T131,T133,Kurt Kitayama,2,256,3,253,2012,total_driving,NA
T131,T77,Vincent Whaley,7,256,103,153,2012,total_driving,NA
T131,T141,Ryan Brehm,10,256,6,250,2012,total_driving,NA
137,T122,Mark Hubbard,10,257,149,108,2012,total_driving,NA
T138,T163,Brandon Hagy,8,258,22,236,2012,total_driving,NA
T138,T109,Billy Horschel,6,258,196,62,2012,total_driving,NA
T140,T147,Sam Burns,6,259,20,239,2012,total_driving,NA
T140,T133,David Lingmerth,5,259,230,29,2012,total_driving,NA
T142,T187,Bud Cauley,6,262,125,137,2012,total_driving,NA
T142,T143,Cameron Tringale,7,262,55,207,2012,total_driving,NA
144,T143,Rikuya Hoshino,2,264,138,126,2012,total_driving,NA
145,T155,Jonathan Byrd,5,265,72,193,2012,total_driving,NA
T146,T116,Maverick McNealy,9,266,89,177,2012,total_driving,NA
T146,T147,Xander Schauffele,3,266,231,35,2012,total_driving,NA
T148,154,Whee Kim,2,267,180,87,2012,total_driving,NA
T148,T141,Lucas Bjerregaard,3,267,18,249,2012,total_driving,NA
150,T152,Chip McDaniel,2,268,59,209,2012,total_driving,NA
T151,T178,Max Homa,6,269,187,82,2012,total_driving,NA
T151,T112,Bill Haas,6,269,147,122,2012,total_driving,NA
T151,146,J.B. Holmes,3,269,224,45,2012,total_driving,NA
T154,129,Zack Sucher,6,270,24,246,2012,total_driving,NA
T154,T157,Roberto Castro,5,270,183,87,2012,total_driving,NA
156,151,Kevin Tway,6,271,27,244,2012,total_driving,NA
T157,T155,Kevin Chappell,6,272,43,229,2012,total_driving,NA
T157,T152,Dominic Bozzelli,7,272,38,234,2012,total_driving,NA
T159,T147,David Hearn,9,273,206,67,2012,total_driving,NA
T159,174,Jimmy Walker,4,273,92,181,2012,total_driving,NA
161,165,Sangmoon Bae,6,274,64,210,2012,total_driving,NA
162,167,Michael Gellerman,8,275,135,140,2012,total_driving,NA
163,T159,Kevin Kisner,7,277,227,50,2012,total_driving,NA
T164,T159,Justin Thomas,5,278,161,117,2012,total_driving,NA
T164,T187,Troy Merritt,7,278,182,96,2012,total_driving,NA
T164,T163,Freddie Jacobson,3,278,141,137,2012,total_driving,NA
167,T175,Talor Gooch,8,280,122,158,2012,total_driving,NA
168,T103,Andrew Putnam,6,283,181,102,2012,total_driving,NA
T169,T157,Si Woo Kim,8,284,99,185,2012,total_driving,NA
T169,T97,Charley Hoffman,7,284,87,197,2012,total_driving,NA
T169,169,Seamus Power,5,284,83,201,2012,total_driving,NA
172,T133,John Huh,5,285,166,119,2012,total_driving,NA
T173,T172,Jason Day,3,286,80,206,2012,total_driving,NA
T173,T172,Chris Kirk,3,286,199,87,2012,total_driving,NA
T173,T175,Rafael Campos,9,286,67,219,2012,total_driving,NA
176,T159,Nate Lashley,8,287,204,83,2012,total_driving,NA
177,177,Brandt Snedeker,4,288,155,133,2012,total_driving,NA
178,T178,Peter Uihlein,6,289,38,251,2012,total_driving,NA
179,150,Kevin Na,7,290,203,87,2012,total_driving,NA
180,T170,Ben Taylor,10,291,134,157,2012,total_driving,NA
181,162,Anirban Lahiri,8,292,118,174,2012,total_driving,NA
182,T208,Roger Sloan,8,293,158,135,2012,total_driving,NA
T183,182,Johnson Wagner,5,294,207,87,2012,total_driving,NA
T183,T183,Robert Garrigus,5,294,52,242,2012,total_driving,NA
T183,T187,Wes Roach,7,294,151,143,2012,total_driving,NA
186,181,Zach Johnson,7,299,216,83,2012,total_driving,NA
187,191,Mikumu Horikawa,3,303,237,66,2012,total_driving,NA
T188,194,Will Gordon,4,304,64,240,2012,total_driving,NA
T188,210,Rory Sabbatini,7,304,219,85,2012,total_driving,NA
T188,T183,Dylan Frittelli,9,304,193,111,2012,total_driving,NA
191,185,Nelson Ledesma,10,305,57,248,2012,total_driving,NA
192,192,Marc Leishman,5,306,90,216,2012,total_driving,NA
193,166,Joseph Bramlett,7,307,94,213,2012,total_driving,NA
194,195,Joaquin Niemann,8,308,164,144,2012,total_driving,NA
T195,T196,Graeme McDowell,5,311,236,75,2012,total_driving,NA
T195,T201,Bronson Burgoon,8,311,130,181,2012,total_driving,NA
197,T187,Brian Gay,9,312,162,150,2012,total_driving,NA
198,193,Rhein Gibson,9,313,90,223,2012,total_driving,NA
199,T196,Tom Hoge,8,314,185,129,2012,total_driving,NA
200,200,Mark Anderson,7,319,132,187,2012,total_driving,NA
201,204,Smylie Kaufman,3,320,64,256,2012,total_driving,NA
T202,199,Zac Blair,10,322,225,97,2012,total_driving,NA
T202,214,Francesco Molinari,3,322,125,197,2012,total_driving,NA
T204,T170,John Senden,5,324,120,204,2012,total_driving,NA
T204,180,Ben Martin,6,324,223,101,2012,total_driving,NA
T206,T205,James Hahn,6,325,163,162,2012,total_driving,NA
T206,186,Aaron Baddeley,6,325,198,127,2012,total_driving,NA
208,T211,J.J. Spaun,9,330,118,212,2012,total_driving,NA
T209,203,Robert Streb,9,332,141,191,2012,total_driving,NA
T209,T208,Robert Allenby,3,332,164,168,2012,total_driving,NA
211,T211,Martin Trainer,8,339,94,245,2012,total_driving,NA
212,T205,"Ted Potter, Jr.",7,340,151,189,2012,total_driving,NA
213,T201,Chris Stroud,6,341,194,147,2012,total_driving,NA
T214,T205,Rob Oppenheim,10,342,200,142,2012,total_driving,NA
T214,198,Matt Every,7,342,122,220,2012,total_driving,NA
T214,213,Morgan Hoffmann,4,342,143,199,2012,total_driving,NA
217,215,Roberto Díaz,2,345,110,235,2012,total_driving,NA
218,216,Stewart Cink,4,350,112,238,2012,total_driving,NA
219,217,C.T. Pan,5,353,189,164,2012,total_driving,NA
220,T218,Patton Kizzire,9,354,158,196,2012,total_driving,NA
221,222,Hudson Swafford,4,356,183,173,2012,total_driving,NA
222,T218,George McNeill,6,359,145,214,2012,total_driving,NA
223,220,Patrick Reed,4,363,239,124,2012,total_driving,NA
224,221,Jamie Lovemark,4,365,114,251,2012,total_driving,NA
225,224,Luke Donald,2,378,232,146,2012,total_driving,NA
226,226,Bo Van Pelt,7,387,155,232,2012,total_driving,NA
227,225,Davis Love III,3,400,172,228,2012,total_driving,NA
228,228,Arjun Atwal,5,404,173,231,2012,total_driving,NA
T229,231,Daniel Chopra,3,411,157,254,2012,total_driving,NA
T229,227,Kevin Stadler,6,411,217,194,2012,total_driving,NA
231,229,John Rollins,4,414,209,205,2012,total_driving,NA
232,230,Parker McLachlin,4,421,201,220,2012,total_driving,NA
233,232,Peter Malnati,9,422,197,225,2012,total_driving,NA
234,233,Michael Kim,8,435,211,224,2012,total_driving,NA
235,235,Tommy Gainey,4,442,209,233,2012,total_driving,NA
236,234,D.A. Points,4,446,226,220,2012,total_driving,NA
237,236,Ricky Barnes,6,451,214,237,2012,total_driving,NA
238,237,Brendon de Jonge,3,462,205,257,2012,total_driving,NA
239,238,Shugo Imahira,2,490,235,255,2012,total_driving,NA
1,1,Andrew Novak,2,35,17,18,2013,total_driving,NA
2,3,Viktor Hovland,4,63,16,47,2013,total_driving,NA
3,4,Chase Koepka,2,72,34,38,2013,total_driving,NA
4,5,John Oda,2,74,70,4,2013,total_driving,NA
5,6,D.J. Trahan,7,91,47,44,2013,total_driving,NA
6,8,Gary Woodland,4,98,94,4,2013,total_driving,NA
7,9,Branden Grace,4,99,21,78,2013,total_driving,NA
T8,10,Patrick Cantlay,3,103,86,17,2013,total_driving,NA
T8,7,Doc Redman,10,103,77,26,2013,total_driving,NA
10,2,Ryan Moore,5,105,94,11,2013,total_driving,NA
11,13,Scottie Scheffler,8,126,15,111,2013,total_driving,NA
12,T19,Kyoung-Hoon Lee,10,128,106,22,2013,total_driving,NA
13,14,Martin Laird,8,129,42,87,2013,total_driving,NA
14,11,Kevin Streelman,9,130,62,68,2013,total_driving,NA
15,25,Jhonattan Vegas,6,132,24,108,2013,total_driving,NA
T16,15,Nick Taylor,8,133,109,24,2013,total_driving,NA
T16,T23,Brendan Steele,8,133,63,70,2013,total_driving,NA
18,12,Harris English,7,135,36,99,2013,total_driving,NA
T19,T27,Harry Higgs,10,140,79,61,2013,total_driving,NA
T19,T27,Sung Kang,7,140,53,87,2013,total_driving,NA
T21,22,Emiliano Grillo,7,142,110,32,2013,total_driving,NA
T21,18,Bubba Watson,4,142,1,141,2013,total_driving,NA
23,T19,Bryson DeChambeau,3,144,13,131,2013,total_driving,NA
24,T52,Matthew Wolff,5,145,40,105,2013,total_driving,NA
25,29,Joel Dahmen,8,149,100,49,2013,total_driving,NA
26,16,Jason Kokrak,5,153,8,145,2013,total_driving,NA
27,17,Josh Teater,6,156,83,73,2013,total_driving,NA
28,T23,Cameron Champ,7,157,2,155,2013,total_driving,NA
29,33,Ryan Palmer,5,160,146,14,2013,total_driving,NA
30,T35,Adam Hadwin,5,164,121,43,2013,total_driving,NA
31,26,Sungjae Im,8,165,50,115,2013,total_driving,NA
32,31,Henrik Norlander,10,168,132,36,2013,total_driving,NA
T33,38,Boo Weekley,5,169,147,22,2013,total_driving,NA
T33,T35,Harold Varner III,7,169,18,151,2013,total_driving,NA
35,37,Lanto Griffin,10,170,40,130,2013,total_driving,NA
36,T19,Lucas Glover,7,174,98,76,2013,total_driving,NA
37,34,Scott Brown,9,175,151,24,2013,total_driving,NA
38,T44,Sebastián Muñoz,10,176,60,116,2013,total_driving,NA
T39,40,Daniel Berger,6,177,56,121,2013,total_driving,NA
T39,42,Keegan Bradley,7,177,71,106,2013,total_driving,NA
41,39,Chesson Hadley,7,179,106,73,2013,total_driving,NA
42,43,Webb Simpson,3,182,170,12,2013,total_driving,NA
43,48,Danny Lee,7,185,9,176,2013,total_driving,NA
44,T50,Pat Perez,6,186,130,56,2013,total_driving,NA
45,T52,Matthew NeSmith,9,188,154,34,2013,total_driving,NA
46,T99,Sepp Straka,10,191,92,99,2013,total_driving,NA
T47,T90,Isaiah Salinda,3,192,14,178,2013,total_driving,NA
T47,T56,John Merrick,4,192,135,57,2013,total_driving,NA
T49,T50,Jim Furyk,3,193,192,1,2013,total_driving,NA
T49,55,Chad Campbell,4,193,178,15,2013,total_driving,NA
T49,T44,Wyndham Clark,7,193,32,161,2013,total_driving,NA
52,32,Alex Noren,4,195,108,87,2013,total_driving,NA
53,NA,Rickie Fowler,2,196,194,2,2013,total_driving,NA
T54,T56,Tony Finau,5,198,12,186,2013,total_driving,NA
T54,T62,Phil Mickelson,5,198,31,167,2013,total_driving,NA
T54,T62,Aaron Wise,7,198,51,147,2013,total_driving,NA
T54,T69,Chase Seiffert,9,198,127,71,2013,total_driving,NA
T58,T73,Abraham Ancer,8,199,113,86,2013,total_driving,NA
T58,61,Adam Schenk,10,199,33,166,2013,total_driving,NA
T58,T64,Scott Harrington,9,199,34,165,2013,total_driving,NA
T61,T52,Brian Harman,8,200,143,57,2013,total_driving,NA
T61,47,Jason Dufner,7,200,140,60,2013,total_driving,NA
T61,59,Cameron Smith,6,200,77,123,2013,total_driving,NA
T64,46,Kramer Hickok,9,201,124,77,2013,total_driving,NA
T64,60,Matt Jones,8,201,49,152,2013,total_driving,NA
66,30,Robby Shelton,10,202,88,114,2013,total_driving,NA
T67,83,Grayson Murray,6,203,4,199,2013,total_driving,NA
T67,T73,Russell Knox,8,203,138,65,2013,total_driving,NA
69,41,Denny McCarthy,8,204,101,103,2013,total_driving,NA
70,T80,Sam Ryder,10,209,53,156,2013,total_driving,NA
71,58,Brice Garnett,8,214,150,64,2013,total_driving,NA
72,66,Michael Thompson,7,215,175,40,2013,total_driving,NA
73,76,Collin Morikawa,6,216,168,48,2013,total_driving,NA
T74,T69,Derek Ernst,4,217,80,137,2013,total_driving,NA
T74,T67,Adam Long,10,217,189,28,2013,total_driving,NA
T74,96,Andrew Landry,9,217,171,46,2013,total_driving,NA
77,T84,Akshay Bhatia,5,218,7,211,2013,total_driving,NA
78,T69,Rod Pampling,3,220,28,192,2013,total_driving,NA
79,136,Nick Watney,7,222,73,149,2013,total_driving,NA
T80,T84,Hideki Matsuyama,6,223,115,108,2013,total_driving,NA
T80,115,Doug Ghim,7,223,116,107,2013,total_driving,NA
T80,T90,Kristoffer Ventura,9,223,44,179,2013,total_driving,NA
T83,T73,Byeong Hun An,8,225,10,215,2013,total_driving,NA
T83,T90,Chandler Phillips,2,225,57,168,2013,total_driving,NA
T83,T69,Brian Stuard,10,225,215,10,2013,total_driving,NA
T83,T97,Alex Cejka,5,225,175,50,2013,total_driving,NA
T83,T80,Ryan Armour,9,225,217,8,2013,total_driving,NA
T88,T90,Graham DeLaet,5,226,36,190,2013,total_driving,NA
T88,T77,Tim Wilkinson,6,226,189,37,2013,total_driving,NA
T88,T86,Brandon Wu,2,226,188,38,2013,total_driving,NA
T91,T88,Hank Lebioda,9,228,104,124,2013,total_driving,NA
T91,79,Charles Howell III,9,228,69,159,2013,total_driving,NA
93,T67,Tyler McCumber,9,229,11,218,2013,total_driving,NA
94,T90,Fabián Gómez,9,230,167,63,2013,total_driving,NA
95,T90,Brendon Todd,11,231,228,3,2013,total_driving,NA
T96,49,Cameron Percy,8,233,61,172,2013,total_driving,NA
T96,T99,Adam Scott,4,233,46,187,2013,total_driving,NA
T96,T80,Luke List,9,233,80,153,2013,total_driving,NA
T96,T86,Russell Henley,8,233,179,54,2013,total_driving,NA
T96,T130,Mackenzie Hughes,8,233,101,132,2013,total_driving,NA
101,T109,J.T. Poston,9,234,175,59,2013,total_driving,NA
102,T64,Vince Covello,8,235,73,162,2013,total_driving,NA
103,T99,Xinjun Zhang,10,236,116,120,2013,total_driving,NA
104,105,K.J. Choi,3,237,233,4,2013,total_driving,NA
T105,107,Tim Herron,4,238,220,18,2013,total_driving,NA
T105,T109,Corey Conners,7,238,186,52,2013,total_driving,NA
T107,108,Keith Mitchell,7,239,135,104,2013,total_driving,NA
T107,T130,Cameron Davis,8,239,22,217,2013,total_driving,NA
T107,T99,Richy Werenski,4,239,45,194,2013,total_driving,NA
T107,T88,Vaughn Taylor,8,239,212,27,2013,total_driving,NA
111,168,Chris Baker,9,240,168,72,2013,total_driving,NA
T112,T112,Jim Herman,8,241,221,20,2013,total_driving,NA
T112,T127,Scott Piercy,8,241,105,136,2013,total_driving,NA
T114,T120,J.J. Henry,5,242,173,69,2013,total_driving,NA
T114,T103,Tyler Duncan,10,242,221,21,2013,total_driving,NA
116,T112,Davis Riley,2,243,83,160,2013,total_driving,NA
T117,T125,Bo Hoag,10,244,127,117,2013,total_driving,NA
T117,T116,Chez Reavie,9,244,228,16,2013,total_driving,NA
119,T116,Matt Kuchar,4,245,238,7,2013,total_driving,NA
T120,223,Paul Casey,4,247,160,87,2013,total_driving,NA
T120,T116,Satoshi Kodaira,6,247,234,13,2013,total_driving,NA
T120,T127,Shawn Stefani,6,247,73,174,2013,total_driving,NA
123,106,Carlos Ortiz,8,248,67,181,2013,total_driving,NA
124,T122,Ben Crane,6,249,207,42,2013,total_driving,NA
125,T130,Tom Lewis,3,252,5,247,2013,total_driving,NA
126,T139,Michael Gligic,9,253,73,180,2013,total_driving,NA
T127,T139,Scott Stallings,8,254,47,207,2013,total_driving,NA
T127,T137,Kyle Stanley,8,254,213,41,2013,total_driving,NA
T129,T137,Henrik Stenson,2,255,202,53,2013,total_driving,NA
T129,T125,Austin Cook,8,255,127,128,2013,total_driving,NA
T131,T120,Beau Hossler,8,256,29,227,2013,total_driving,NA
T131,T122,Patrick Rodgers,10,256,26,230,2013,total_driving,NA
T131,T143,Sebastian Cappelen,8,256,30,226,2013,total_driving,NA
T131,T133,Kurt Kitayama,2,256,3,253,2013,total_driving,NA
T131,T77,Vincent Whaley,7,256,103,153,2013,total_driving,NA
T131,T141,Ryan Brehm,10,256,6,250,2013,total_driving,NA
137,T122,Mark Hubbard,10,257,149,108,2013,total_driving,NA
T138,T163,Brandon Hagy,8,258,22,236,2013,total_driving,NA
T138,T109,Billy Horschel,6,258,196,62,2013,total_driving,NA
T140,T147,Sam Burns,6,259,20,239,2013,total_driving,NA
T140,T133,David Lingmerth,5,259,230,29,2013,total_driving,NA
T142,T187,Bud Cauley,6,262,125,137,2013,total_driving,NA
T142,T143,Cameron Tringale,7,262,55,207,2013,total_driving,NA
144,T143,Rikuya Hoshino,2,264,138,126,2013,total_driving,NA
145,T155,Jonathan Byrd,5,265,72,193,2013,total_driving,NA
T146,T116,Maverick McNealy,9,266,89,177,2013,total_driving,NA
T146,T147,Xander Schauffele,3,266,231,35,2013,total_driving,NA
T148,154,Whee Kim,2,267,180,87,2013,total_driving,NA
T148,T141,Lucas Bjerregaard,3,267,18,249,2013,total_driving,NA
150,T152,Chip McDaniel,2,268,59,209,2013,total_driving,NA
T151,T178,Max Homa,6,269,187,82,2013,total_driving,NA
T151,T112,Bill Haas,6,269,147,122,2013,total_driving,NA
T151,146,J.B. Holmes,3,269,224,45,2013,total_driving,NA
T154,129,Zack Sucher,6,270,24,246,2013,total_driving,NA
T154,T157,Roberto Castro,5,270,183,87,2013,total_driving,NA
156,151,Kevin Tway,6,271,27,244,2013,total_driving,NA
T157,T155,Kevin Chappell,6,272,43,229,2013,total_driving,NA
T157,T152,Dominic Bozzelli,7,272,38,234,2013,total_driving,NA
T159,T147,David Hearn,9,273,206,67,2013,total_driving,NA
T159,174,Jimmy Walker,4,273,92,181,2013,total_driving,NA
161,165,Sangmoon Bae,6,274,64,210,2013,total_driving,NA
162,167,Michael Gellerman,8,275,135,140,2013,total_driving,NA
163,T159,Kevin Kisner,7,277,227,50,2013,total_driving,NA
T164,T159,Justin Thomas,5,278,161,117,2013,total_driving,NA
T164,T187,Troy Merritt,7,278,182,96,2013,total_driving,NA
T164,T163,Freddie Jacobson,3,278,141,137,2013,total_driving,NA
167,T175,Talor Gooch,8,280,122,158,2013,total_driving,NA
168,T103,Andrew Putnam,6,283,181,102,2013,total_driving,NA
T169,T157,Si Woo Kim,8,284,99,185,2013,total_driving,NA
T169,T97,Charley Hoffman,7,284,87,197,2013,total_driving,NA
T169,169,Seamus Power,5,284,83,201,2013,total_driving,NA
172,T133,John Huh,5,285,166,119,2013,total_driving,NA
T173,T172,Jason Day,3,286,80,206,2013,total_driving,NA
T173,T172,Chris Kirk,3,286,199,87,2013,total_driving,NA
T173,T175,Rafael Campos,9,286,67,219,2013,total_driving,NA
176,T159,Nate Lashley,8,287,204,83,2013,total_driving,NA
177,177,Brandt Snedeker,4,288,155,133,2013,total_driving,NA
178,T178,Peter Uihlein,6,289,38,251,2013,total_driving,NA
179,150,Kevin Na,7,290,203,87,2013,total_driving,NA
180,T170,Ben Taylor,10,291,134,157,2013,total_driving,NA
181,162,Anirban Lahiri,8,292,118,174,2013,total_driving,NA
182,T208,Roger Sloan,8,293,158,135,2013,total_driving,NA
T183,182,Johnson Wagner,5,294,207,87,2013,total_driving,NA
T183,T183,Robert Garrigus,5,294,52,242,2013,total_driving,NA
T183,T187,Wes Roach,7,294,151,143,2013,total_driving,NA
186,181,Zach Johnson,7,299,216,83,2013,total_driving,NA
187,191,Mikumu Horikawa,3,303,237,66,2013,total_driving,NA
T188,194,Will Gordon,4,304,64,240,2013,total_driving,NA
T188,210,Rory Sabbatini,7,304,219,85,2013,total_driving,NA
T188,T183,Dylan Frittelli,9,304,193,111,2013,total_driving,NA
191,185,Nelson Ledesma,10,305,57,248,2013,total_driving,NA
192,192,Marc Leishman,5,306,90,216,2013,total_driving,NA
193,166,Joseph Bramlett,7,307,94,213,2013,total_driving,NA
194,195,Joaquin Niemann,8,308,164,144,2013,total_driving,NA
T195,T196,Graeme McDowell,5,311,236,75,2013,total_driving,NA
T195,T201,Bronson Burgoon,8,311,130,181,2013,total_driving,NA
197,T187,Brian Gay,9,312,162,150,2013,total_driving,NA
198,193,Rhein Gibson,9,313,90,223,2013,total_driving,NA
199,T196,Tom Hoge,8,314,185,129,2013,total_driving,NA
200,200,Mark Anderson,7,319,132,187,2013,total_driving,NA
201,204,Smylie Kaufman,3,320,64,256,2013,total_driving,NA
T202,199,Zac Blair,10,322,225,97,2013,total_driving,NA
T202,214,Francesco Molinari,3,322,125,197,2013,total_driving,NA
T204,T170,John Senden,5,324,120,204,2013,total_driving,NA
T204,180,Ben Martin,6,324,223,101,2013,total_driving,NA
T206,T205,James Hahn,6,325,163,162,2013,total_driving,NA
T206,186,Aaron Baddeley,6,325,198,127,2013,total_driving,NA
208,T211,J.J. Spaun,9,330,118,212,2013,total_driving,NA
T209,203,Robert Streb,9,332,141,191,2013,total_driving,NA
T209,T208,Robert Allenby,3,332,164,168,2013,total_driving,NA
211,T211,Martin Trainer,8,339,94,245,2013,total_driving,NA
212,T205,"Ted Potter, Jr.",7,340,151,189,2013,total_driving,NA
213,T201,Chris Stroud,6,341,194,147,2013,total_driving,NA
T214,T205,Rob Oppenheim,10,342,200,142,2013,total_driving,NA
T214,198,Matt Every,7,342,122,220,2013,total_driving,NA
T214,213,Morgan Hoffmann,4,342,143,199,2013,total_driving,NA
217,215,Roberto Díaz,2,345,110,235,2013,total_driving,NA
218,216,Stewart Cink,4,350,112,238,2013,total_driving,NA
219,217,C.T. Pan,5,353,189,164,2013,total_driving,NA
220,T218,Patton Kizzire,9,354,158,196,2013,total_driving,NA
221,222,Hudson Swafford,4,356,183,173,2013,total_driving,NA
222,T218,George McNeill,6,359,145,214,2013,total_driving,NA
223,220,Patrick Reed,4,363,239,124,2013,total_driving,NA
224,221,Jamie Lovemark,4,365,114,251,2013,total_driving,NA
225,224,Luke Donald,2,378,232,146,2013,total_driving,NA
226,226,Bo Van Pelt,7,387,155,232,2013,total_driving,NA
227,225,Davis Love III,3,400,172,228,2013,total_driving,NA
228,228,Arjun Atwal,5,404,173,231,2013,total_driving,NA
T229,231,Daniel Chopra,3,411,157,254,2013,total_driving,NA
T229,227,Kevin Stadler,6,411,217,194,2013,total_driving,NA
231,229,John Rollins,4,414,209,205,2013,total_driving,NA
232,230,Parker McLachlin,4,421,201,220,2013,total_driving,NA
233,232,Peter Malnati,9,422,197,225,2013,total_driving,NA
234,233,Michael Kim,8,435,211,224,2013,total_driving,NA
235,235,Tommy Gainey,4,442,209,233,2013,total_driving,NA
236,234,D.A. Points,4,446,226,220,2013,total_driving,NA
237,236,Ricky Barnes,6,451,214,237,2013,total_driving,NA
238,237,Brendon de Jonge,3,462,205,257,2013,total_driving,NA
239,238,Shugo Imahira,2,490,235,255,2013,total_driving,NA
1,1,Andrew Novak,2,35,17,18,2014,total_driving,NA
2,3,Viktor Hovland,4,63,16,47,2014,total_driving,NA
3,4,Chase Koepka,2,72,34,38,2014,total_driving,NA
4,5,John Oda,2,74,70,4,2014,total_driving,NA
5,6,D.J. Trahan,7,91,47,44,2014,total_driving,NA
6,8,Gary Woodland,4,98,94,4,2014,total_driving,NA
7,9,Branden Grace,4,99,21,78,2014,total_driving,NA
T8,10,Patrick Cantlay,3,103,86,17,2014,total_driving,NA
T8,7,Doc Redman,10,103,77,26,2014,total_driving,NA
10,2,Ryan Moore,5,105,94,11,2014,total_driving,NA
11,13,Scottie Scheffler,8,126,15,111,2014,total_driving,NA
12,T19,Kyoung-Hoon Lee,10,128,106,22,2014,total_driving,NA
13,14,Martin Laird,8,129,42,87,2014,total_driving,NA
14,11,Kevin Streelman,9,130,62,68,2014,total_driving,NA
15,25,Jhonattan Vegas,6,132,24,108,2014,total_driving,NA
T16,15,Nick Taylor,8,133,109,24,2014,total_driving,NA
T16,T23,Brendan Steele,8,133,63,70,2014,total_driving,NA
18,12,Harris English,7,135,36,99,2014,total_driving,NA
T19,T27,Harry Higgs,10,140,79,61,2014,total_driving,NA
T19,T27,Sung Kang,7,140,53,87,2014,total_driving,NA
T21,22,Emiliano Grillo,7,142,110,32,2014,total_driving,NA
T21,18,Bubba Watson,4,142,1,141,2014,total_driving,NA
23,T19,Bryson DeChambeau,3,144,13,131,2014,total_driving,NA
24,T52,Matthew Wolff,5,145,40,105,2014,total_driving,NA
25,29,Joel Dahmen,8,149,100,49,2014,total_driving,NA
26,16,Jason Kokrak,5,153,8,145,2014,total_driving,NA
27,17,Josh Teater,6,156,83,73,2014,total_driving,NA
28,T23,Cameron Champ,7,157,2,155,2014,total_driving,NA
29,33,Ryan Palmer,5,160,146,14,2014,total_driving,NA
30,T35,Adam Hadwin,5,164,121,43,2014,total_driving,NA
31,26,Sungjae Im,8,165,50,115,2014,total_driving,NA
32,31,Henrik Norlander,10,168,132,36,2014,total_driving,NA
T33,38,Boo Weekley,5,169,147,22,2014,total_driving,NA
T33,T35,Harold Varner III,7,169,18,151,2014,total_driving,NA
35,37,Lanto Griffin,10,170,40,130,2014,total_driving,NA
36,T19,Lucas Glover,7,174,98,76,2014,total_driving,NA
37,34,Scott Brown,9,175,151,24,2014,total_driving,NA
38,T44,Sebastián Muñoz,10,176,60,116,2014,total_driving,NA
T39,40,Daniel Berger,6,177,56,121,2014,total_driving,NA
T39,42,Keegan Bradley,7,177,71,106,2014,total_driving,NA
41,39,Chesson Hadley,7,179,106,73,2014,total_driving,NA
42,43,Webb Simpson,3,182,170,12,2014,total_driving,NA
43,48,Danny Lee,7,185,9,176,2014,total_driving,NA
44,T50,Pat Perez,6,186,130,56,2014,total_driving,NA
45,T52,Matthew NeSmith,9,188,154,34,2014,total_driving,NA
46,T99,Sepp Straka,10,191,92,99,2014,total_driving,NA
T47,T90,Isaiah Salinda,3,192,14,178,2014,total_driving,NA
T47,T56,John Merrick,4,192,135,57,2014,total_driving,NA
T49,T50,Jim Furyk,3,193,192,1,2014,total_driving,NA
T49,55,Chad Campbell,4,193,178,15,2014,total_driving,NA
T49,T44,Wyndham Clark,7,193,32,161,2014,total_driving,NA
52,32,Alex Noren,4,195,108,87,2014,total_driving,NA
53,NA,Rickie Fowler,2,196,194,2,2014,total_driving,NA
T54,T56,Tony Finau,5,198,12,186,2014,total_driving,NA
T54,T62,Phil Mickelson,5,198,31,167,2014,total_driving,NA
T54,T62,Aaron Wise,7,198,51,147,2014,total_driving,NA
T54,T69,Chase Seiffert,9,198,127,71,2014,total_driving,NA
T58,T73,Abraham Ancer,8,199,113,86,2014,total_driving,NA
T58,61,Adam Schenk,10,199,33,166,2014,total_driving,NA
T58,T64,Scott Harrington,9,199,34,165,2014,total_driving,NA
T61,T52,Brian Harman,8,200,143,57,2014,total_driving,NA
T61,47,Jason Dufner,7,200,140,60,2014,total_driving,NA
T61,59,Cameron Smith,6,200,77,123,2014,total_driving,NA
T64,46,Kramer Hickok,9,201,124,77,2014,total_driving,NA
T64,60,Matt Jones,8,201,49,152,2014,total_driving,NA
66,30,Robby Shelton,10,202,88,114,2014,total_driving,NA
T67,83,Grayson Murray,6,203,4,199,2014,total_driving,NA
T67,T73,Russell Knox,8,203,138,65,2014,total_driving,NA
69,41,Denny McCarthy,8,204,101,103,2014,total_driving,NA
70,T80,Sam Ryder,10,209,53,156,2014,total_driving,NA
71,58,Brice Garnett,8,214,150,64,2014,total_driving,NA
72,66,Michael Thompson,7,215,175,40,2014,total_driving,NA
73,76,Collin Morikawa,6,216,168,48,2014,total_driving,NA
T74,T69,Derek Ernst,4,217,80,137,2014,total_driving,NA
T74,T67,Adam Long,10,217,189,28,2014,total_driving,NA
T74,96,Andrew Landry,9,217,171,46,2014,total_driving,NA
77,T84,Akshay Bhatia,5,218,7,211,2014,total_driving,NA
78,T69,Rod Pampling,3,220,28,192,2014,total_driving,NA
79,136,Nick Watney,7,222,73,149,2014,total_driving,NA
T80,T84,Hideki Matsuyama,6,223,115,108,2014,total_driving,NA
T80,115,Doug Ghim,7,223,116,107,2014,total_driving,NA
T80,T90,Kristoffer Ventura,9,223,44,179,2014,total_driving,NA
T83,T73,Byeong Hun An,8,225,10,215,2014,total_driving,NA
T83,T90,Chandler Phillips,2,225,57,168,2014,total_driving,NA
T83,T69,Brian Stuard,10,225,215,10,2014,total_driving,NA
T83,T97,Alex Cejka,5,225,175,50,2014,total_driving,NA
T83,T80,Ryan Armour,9,225,217,8,2014,total_driving,NA
T88,T90,Graham DeLaet,5,226,36,190,2014,total_driving,NA
T88,T77,Tim Wilkinson,6,226,189,37,2014,total_driving,NA
T88,T86,Brandon Wu,2,226,188,38,2014,total_driving,NA
T91,T88,Hank Lebioda,9,228,104,124,2014,total_driving,NA
T91,79,Charles Howell III,9,228,69,159,2014,total_driving,NA
93,T67,Tyler McCumber,9,229,11,218,2014,total_driving,NA
94,T90,Fabián Gómez,9,230,167,63,2014,total_driving,NA
95,T90,Brendon Todd,11,231,228,3,2014,total_driving,NA
T96,49,Cameron Percy,8,233,61,172,2014,total_driving,NA
T96,T99,Adam Scott,4,233,46,187,2014,total_driving,NA
T96,T80,Luke List,9,233,80,153,2014,total_driving,NA
T96,T86,Russell Henley,8,233,179,54,2014,total_driving,NA
T96,T130,Mackenzie Hughes,8,233,101,132,2014,total_driving,NA
101,T109,J.T. Poston,9,234,175,59,2014,total_driving,NA
102,T64,Vince Covello,8,235,73,162,2014,total_driving,NA
103,T99,Xinjun Zhang,10,236,116,120,2014,total_driving,NA
104,105,K.J. Choi,3,237,233,4,2014,total_driving,NA
T105,107,Tim Herron,4,238,220,18,2014,total_driving,NA
T105,T109,Corey Conners,7,238,186,52,2014,total_driving,NA
T107,108,Keith Mitchell,7,239,135,104,2014,total_driving,NA
T107,T130,Cameron Davis,8,239,22,217,2014,total_driving,NA
T107,T99,Richy Werenski,4,239,45,194,2014,total_driving,NA
T107,T88,Vaughn Taylor,8,239,212,27,2014,total_driving,NA
111,168,Chris Baker,9,240,168,72,2014,total_driving,NA
T112,T112,Jim Herman,8,241,221,20,2014,total_driving,NA
T112,T127,Scott Piercy,8,241,105,136,2014,total_driving,NA
T114,T120,J.J. Henry,5,242,173,69,2014,total_driving,NA
T114,T103,Tyler Duncan,10,242,221,21,2014,total_driving,NA
116,T112,Davis Riley,2,243,83,160,2014,total_driving,NA
T117,T125,Bo Hoag,10,244,127,117,2014,total_driving,NA
T117,T116,Chez Reavie,9,244,228,16,2014,total_driving,NA
119,T116,Matt Kuchar,4,245,238,7,2014,total_driving,NA
T120,223,Paul Casey,4,247,160,87,2014,total_driving,NA
T120,T116,Satoshi Kodaira,6,247,234,13,2014,total_driving,NA
T120,T127,Shawn Stefani,6,247,73,174,2014,total_driving,NA
123,106,Carlos Ortiz,8,248,67,181,2014,total_driving,NA
124,T122,Ben Crane,6,249,207,42,2014,total_driving,NA
125,T130,Tom Lewis,3,252,5,247,2014,total_driving,NA
126,T139,Michael Gligic,9,253,73,180,2014,total_driving,NA
T127,T139,Scott Stallings,8,254,47,207,2014,total_driving,NA
T127,T137,Kyle Stanley,8,254,213,41,2014,total_driving,NA
T129,T137,Henrik Stenson,2,255,202,53,2014,total_driving,NA
T129,T125,Austin Cook,8,255,127,128,2014,total_driving,NA
T131,T120,Beau Hossler,8,256,29,227,2014,total_driving,NA
T131,T122,Patrick Rodgers,10,256,26,230,2014,total_driving,NA
T131,T143,Sebastian Cappelen,8,256,30,226,2014,total_driving,NA
T131,T133,Kurt Kitayama,2,256,3,253,2014,total_driving,NA
T131,T77,Vincent Whaley,7,256,103,153,2014,total_driving,NA
T131,T141,Ryan Brehm,10,256,6,250,2014,total_driving,NA
137,T122,Mark Hubbard,10,257,149,108,2014,total_driving,NA
T138,T163,Brandon Hagy,8,258,22,236,2014,total_driving,NA
T138,T109,Billy Horschel,6,258,196,62,2014,total_driving,NA
T140,T147,Sam Burns,6,259,20,239,2014,total_driving,NA
T140,T133,David Lingmerth,5,259,230,29,2014,total_driving,NA
T142,T187,Bud Cauley,6,262,125,137,2014,total_driving,NA
T142,T143,Cameron Tringale,7,262,55,207,2014,total_driving,NA
144,T143,Rikuya Hoshino,2,264,138,126,2014,total_driving,NA
145,T155,Jonathan Byrd,5,265,72,193,2014,total_driving,NA
T146,T116,Maverick McNealy,9,266,89,177,2014,total_driving,NA
T146,T147,Xander Schauffele,3,266,231,35,2014,total_driving,NA
T148,154,Whee Kim,2,267,180,87,2014,total_driving,NA
T148,T141,Lucas Bjerregaard,3,267,18,249,2014,total_driving,NA
150,T152,Chip McDaniel,2,268,59,209,2014,total_driving,NA
T151,T178,Max Homa,6,269,187,82,2014,total_driving,NA
T151,T112,Bill Haas,6,269,147,122,2014,total_driving,NA
T151,146,J.B. Holmes,3,269,224,45,2014,total_driving,NA
T154,129,Zack Sucher,6,270,24,246,2014,total_driving,NA
T154,T157,Roberto Castro,5,270,183,87,2014,total_driving,NA
156,151,Kevin Tway,6,271,27,244,2014,total_driving,NA
T157,T155,Kevin Chappell,6,272,43,229,2014,total_driving,NA
T157,T152,Dominic Bozzelli,7,272,38,234,2014,total_driving,NA
T159,T147,David Hearn,9,273,206,67,2014,total_driving,NA
T159,174,Jimmy Walker,4,273,92,181,2014,total_driving,NA
161,165,Sangmoon Bae,6,274,64,210,2014,total_driving,NA
162,167,Michael Gellerman,8,275,135,140,2014,total_driving,NA
163,T159,Kevin Kisner,7,277,227,50,2014,total_driving,NA
T164,T159,Justin Thomas,5,278,161,117,2014,total_driving,NA
T164,T187,Troy Merritt,7,278,182,96,2014,total_driving,NA
T164,T163,Freddie Jacobson,3,278,141,137,2014,total_driving,NA
167,T175,Talor Gooch,8,280,122,158,2014,total_driving,NA
168,T103,Andrew Putnam,6,283,181,102,2014,total_driving,NA
T169,T157,Si Woo Kim,8,284,99,185,2014,total_driving,NA
T169,T97,Charley Hoffman,7,284,87,197,2014,total_driving,NA
T169,169,Seamus Power,5,284,83,201,2014,total_driving,NA
172,T133,John Huh,5,285,166,119,2014,total_driving,NA
T173,T172,Jason Day,3,286,80,206,2014,total_driving,NA
T173,T172,Chris Kirk,3,286,199,87,2014,total_driving,NA
T173,T175,Rafael Campos,9,286,67,219,2014,total_driving,NA
176,T159,Nate Lashley,8,287,204,83,2014,total_driving,NA
177,177,Brandt Snedeker,4,288,155,133,2014,total_driving,NA
178,T178,Peter Uihlein,6,289,38,251,2014,total_driving,NA
179,150,Kevin Na,7,290,203,87,2014,total_driving,NA
180,T170,Ben Taylor,10,291,134,157,2014,total_driving,NA
181,162,Anirban Lahiri,8,292,118,174,2014,total_driving,NA
182,T208,Roger Sloan,8,293,158,135,2014,total_driving,NA
T183,182,Johnson Wagner,5,294,207,87,2014,total_driving,NA
T183,T183,Robert Garrigus,5,294,52,242,2014,total_driving,NA
T183,T187,Wes Roach,7,294,151,143,2014,total_driving,NA
186,181,Zach Johnson,7,299,216,83,2014,total_driving,NA
187,191,Mikumu Horikawa,3,303,237,66,2014,total_driving,NA
T188,194,Will Gordon,4,304,64,240,2014,total_driving,NA
T188,210,Rory Sabbatini,7,304,219,85,2014,total_driving,NA
T188,T183,Dylan Frittelli,9,304,193,111,2014,total_driving,NA
191,185,Nelson Ledesma,10,305,57,248,2014,total_driving,NA
192,192,Marc Leishman,5,306,90,216,2014,total_driving,NA
193,166,Joseph Bramlett,7,307,94,213,2014,total_driving,NA
194,195,Joaquin Niemann,8,308,164,144,2014,total_driving,NA
T195,T196,Graeme McDowell,5,311,236,75,2014,total_driving,NA
T195,T201,Bronson Burgoon,8,311,130,181,2014,total_driving,NA
197,T187,Brian Gay,9,312,162,150,2014,total_driving,NA
198,193,Rhein Gibson,9,313,90,223,2014,total_driving,NA
199,T196,Tom Hoge,8,314,185,129,2014,total_driving,NA
200,200,Mark Anderson,7,319,132,187,2014,total_driving,NA
201,204,Smylie Kaufman,3,320,64,256,2014,total_driving,NA
T202,199,Zac Blair,10,322,225,97,2014,total_driving,NA
T202,214,Francesco Molinari,3,322,125,197,2014,total_driving,NA
T204,T170,John Senden,5,324,120,204,2014,total_driving,NA
T204,180,Ben Martin,6,324,223,101,2014,total_driving,NA
T206,T205,James Hahn,6,325,163,162,2014,total_driving,NA
T206,186,Aaron Baddeley,6,325,198,127,2014,total_driving,NA
208,T211,J.J. Spaun,9,330,118,212,2014,total_driving,NA
T209,203,Robert Streb,9,332,141,191,2014,total_driving,NA
T209,T208,Robert Allenby,3,332,164,168,2014,total_driving,NA
211,T211,Martin Trainer,8,339,94,245,2014,total_driving,NA
212,T205,"Ted Potter, Jr.",7,340,151,189,2014,total_driving,NA
213,T201,Chris Stroud,6,341,194,147,2014,total_driving,NA
T214,T205,Rob Oppenheim,10,342,200,142,2014,total_driving,NA
T214,198,Matt Every,7,342,122,220,2014,total_driving,NA
T214,213,Morgan Hoffmann,4,342,143,199,2014,total_driving,NA
217,215,Roberto Díaz,2,345,110,235,2014,total_driving,NA
218,216,Stewart Cink,4,350,112,238,2014,total_driving,NA
219,217,C.T. Pan,5,353,189,164,2014,total_driving,NA
220,T218,Patton Kizzire,9,354,158,196,2014,total_driving,NA
221,222,Hudson Swafford,4,356,183,173,2014,total_driving,NA
222,T218,George McNeill,6,359,145,214,2014,total_driving,NA
223,220,Patrick Reed,4,363,239,124,2014,total_driving,NA
224,221,Jamie Lovemark,4,365,114,251,2014,total_driving,NA
225,224,Luke Donald,2,378,232,146,2014,total_driving,NA
226,226,Bo Van Pelt,7,387,155,232,2014,total_driving,NA
227,225,Davis Love III,3,400,172,228,2014,total_driving,NA
228,228,Arjun Atwal,5,404,173,231,2014,total_driving,NA
T229,231,Daniel Chopra,3,411,157,254,2014,total_driving,NA
T229,227,Kevin Stadler,6,411,217,194,2014,total_driving,NA
231,229,John Rollins,4,414,209,205,2014,total_driving,NA
232,230,Parker McLachlin,4,421,201,220,2014,total_driving,NA
233,232,Peter Malnati,9,422,197,225,2014,total_driving,NA
234,233,Michael Kim,8,435,211,224,2014,total_driving,NA
235,235,Tommy Gainey,4,442,209,233,2014,total_driving,NA
236,234,D.A. Points,4,446,226,220,2014,total_driving,NA
237,236,Ricky Barnes,6,451,214,237,2014,total_driving,NA
238,237,Brendon de Jonge,3,462,205,257,2014,total_driving,NA
239,238,Shugo Imahira,2,490,235,255,2014,total_driving,NA
1,1,Andrew Novak,2,35,17,18,2015,total_driving,NA
2,3,Viktor Hovland,4,63,16,47,2015,total_driving,NA
3,4,Chase Koepka,2,72,34,38,2015,total_driving,NA
4,5,John Oda,2,74,70,4,2015,total_driving,NA
5,6,D.J. Trahan,7,91,47,44,2015,total_driving,NA
6,8,Gary Woodland,4,98,94,4,2015,total_driving,NA
7,9,Branden Grace,4,99,21,78,2015,total_driving,NA
T8,10,Patrick Cantlay,3,103,86,17,2015,total_driving,NA
T8,7,Doc Redman,10,103,77,26,2015,total_driving,NA
10,2,Ryan Moore,5,105,94,11,2015,total_driving,NA
11,13,Scottie Scheffler,8,126,15,111,2015,total_driving,NA
12,T19,Kyoung-Hoon Lee,10,128,106,22,2015,total_driving,NA
13,14,Martin Laird,8,129,42,87,2015,total_driving,NA
14,11,Kevin Streelman,9,130,62,68,2015,total_driving,NA
15,25,Jhonattan Vegas,6,132,24,108,2015,total_driving,NA
T16,15,Nick Taylor,8,133,109,24,2015,total_driving,NA
T16,T23,Brendan Steele,8,133,63,70,2015,total_driving,NA
18,12,Harris English,7,135,36,99,2015,total_driving,NA
T19,T27,Harry Higgs,10,140,79,61,2015,total_driving,NA
T19,T27,Sung Kang,7,140,53,87,2015,total_driving,NA
T21,22,Emiliano Grillo,7,142,110,32,2015,total_driving,NA
T21,18,Bubba Watson,4,142,1,141,2015,total_driving,NA
23,T19,Bryson DeChambeau,3,144,13,131,2015,total_driving,NA
24,T52,Matthew Wolff,5,145,40,105,2015,total_driving,NA
25,29,Joel Dahmen,8,149,100,49,2015,total_driving,NA
26,16,Jason Kokrak,5,153,8,145,2015,total_driving,NA
27,17,Josh Teater,6,156,83,73,2015,total_driving,NA
28,T23,Cameron Champ,7,157,2,155,2015,total_driving,NA
29,33,Ryan Palmer,5,160,146,14,2015,total_driving,NA
30,T35,Adam Hadwin,5,164,121,43,2015,total_driving,NA
31,26,Sungjae Im,8,165,50,115,2015,total_driving,NA
32,31,Henrik Norlander,10,168,132,36,2015,total_driving,NA
T33,38,Boo Weekley,5,169,147,22,2015,total_driving,NA
T33,T35,Harold Varner III,7,169,18,151,2015,total_driving,NA
35,37,Lanto Griffin,10,170,40,130,2015,total_driving,NA
36,T19,Lucas Glover,7,174,98,76,2015,total_driving,NA
37,34,Scott Brown,9,175,151,24,2015,total_driving,NA
38,T44,Sebastián Muñoz,10,176,60,116,2015,total_driving,NA
T39,40,Daniel Berger,6,177,56,121,2015,total_driving,NA
T39,42,Keegan Bradley,7,177,71,106,2015,total_driving,NA
41,39,Chesson Hadley,7,179,106,73,2015,total_driving,NA
42,43,Webb Simpson,3,182,170,12,2015,total_driving,NA
43,48,Danny Lee,7,185,9,176,2015,total_driving,NA
44,T50,Pat Perez,6,186,130,56,2015,total_driving,NA
45,T52,Matthew NeSmith,9,188,154,34,2015,total_driving,NA
46,T99,Sepp Straka,10,191,92,99,2015,total_driving,NA
T47,T90,Isaiah Salinda,3,192,14,178,2015,total_driving,NA
T47,T56,John Merrick,4,192,135,57,2015,total_driving,NA
T49,T50,Jim Furyk,3,193,192,1,2015,total_driving,NA
T49,55,Chad Campbell,4,193,178,15,2015,total_driving,NA
T49,T44,Wyndham Clark,7,193,32,161,2015,total_driving,NA
52,32,Alex Noren,4,195,108,87,2015,total_driving,NA
53,NA,Rickie Fowler,2,196,194,2,2015,total_driving,NA
T54,T56,Tony Finau,5,198,12,186,2015,total_driving,NA
T54,T62,Phil Mickelson,5,198,31,167,2015,total_driving,NA
T54,T62,Aaron Wise,7,198,51,147,2015,total_driving,NA
T54,T69,Chase Seiffert,9,198,127,71,2015,total_driving,NA
T58,T73,Abraham Ancer,8,199,113,86,2015,total_driving,NA
T58,61,Adam Schenk,10,199,33,166,2015,total_driving,NA
T58,T64,Scott Harrington,9,199,34,165,2015,total_driving,NA
T61,T52,Brian Harman,8,200,143,57,2015,total_driving,NA
T61,47,Jason Dufner,7,200,140,60,2015,total_driving,NA
T61,59,Cameron Smith,6,200,77,123,2015,total_driving,NA
T64,46,Kramer Hickok,9,201,124,77,2015,total_driving,NA
T64,60,Matt Jones,8,201,49,152,2015,total_driving,NA
66,30,Robby Shelton,10,202,88,114,2015,total_driving,NA
T67,83,Grayson Murray,6,203,4,199,2015,total_driving,NA
T67,T73,Russell Knox,8,203,138,65,2015,total_driving,NA
69,41,Denny McCarthy,8,204,101,103,2015,total_driving,NA
70,T80,Sam Ryder,10,209,53,156,2015,total_driving,NA
71,58,Brice Garnett,8,214,150,64,2015,total_driving,NA
72,66,Michael Thompson,7,215,175,40,2015,total_driving,NA
73,76,Collin Morikawa,6,216,168,48,2015,total_driving,NA
T74,T69,Derek Ernst,4,217,80,137,2015,total_driving,NA
T74,T67,Adam Long,10,217,189,28,2015,total_driving,NA
T74,96,Andrew Landry,9,217,171,46,2015,total_driving,NA
77,T84,Akshay Bhatia,5,218,7,211,2015,total_driving,NA
78,T69,Rod Pampling,3,220,28,192,2015,total_driving,NA
79,136,Nick Watney,7,222,73,149,2015,total_driving,NA
T80,T84,Hideki Matsuyama,6,223,115,108,2015,total_driving,NA
T80,115,Doug Ghim,7,223,116,107,2015,total_driving,NA
T80,T90,Kristoffer Ventura,9,223,44,179,2015,total_driving,NA
T83,T73,Byeong Hun An,8,225,10,215,2015,total_driving,NA
T83,T90,Chandler Phillips,2,225,57,168,2015,total_driving,NA
T83,T69,Brian Stuard,10,225,215,10,2015,total_driving,NA
T83,T97,Alex Cejka,5,225,175,50,2015,total_driving,NA
T83,T80,Ryan Armour,9,225,217,8,2015,total_driving,NA
T88,T90,Graham DeLaet,5,226,36,190,2015,total_driving,NA
T88,T77,Tim Wilkinson,6,226,189,37,2015,total_driving,NA
T88,T86,Brandon Wu,2,226,188,38,2015,total_driving,NA
T91,T88,Hank Lebioda,9,228,104,124,2015,total_driving,NA
T91,79,Charles Howell III,9,228,69,159,2015,total_driving,NA
93,T67,Tyler McCumber,9,229,11,218,2015,total_driving,NA
94,T90,Fabián Gómez,9,230,167,63,2015,total_driving,NA
95,T90,Brendon Todd,11,231,228,3,2015,total_driving,NA
T96,49,Cameron Percy,8,233,61,172,2015,total_driving,NA
T96,T99,Adam Scott,4,233,46,187,2015,total_driving,NA
T96,T80,Luke List,9,233,80,153,2015,total_driving,NA
T96,T86,Russell Henley,8,233,179,54,2015,total_driving,NA
T96,T130,Mackenzie Hughes,8,233,101,132,2015,total_driving,NA
101,T109,J.T. Poston,9,234,175,59,2015,total_driving,NA
102,T64,Vince Covello,8,235,73,162,2015,total_driving,NA
103,T99,Xinjun Zhang,10,236,116,120,2015,total_driving,NA
104,105,K.J. Choi,3,237,233,4,2015,total_driving,NA
T105,107,Tim Herron,4,238,220,18,2015,total_driving,NA
T105,T109,Corey Conners,7,238,186,52,2015,total_driving,NA
T107,108,Keith Mitchell,7,239,135,104,2015,total_driving,NA
T107,T130,Cameron Davis,8,239,22,217,2015,total_driving,NA
T107,T99,Richy Werenski,4,239,45,194,2015,total_driving,NA
T107,T88,Vaughn Taylor,8,239,212,27,2015,total_driving,NA
111,168,Chris Baker,9,240,168,72,2015,total_driving,NA
T112,T112,Jim Herman,8,241,221,20,2015,total_driving,NA
T112,T127,Scott Piercy,8,241,105,136,2015,total_driving,NA
T114,T120,J.J. Henry,5,242,173,69,2015,total_driving,NA
T114,T103,Tyler Duncan,10,242,221,21,2015,total_driving,NA
116,T112,Davis Riley,2,243,83,160,2015,total_driving,NA
T117,T125,Bo Hoag,10,244,127,117,2015,total_driving,NA
T117,T116,Chez Reavie,9,244,228,16,2015,total_driving,NA
119,T116,Matt Kuchar,4,245,238,7,2015,total_driving,NA
T120,223,Paul Casey,4,247,160,87,2015,total_driving,NA
T120,T116,Satoshi Kodaira,6,247,234,13,2015,total_driving,NA
T120,T127,Shawn Stefani,6,247,73,174,2015,total_driving,NA
123,106,Carlos Ortiz,8,248,67,181,2015,total_driving,NA
124,T122,Ben Crane,6,249,207,42,2015,total_driving,NA
125,T130,Tom Lewis,3,252,5,247,2015,total_driving,NA
126,T139,Michael Gligic,9,253,73,180,2015,total_driving,NA
T127,T139,Scott Stallings,8,254,47,207,2015,total_driving,NA
T127,T137,Kyle Stanley,8,254,213,41,2015,total_driving,NA
T129,T137,Henrik Stenson,2,255,202,53,2015,total_driving,NA
T129,T125,Austin Cook,8,255,127,128,2015,total_driving,NA
T131,T120,Beau Hossler,8,256,29,227,2015,total_driving,NA
T131,T122,Patrick Rodgers,10,256,26,230,2015,total_driving,NA
T131,T143,Sebastian Cappelen,8,256,30,226,2015,total_driving,NA
T131,T133,Kurt Kitayama,2,256,3,253,2015,total_driving,NA
T131,T77,Vincent Whaley,7,256,103,153,2015,total_driving,NA
T131,T141,Ryan Brehm,10,256,6,250,2015,total_driving,NA
137,T122,Mark Hubbard,10,257,149,108,2015,total_driving,NA
T138,T163,Brandon Hagy,8,258,22,236,2015,total_driving,NA
T138,T109,Billy Horschel,6,258,196,62,2015,total_driving,NA
T140,T147,Sam Burns,6,259,20,239,2015,total_driving,NA
T140,T133,David Lingmerth,5,259,230,29,2015,total_driving,NA
T142,T187,Bud Cauley,6,262,125,137,2015,total_driving,NA
T142,T143,Cameron Tringale,7,262,55,207,2015,total_driving,NA
144,T143,Rikuya Hoshino,2,264,138,126,2015,total_driving,NA
145,T155,Jonathan Byrd,5,265,72,193,2015,total_driving,NA
T146,T116,Maverick McNealy,9,266,89,177,2015,total_driving,NA
T146,T147,Xander Schauffele,3,266,231,35,2015,total_driving,NA
T148,154,Whee Kim,2,267,180,87,2015,total_driving,NA
T148,T141,Lucas Bjerregaard,3,267,18,249,2015,total_driving,NA
150,T152,Chip McDaniel,2,268,59,209,2015,total_driving,NA
T151,T178,Max Homa,6,269,187,82,2015,total_driving,NA
T151,T112,Bill Haas,6,269,147,122,2015,total_driving,NA
T151,146,J.B. Holmes,3,269,224,45,2015,total_driving,NA
T154,129,Zack Sucher,6,270,24,246,2015,total_driving,NA
T154,T157,Roberto Castro,5,270,183,87,2015,total_driving,NA
156,151,Kevin Tway,6,271,27,244,2015,total_driving,NA
T157,T155,Kevin Chappell,6,272,43,229,2015,total_driving,NA
T157,T152,Dominic Bozzelli,7,272,38,234,2015,total_driving,NA
T159,T147,David Hearn,9,273,206,67,2015,total_driving,NA
T159,174,Jimmy Walker,4,273,92,181,2015,total_driving,NA
161,165,Sangmoon Bae,6,274,64,210,2015,total_driving,NA
162,167,Michael Gellerman,8,275,135,140,2015,total_driving,NA
163,T159,Kevin Kisner,7,277,227,50,2015,total_driving,NA
T164,T159,Justin Thomas,5,278,161,117,2015,total_driving,NA
T164,T187,Troy Merritt,7,278,182,96,2015,total_driving,NA
T164,T163,Freddie Jacobson,3,278,141,137,2015,total_driving,NA
167,T175,Talor Gooch,8,280,122,158,2015,total_driving,NA
168,T103,Andrew Putnam,6,283,181,102,2015,total_driving,NA
T169,T157,Si Woo Kim,8,284,99,185,2015,total_driving,NA
T169,T97,Charley Hoffman,7,284,87,197,2015,total_driving,NA
T169,169,Seamus Power,5,284,83,201,2015,total_driving,NA
172,T133,John Huh,5,285,166,119,2015,total_driving,NA
T173,T172,Jason Day,3,286,80,206,2015,total_driving,NA
T173,T172,Chris Kirk,3,286,199,87,2015,total_driving,NA
T173,T175,Rafael Campos,9,286,67,219,2015,total_driving,NA
176,T159,Nate Lashley,8,287,204,83,2015,total_driving,NA
177,177,Brandt Snedeker,4,288,155,133,2015,total_driving,NA
178,T178,Peter Uihlein,6,289,38,251,2015,total_driving,NA
179,150,Kevin Na,7,290,203,87,2015,total_driving,NA
180,T170,Ben Taylor,10,291,134,157,2015,total_driving,NA
181,162,Anirban Lahiri,8,292,118,174,2015,total_driving,NA
182,T208,Roger Sloan,8,293,158,135,2015,total_driving,NA
T183,182,Johnson Wagner,5,294,207,87,2015,total_driving,NA
T183,T183,Robert Garrigus,5,294,52,242,2015,total_driving,NA
T183,T187,Wes Roach,7,294,151,143,2015,total_driving,NA
186,181,Zach Johnson,7,299,216,83,2015,total_driving,NA
187,191,Mikumu Horikawa,3,303,237,66,2015,total_driving,NA
T188,194,Will Gordon,4,304,64,240,2015,total_driving,NA
T188,210,Rory Sabbatini,7,304,219,85,2015,total_driving,NA
T188,T183,Dylan Frittelli,9,304,193,111,2015,total_driving,NA
191,185,Nelson Ledesma,10,305,57,248,2015,total_driving,NA
192,192,Marc Leishman,5,306,90,216,2015,total_driving,NA
193,166,Joseph Bramlett,7,307,94,213,2015,total_driving,NA
194,195,Joaquin Niemann,8,308,164,144,2015,total_driving,NA
T195,T196,Graeme McDowell,5,311,236,75,2015,total_driving,NA
T195,T201,Bronson Burgoon,8,311,130,181,2015,total_driving,NA
197,T187,Brian Gay,9,312,162,150,2015,total_driving,NA
198,193,Rhein Gibson,9,313,90,223,2015,total_driving,NA
199,T196,Tom Hoge,8,314,185,129,2015,total_driving,NA
200,200,Mark Anderson,7,319,132,187,2015,total_driving,NA
201,204,Smylie Kaufman,3,320,64,256,2015,total_driving,NA
T202,199,Zac Blair,10,322,225,97,2015,total_driving,NA
T202,214,Francesco Molinari,3,322,125,197,2015,total_driving,NA
T204,T170,John Senden,5,324,120,204,2015,total_driving,NA
T204,180,Ben Martin,6,324,223,101,2015,total_driving,NA
T206,T205,James Hahn,6,325,163,162,2015,total_driving,NA
T206,186,Aaron Baddeley,6,325,198,127,2015,total_driving,NA
208,T211,J.J. Spaun,9,330,118,212,2015,total_driving,NA
T209,203,Robert Streb,9,332,141,191,2015,total_driving,NA
T209,T208,Robert Allenby,3,332,164,168,2015,total_driving,NA
211,T211,Martin Trainer,8,339,94,245,2015,total_driving,NA
212,T205,"Ted Potter, Jr.",7,340,151,189,2015,total_driving,NA
213,T201,Chris Stroud,6,341,194,147,2015,total_driving,NA
T214,T205,Rob Oppenheim,10,342,200,142,2015,total_driving,NA
T214,198,Matt Every,7,342,122,220,2015,total_driving,NA
T214,213,Morgan Hoffmann,4,342,143,199,2015,total_driving,NA
217,215,Roberto Díaz,2,345,110,235,2015,total_driving,NA
218,216,Stewart Cink,4,350,112,238,2015,total_driving,NA
219,217,C.T. Pan,5,353,189,164,2015,total_driving,NA
220,T218,Patton Kizzire,9,354,158,196,2015,total_driving,NA
221,222,Hudson Swafford,4,356,183,173,2015,total_driving,NA
222,T218,George McNeill,6,359,145,214,2015,total_driving,NA
223,220,Patrick Reed,4,363,239,124,2015,total_driving,NA
224,221,Jamie Lovemark,4,365,114,251,2015,total_driving,NA
225,224,Luke Donald,2,378,232,146,2015,total_driving,NA
226,226,Bo Van Pelt,7,387,155,232,2015,total_driving,NA
227,225,Davis Love III,3,400,172,228,2015,total_driving,NA
228,228,Arjun Atwal,5,404,173,231,2015,total_driving,NA
T229,231,Daniel Chopra,3,411,157,254,2015,total_driving,NA
T229,227,Kevin Stadler,6,411,217,194,2015,total_driving,NA
231,229,John Rollins,4,414,209,205,2015,total_driving,NA
232,230,Parker McLachlin,4,421,201,220,2015,total_driving,NA
233,232,Peter Malnati,9,422,197,225,2015,total_driving,NA
234,233,Michael Kim,8,435,211,224,2015,total_driving,NA
235,235,Tommy Gainey,4,442,209,233,2015,total_driving,NA
236,234,D.A. Points,4,446,226,220,2015,total_driving,NA
237,236,Ricky Barnes,6,451,214,237,2015,total_driving,NA
238,237,Brendon de Jonge,3,462,205,257,2015,total_driving,NA
239,238,Shugo Imahira,2,490,235,255,2015,total_driving,NA
1,1,Andrew Novak,2,35,17,18,2016,total_driving,NA
2,3,Viktor Hovland,4,63,16,47,2016,total_driving,NA
3,4,Chase Koepka,2,72,34,38,2016,total_driving,NA
4,5,John Oda,2,74,70,4,2016,total_driving,NA
5,6,D.J. Trahan,7,91,47,44,2016,total_driving,NA
6,8,Gary Woodland,4,98,94,4,2016,total_driving,NA
7,9,Branden Grace,4,99,21,78,2016,total_driving,NA
T8,10,Patrick Cantlay,3,103,86,17,2016,total_driving,NA
T8,7,Doc Redman,10,103,77,26,2016,total_driving,NA
10,2,Ryan Moore,5,105,94,11,2016,total_driving,NA
11,13,Scottie Scheffler,8,126,15,111,2016,total_driving,NA
12,T19,Kyoung-Hoon Lee,10,128,106,22,2016,total_driving,NA
13,14,Martin Laird,8,129,42,87,2016,total_driving,NA
14,11,Kevin Streelman,9,130,62,68,2016,total_driving,NA
15,25,Jhonattan Vegas,6,132,24,108,2016,total_driving,NA
T16,15,Nick Taylor,8,133,109,24,2016,total_driving,NA
T16,T23,Brendan Steele,8,133,63,70,2016,total_driving,NA
18,12,Harris English,7,135,36,99,2016,total_driving,NA
T19,T27,Harry Higgs,10,140,79,61,2016,total_driving,NA
T19,T27,Sung Kang,7,140,53,87,2016,total_driving,NA
T21,22,Emiliano Grillo,7,142,110,32,2016,total_driving,NA
T21,18,Bubba Watson,4,142,1,141,2016,total_driving,NA
23,T19,Bryson DeChambeau,3,144,13,131,2016,total_driving,NA
24,T52,Matthew Wolff,5,145,40,105,2016,total_driving,NA
25,29,Joel Dahmen,8,149,100,49,2016,total_driving,NA
26,16,Jason Kokrak,5,153,8,145,2016,total_driving,NA
27,17,Josh Teater,6,156,83,73,2016,total_driving,NA
28,T23,Cameron Champ,7,157,2,155,2016,total_driving,NA
29,33,Ryan Palmer,5,160,146,14,2016,total_driving,NA
30,T35,Adam Hadwin,5,164,121,43,2016,total_driving,NA
31,26,Sungjae Im,8,165,50,115,2016,total_driving,NA
32,31,Henrik Norlander,10,168,132,36,2016,total_driving,NA
T33,38,Boo Weekley,5,169,147,22,2016,total_driving,NA
T33,T35,Harold Varner III,7,169,18,151,2016,total_driving,NA
35,37,Lanto Griffin,10,170,40,130,2016,total_driving,NA
36,T19,Lucas Glover,7,174,98,76,2016,total_driving,NA
37,34,Scott Brown,9,175,151,24,2016,total_driving,NA
38,T44,Sebastián Muñoz,10,176,60,116,2016,total_driving,NA
T39,40,Daniel Berger,6,177,56,121,2016,total_driving,NA
T39,42,Keegan Bradley,7,177,71,106,2016,total_driving,NA
41,39,Chesson Hadley,7,179,106,73,2016,total_driving,NA
42,43,Webb Simpson,3,182,170,12,2016,total_driving,NA
43,48,Danny Lee,7,185,9,176,2016,total_driving,NA
44,T50,Pat Perez,6,186,130,56,2016,total_driving,NA
45,T52,Matthew NeSmith,9,188,154,34,2016,total_driving,NA
46,T99,Sepp Straka,10,191,92,99,2016,total_driving,NA
T47,T90,Isaiah Salinda,3,192,14,178,2016,total_driving,NA
T47,T56,John Merrick,4,192,135,57,2016,total_driving,NA
T49,T50,Jim Furyk,3,193,192,1,2016,total_driving,NA
T49,55,Chad Campbell,4,193,178,15,2016,total_driving,NA
T49,T44,Wyndham Clark,7,193,32,161,2016,total_driving,NA
52,32,Alex Noren,4,195,108,87,2016,total_driving,NA
53,NA,Rickie Fowler,2,196,194,2,2016,total_driving,NA
T54,T56,Tony Finau,5,198,12,186,2016,total_driving,NA
T54,T62,Phil Mickelson,5,198,31,167,2016,total_driving,NA
T54,T62,Aaron Wise,7,198,51,147,2016,total_driving,NA
T54,T69,Chase Seiffert,9,198,127,71,2016,total_driving,NA
T58,T73,Abraham Ancer,8,199,113,86,2016,total_driving,NA
T58,61,Adam Schenk,10,199,33,166,2016,total_driving,NA
T58,T64,Scott Harrington,9,199,34,165,2016,total_driving,NA
T61,T52,Brian Harman,8,200,143,57,2016,total_driving,NA
T61,47,Jason Dufner,7,200,140,60,2016,total_driving,NA
T61,59,Cameron Smith,6,200,77,123,2016,total_driving,NA
T64,46,Kramer Hickok,9,201,124,77,2016,total_driving,NA
T64,60,Matt Jones,8,201,49,152,2016,total_driving,NA
66,30,Robby Shelton,10,202,88,114,2016,total_driving,NA
T67,83,Grayson Murray,6,203,4,199,2016,total_driving,NA
T67,T73,Russell Knox,8,203,138,65,2016,total_driving,NA
69,41,Denny McCarthy,8,204,101,103,2016,total_driving,NA
70,T80,Sam Ryder,10,209,53,156,2016,total_driving,NA
71,58,Brice Garnett,8,214,150,64,2016,total_driving,NA
72,66,Michael Thompson,7,215,175,40,2016,total_driving,NA
73,76,Collin Morikawa,6,216,168,48,2016,total_driving,NA
T74,T69,Derek Ernst,4,217,80,137,2016,total_driving,NA
T74,T67,Adam Long,10,217,189,28,2016,total_driving,NA
T74,96,Andrew Landry,9,217,171,46,2016,total_driving,NA
77,T84,Akshay Bhatia,5,218,7,211,2016,total_driving,NA
78,T69,Rod Pampling,3,220,28,192,2016,total_driving,NA
79,136,Nick Watney,7,222,73,149,2016,total_driving,NA
T80,T84,Hideki Matsuyama,6,223,115,108,2016,total_driving,NA
T80,115,Doug Ghim,7,223,116,107,2016,total_driving,NA
T80,T90,Kristoffer Ventura,9,223,44,179,2016,total_driving,NA
T83,T73,Byeong Hun An,8,225,10,215,2016,total_driving,NA
T83,T90,Chandler Phillips,2,225,57,168,2016,total_driving,NA
T83,T69,Brian Stuard,10,225,215,10,2016,total_driving,NA
T83,T97,Alex Cejka,5,225,175,50,2016,total_driving,NA
T83,T80,Ryan Armour,9,225,217,8,2016,total_driving,NA
T88,T90,Graham DeLaet,5,226,36,190,2016,total_driving,NA
T88,T77,Tim Wilkinson,6,226,189,37,2016,total_driving,NA
T88,T86,Brandon Wu,2,226,188,38,2016,total_driving,NA
T91,T88,Hank Lebioda,9,228,104,124,2016,total_driving,NA
T91,79,Charles Howell III,9,228,69,159,2016,total_driving,NA
93,T67,Tyler McCumber,9,229,11,218,2016,total_driving,NA
94,T90,Fabián Gómez,9,230,167,63,2016,total_driving,NA
95,T90,Brendon Todd,11,231,228,3,2016,total_driving,NA
T96,49,Cameron Percy,8,233,61,172,2016,total_driving,NA
T96,T99,Adam Scott,4,233,46,187,2016,total_driving,NA
T96,T80,Luke List,9,233,80,153,2016,total_driving,NA
T96,T86,Russell Henley,8,233,179,54,2016,total_driving,NA
T96,T130,Mackenzie Hughes,8,233,101,132,2016,total_driving,NA
101,T109,J.T. Poston,9,234,175,59,2016,total_driving,NA
102,T64,Vince Covello,8,235,73,162,2016,total_driving,NA
103,T99,Xinjun Zhang,10,236,116,120,2016,total_driving,NA
104,105,K.J. Choi,3,237,233,4,2016,total_driving,NA
T105,107,Tim Herron,4,238,220,18,2016,total_driving,NA
T105,T109,Corey Conners,7,238,186,52,2016,total_driving,NA
T107,108,Keith Mitchell,7,239,135,104,2016,total_driving,NA
T107,T130,Cameron Davis,8,239,22,217,2016,total_driving,NA
T107,T99,Richy Werenski,4,239,45,194,2016,total_driving,NA
T107,T88,Vaughn Taylor,8,239,212,27,2016,total_driving,NA
111,168,Chris Baker,9,240,168,72,2016,total_driving,NA
T112,T112,Jim Herman,8,241,221,20,2016,total_driving,NA
T112,T127,Scott Piercy,8,241,105,136,2016,total_driving,NA
T114,T120,J.J. Henry,5,242,173,69,2016,total_driving,NA
T114,T103,Tyler Duncan,10,242,221,21,2016,total_driving,NA
116,T112,Davis Riley,2,243,83,160,2016,total_driving,NA
T117,T125,Bo Hoag,10,244,127,117,2016,total_driving,NA
T117,T116,Chez Reavie,9,244,228,16,2016,total_driving,NA
119,T116,Matt Kuchar,4,245,238,7,2016,total_driving,NA
T120,223,Paul Casey,4,247,160,87,2016,total_driving,NA
T120,T116,Satoshi Kodaira,6,247,234,13,2016,total_driving,NA
T120,T127,Shawn Stefani,6,247,73,174,2016,total_driving,NA
123,106,Carlos Ortiz,8,248,67,181,2016,total_driving,NA
124,T122,Ben Crane,6,249,207,42,2016,total_driving,NA
125,T130,Tom Lewis,3,252,5,247,2016,total_driving,NA
126,T139,Michael Gligic,9,253,73,180,2016,total_driving,NA
T127,T139,Scott Stallings,8,254,47,207,2016,total_driving,NA
T127,T137,Kyle Stanley,8,254,213,41,2016,total_driving,NA
T129,T137,Henrik Stenson,2,255,202,53,2016,total_driving,NA
T129,T125,Austin Cook,8,255,127,128,2016,total_driving,NA
T131,T120,Beau Hossler,8,256,29,227,2016,total_driving,NA
T131,T122,Patrick Rodgers,10,256,26,230,2016,total_driving,NA
T131,T143,Sebastian Cappelen,8,256,30,226,2016,total_driving,NA
T131,T133,Kurt Kitayama,2,256,3,253,2016,total_driving,NA
T131,T77,Vincent Whaley,7,256,103,153,2016,total_driving,NA
T131,T141,Ryan Brehm,10,256,6,250,2016,total_driving,NA
137,T122,Mark Hubbard,10,257,149,108,2016,total_driving,NA
T138,T163,Brandon Hagy,8,258,22,236,2016,total_driving,NA
T138,T109,Billy Horschel,6,258,196,62,2016,total_driving,NA
T140,T147,Sam Burns,6,259,20,239,2016,total_driving,NA
T140,T133,David Lingmerth,5,259,230,29,2016,total_driving,NA
T142,T187,Bud Cauley,6,262,125,137,2016,total_driving,NA
T142,T143,Cameron Tringale,7,262,55,207,2016,total_driving,NA
144,T143,Rikuya Hoshino,2,264,138,126,2016,total_driving,NA
145,T155,Jonathan Byrd,5,265,72,193,2016,total_driving,NA
T146,T116,Maverick McNealy,9,266,89,177,2016,total_driving,NA
T146,T147,Xander Schauffele,3,266,231,35,2016,total_driving,NA
T148,154,Whee Kim,2,267,180,87,2016,total_driving,NA
T148,T141,Lucas Bjerregaard,3,267,18,249,2016,total_driving,NA
150,T152,Chip McDaniel,2,268,59,209,2016,total_driving,NA
T151,T178,Max Homa,6,269,187,82,2016,total_driving,NA
T151,T112,Bill Haas,6,269,147,122,2016,total_driving,NA
T151,146,J.B. Holmes,3,269,224,45,2016,total_driving,NA
T154,129,Zack Sucher,6,270,24,246,2016,total_driving,NA
T154,T157,Roberto Castro,5,270,183,87,2016,total_driving,NA
156,151,Kevin Tway,6,271,27,244,2016,total_driving,NA
T157,T155,Kevin Chappell,6,272,43,229,2016,total_driving,NA
T157,T152,Dominic Bozzelli,7,272,38,234,2016,total_driving,NA
T159,T147,David Hearn,9,273,206,67,2016,total_driving,NA
T159,174,Jimmy Walker,4,273,92,181,2016,total_driving,NA
161,165,Sangmoon Bae,6,274,64,210,2016,total_driving,NA
162,167,Michael Gellerman,8,275,135,140,2016,total_driving,NA
163,T159,Kevin Kisner,7,277,227,50,2016,total_driving,NA
T164,T159,Justin Thomas,5,278,161,117,2016,total_driving,NA
T164,T187,Troy Merritt,7,278,182,96,2016,total_driving,NA
T164,T163,Freddie Jacobson,3,278,141,137,2016,total_driving,NA
167,T175,Talor Gooch,8,280,122,158,2016,total_driving,NA
168,T103,Andrew Putnam,6,283,181,102,2016,total_driving,NA
T169,T157,Si Woo Kim,8,284,99,185,2016,total_driving,NA
T169,T97,Charley Hoffman,7,284,87,197,2016,total_driving,NA
T169,169,Seamus Power,5,284,83,201,2016,total_driving,NA
172,T133,John Huh,5,285,166,119,2016,total_driving,NA
T173,T172,Jason Day,3,286,80,206,2016,total_driving,NA
T173,T172,Chris Kirk,3,286,199,87,2016,total_driving,NA
T173,T175,Rafael Campos,9,286,67,219,2016,total_driving,NA
176,T159,Nate Lashley,8,287,204,83,2016,total_driving,NA
177,177,Brandt Snedeker,4,288,155,133,2016,total_driving,NA
178,T178,Peter Uihlein,6,289,38,251,2016,total_driving,NA
179,150,Kevin Na,7,290,203,87,2016,total_driving,NA
180,T170,Ben Taylor,10,291,134,157,2016,total_driving,NA
181,162,Anirban Lahiri,8,292,118,174,2016,total_driving,NA
182,T208,Roger Sloan,8,293,158,135,2016,total_driving,NA
T183,182,Johnson Wagner,5,294,207,87,2016,total_driving,NA
T183,T183,Robert Garrigus,5,294,52,242,2016,total_driving,NA
T183,T187,Wes Roach,7,294,151,143,2016,total_driving,NA
186,181,Zach Johnson,7,299,216,83,2016,total_driving,NA
187,191,Mikumu Horikawa,3,303,237,66,2016,total_driving,NA
T188,194,Will Gordon,4,304,64,240,2016,total_driving,NA
T188,210,Rory Sabbatini,7,304,219,85,2016,total_driving,NA
T188,T183,Dylan Frittelli,9,304,193,111,2016,total_driving,NA
191,185,Nelson Ledesma,10,305,57,248,2016,total_driving,NA
192,192,Marc Leishman,5,306,90,216,2016,total_driving,NA
193,166,Joseph Bramlett,7,307,94,213,2016,total_driving,NA
194,195,Joaquin Niemann,8,308,164,144,2016,total_driving,NA
T195,T196,Graeme McDowell,5,311,236,75,2016,total_driving,NA
T195,T201,Bronson Burgoon,8,311,130,181,2016,total_driving,NA
197,T187,Brian Gay,9,312,162,150,2016,total_driving,NA
198,193,Rhein Gibson,9,313,90,223,2016,total_driving,NA
199,T196,Tom Hoge,8,314,185,129,2016,total_driving,NA
200,200,Mark Anderson,7,319,132,187,2016,total_driving,NA
201,204,Smylie Kaufman,3,320,64,256,2016,total_driving,NA
T202,199,Zac Blair,10,322,225,97,2016,total_driving,NA
T202,214,Francesco Molinari,3,322,125,197,2016,total_driving,NA
T204,T170,John Senden,5,324,120,204,2016,total_driving,NA
T204,180,Ben Martin,6,324,223,101,2016,total_driving,NA
T206,T205,James Hahn,6,325,163,162,2016,total_driving,NA
T206,186,Aaron Baddeley,6,325,198,127,2016,total_driving,NA
208,T211,J.J. Spaun,9,330,118,212,2016,total_driving,NA
T209,203,Robert Streb,9,332,141,191,2016,total_driving,NA
T209,T208,Robert Allenby,3,332,164,168,2016,total_driving,NA
211,T211,Martin Trainer,8,339,94,245,2016,total_driving,NA
212,T205,"Ted Potter, Jr.",7,340,151,189,2016,total_driving,NA
213,T201,Chris Stroud,6,341,194,147,2016,total_driving,NA
T214,T205,Rob Oppenheim,10,342,200,142,2016,total_driving,NA
T214,198,Matt Every,7,342,122,220,2016,total_driving,NA
T214,213,Morgan Hoffmann,4,342,143,199,2016,total_driving,NA
217,215,Roberto Díaz,2,345,110,235,2016,total_driving,NA
218,216,Stewart Cink,4,350,112,238,2016,total_driving,NA
219,217,C.T. Pan,5,353,189,164,2016,total_driving,NA
220,T218,Patton Kizzire,9,354,158,196,2016,total_driving,NA
221,222,Hudson Swafford,4,356,183,173,2016,total_driving,NA
222,T218,George McNeill,6,359,145,214,2016,total_driving,NA
223,220,Patrick Reed,4,363,239,124,2016,total_driving,NA
224,221,Jamie Lovemark,4,365,114,251,2016,total_driving,NA
225,224,Luke Donald,2,378,232,146,2016,total_driving,NA
226,226,Bo Van Pelt,7,387,155,232,2016,total_driving,NA
227,225,Davis Love III,3,400,172,228,2016,total_driving,NA
228,228,Arjun Atwal,5,404,173,231,2016,total_driving,NA
T229,231,Daniel Chopra,3,411,157,254,2016,total_driving,NA
T229,227,Kevin Stadler,6,411,217,194,2016,total_driving,NA
231,229,John Rollins,4,414,209,205,2016,total_driving,NA
232,230,Parker McLachlin,4,421,201,220,2016,total_driving,NA
233,232,Peter Malnati,9,422,197,225,2016,total_driving,NA
234,233,Michael Kim,8,435,211,224,2016,total_driving,NA
235,235,Tommy Gainey,4,442,209,233,2016,total_driving,NA
236,234,D.A. Points,4,446,226,220,2016,total_driving,NA
237,236,Ricky Barnes,6,451,214,237,2016,total_driving,NA
238,237,Brendon de Jonge,3,462,205,257,2016,total_driving,NA
239,238,Shugo Imahira,2,490,235,255,2016,total_driving,NA
1,1,Andrew Novak,2,35,17,18,2017,total_driving,NA
2,3,Viktor Hovland,4,63,16,47,2017,total_driving,NA
3,4,Chase Koepka,2,72,34,38,2017,total_driving,NA
4,5,John Oda,2,74,70,4,2017,total_driving,NA
5,6,D.J. Trahan,7,91,47,44,2017,total_driving,NA
6,8,Gary Woodland,4,98,94,4,2017,total_driving,NA
7,9,Branden Grace,4,99,21,78,2017,total_driving,NA
T8,10,Patrick Cantlay,3,103,86,17,2017,total_driving,NA
T8,7,Doc Redman,10,103,77,26,2017,total_driving,NA
10,2,Ryan Moore,5,105,94,11,2017,total_driving,NA
11,13,Scottie Scheffler,8,126,15,111,2017,total_driving,NA
12,T19,Kyoung-Hoon Lee,10,128,106,22,2017,total_driving,NA
13,14,Martin Laird,8,129,42,87,2017,total_driving,NA
14,11,Kevin Streelman,9,130,62,68,2017,total_driving,NA
15,25,Jhonattan Vegas,6,132,24,108,2017,total_driving,NA
T16,15,Nick Taylor,8,133,109,24,2017,total_driving,NA
T16,T23,Brendan Steele,8,133,63,70,2017,total_driving,NA
18,12,Harris English,7,135,36,99,2017,total_driving,NA
T19,T27,Harry Higgs,10,140,79,61,2017,total_driving,NA
T19,T27,Sung Kang,7,140,53,87,2017,total_driving,NA
T21,22,Emiliano Grillo,7,142,110,32,2017,total_driving,NA
T21,18,Bubba Watson,4,142,1,141,2017,total_driving,NA
23,T19,Bryson DeChambeau,3,144,13,131,2017,total_driving,NA
24,T52,Matthew Wolff,5,145,40,105,2017,total_driving,NA
25,29,Joel Dahmen,8,149,100,49,2017,total_driving,NA
26,16,Jason Kokrak,5,153,8,145,2017,total_driving,NA
27,17,Josh Teater,6,156,83,73,2017,total_driving,NA
28,T23,Cameron Champ,7,157,2,155,2017,total_driving,NA
29,33,Ryan Palmer,5,160,146,14,2017,total_driving,NA
30,T35,Adam Hadwin,5,164,121,43,2017,total_driving,NA
31,26,Sungjae Im,8,165,50,115,2017,total_driving,NA
32,31,Henrik Norlander,10,168,132,36,2017,total_driving,NA
T33,38,Boo Weekley,5,169,147,22,2017,total_driving,NA
T33,T35,Harold Varner III,7,169,18,151,2017,total_driving,NA
35,37,Lanto Griffin,10,170,40,130,2017,total_driving,NA
36,T19,Lucas Glover,7,174,98,76,2017,total_driving,NA
37,34,Scott Brown,9,175,151,24,2017,total_driving,NA
38,T44,Sebastián Muñoz,10,176,60,116,2017,total_driving,NA
T39,40,Daniel Berger,6,177,56,121,2017,total_driving,NA
T39,42,Keegan Bradley,7,177,71,106,2017,total_driving,NA
41,39,Chesson Hadley,7,179,106,73,2017,total_driving,NA
42,43,Webb Simpson,3,182,170,12,2017,total_driving,NA
43,48,Danny Lee,7,185,9,176,2017,total_driving,NA
44,T50,Pat Perez,6,186,130,56,2017,total_driving,NA
45,T52,Matthew NeSmith,9,188,154,34,2017,total_driving,NA
46,T99,Sepp Straka,10,191,92,99,2017,total_driving,NA
T47,T90,Isaiah Salinda,3,192,14,178,2017,total_driving,NA
T47,T56,John Merrick,4,192,135,57,2017,total_driving,NA
T49,T50,Jim Furyk,3,193,192,1,2017,total_driving,NA
T49,55,Chad Campbell,4,193,178,15,2017,total_driving,NA
T49,T44,Wyndham Clark,7,193,32,161,2017,total_driving,NA
52,32,Alex Noren,4,195,108,87,2017,total_driving,NA
53,NA,Rickie Fowler,2,196,194,2,2017,total_driving,NA
T54,T56,Tony Finau,5,198,12,186,2017,total_driving,NA
T54,T62,Phil Mickelson,5,198,31,167,2017,total_driving,NA
T54,T62,Aaron Wise,7,198,51,147,2017,total_driving,NA
T54,T69,Chase Seiffert,9,198,127,71,2017,total_driving,NA
T58,T73,Abraham Ancer,8,199,113,86,2017,total_driving,NA
T58,61,Adam Schenk,10,199,33,166,2017,total_driving,NA
T58,T64,Scott Harrington,9,199,34,165,2017,total_driving,NA
T61,T52,Brian Harman,8,200,143,57,2017,total_driving,NA
T61,47,Jason Dufner,7,200,140,60,2017,total_driving,NA
T61,59,Cameron Smith,6,200,77,123,2017,total_driving,NA
T64,46,Kramer Hickok,9,201,124,77,2017,total_driving,NA
T64,60,Matt Jones,8,201,49,152,2017,total_driving,NA
66,30,Robby Shelton,10,202,88,114,2017,total_driving,NA
T67,83,Grayson Murray,6,203,4,199,2017,total_driving,NA
T67,T73,Russell Knox,8,203,138,65,2017,total_driving,NA
69,41,Denny McCarthy,8,204,101,103,2017,total_driving,NA
70,T80,Sam Ryder,10,209,53,156,2017,total_driving,NA
71,58,Brice Garnett,8,214,150,64,2017,total_driving,NA
72,66,Michael Thompson,7,215,175,40,2017,total_driving,NA
73,76,Collin Morikawa,6,216,168,48,2017,total_driving,NA
T74,T69,Derek Ernst,4,217,80,137,2017,total_driving,NA
T74,T67,Adam Long,10,217,189,28,2017,total_driving,NA
T74,96,Andrew Landry,9,217,171,46,2017,total_driving,NA
77,T84,Akshay Bhatia,5,218,7,211,2017,total_driving,NA
78,T69,Rod Pampling,3,220,28,192,2017,total_driving,NA
79,136,Nick Watney,7,222,73,149,2017,total_driving,NA
T80,T84,Hideki Matsuyama,6,223,115,108,2017,total_driving,NA
T80,115,Doug Ghim,7,223,116,107,2017,total_driving,NA
T80,T90,Kristoffer Ventura,9,223,44,179,2017,total_driving,NA
T83,T73,Byeong Hun An,8,225,10,215,2017,total_driving,NA
T83,T90,Chandler Phillips,2,225,57,168,2017,total_driving,NA
T83,T69,Brian Stuard,10,225,215,10,2017,total_driving,NA
T83,T97,Alex Cejka,5,225,175,50,2017,total_driving,NA
T83,T80,Ryan Armour,9,225,217,8,2017,total_driving,NA
T88,T90,Graham DeLaet,5,226,36,190,2017,total_driving,NA
T88,T77,Tim Wilkinson,6,226,189,37,2017,total_driving,NA
T88,T86,Brandon Wu,2,226,188,38,2017,total_driving,NA
T91,T88,Hank Lebioda,9,228,104,124,2017,total_driving,NA
T91,79,Charles Howell III,9,228,69,159,2017,total_driving,NA
93,T67,Tyler McCumber,9,229,11,218,2017,total_driving,NA
94,T90,Fabián Gómez,9,230,167,63,2017,total_driving,NA
95,T90,Brendon Todd,11,231,228,3,2017,total_driving,NA
T96,49,Cameron Percy,8,233,61,172,2017,total_driving,NA
T96,T99,Adam Scott,4,233,46,187,2017,total_driving,NA
T96,T80,Luke List,9,233,80,153,2017,total_driving,NA
T96,T86,Russell Henley,8,233,179,54,2017,total_driving,NA
T96,T130,Mackenzie Hughes,8,233,101,132,2017,total_driving,NA
101,T109,J.T. Poston,9,234,175,59,2017,total_driving,NA
102,T64,Vince Covello,8,235,73,162,2017,total_driving,NA
103,T99,Xinjun Zhang,10,236,116,120,2017,total_driving,NA
104,105,K.J. Choi,3,237,233,4,2017,total_driving,NA
T105,107,Tim Herron,4,238,220,18,2017,total_driving,NA
T105,T109,Corey Conners,7,238,186,52,2017,total_driving,NA
T107,108,Keith Mitchell,7,239,135,104,2017,total_driving,NA
T107,T130,Cameron Davis,8,239,22,217,2017,total_driving,NA
T107,T99,Richy Werenski,4,239,45,194,2017,total_driving,NA
T107,T88,Vaughn Taylor,8,239,212,27,2017,total_driving,NA
111,168,Chris Baker,9,240,168,72,2017,total_driving,NA
T112,T112,Jim Herman,8,241,221,20,2017,total_driving,NA
T112,T127,Scott Piercy,8,241,105,136,2017,total_driving,NA
T114,T120,J.J. Henry,5,242,173,69,2017,total_driving,NA
T114,T103,Tyler Duncan,10,242,221,21,2017,total_driving,NA
116,T112,Davis Riley,2,243,83,160,2017,total_driving,NA
T117,T125,Bo Hoag,10,244,127,117,2017,total_driving,NA
T117,T116,Chez Reavie,9,244,228,16,2017,total_driving,NA
119,T116,Matt Kuchar,4,245,238,7,2017,total_driving,NA
T120,223,Paul Casey,4,247,160,87,2017,total_driving,NA
T120,T116,Satoshi Kodaira,6,247,234,13,2017,total_driving,NA
T120,T127,Shawn Stefani,6,247,73,174,2017,total_driving,NA
123,106,Carlos Ortiz,8,248,67,181,2017,total_driving,NA
124,T122,Ben Crane,6,249,207,42,2017,total_driving,NA
125,T130,Tom Lewis,3,252,5,247,2017,total_driving,NA
126,T139,Michael Gligic,9,253,73,180,2017,total_driving,NA
T127,T139,Scott Stallings,8,254,47,207,2017,total_driving,NA
T127,T137,Kyle Stanley,8,254,213,41,2017,total_driving,NA
T129,T137,Henrik Stenson,2,255,202,53,2017,total_driving,NA
T129,T125,Austin Cook,8,255,127,128,2017,total_driving,NA
T131,T120,Beau Hossler,8,256,29,227,2017,total_driving,NA
T131,T122,Patrick Rodgers,10,256,26,230,2017,total_driving,NA
T131,T143,Sebastian Cappelen,8,256,30,226,2017,total_driving,NA
T131,T133,Kurt Kitayama,2,256,3,253,2017,total_driving,NA
T131,T77,Vincent Whaley,7,256,103,153,2017,total_driving,NA
T131,T141,Ryan Brehm,10,256,6,250,2017,total_driving,NA
137,T122,Mark Hubbard,10,257,149,108,2017,total_driving,NA
T138,T163,Brandon Hagy,8,258,22,236,2017,total_driving,NA
T138,T109,Billy Horschel,6,258,196,62,2017,total_driving,NA
T140,T147,Sam Burns,6,259,20,239,2017,total_driving,NA
T140,T133,David Lingmerth,5,259,230,29,2017,total_driving,NA
T142,T187,Bud Cauley,6,262,125,137,2017,total_driving,NA
T142,T143,Cameron Tringale,7,262,55,207,2017,total_driving,NA
144,T143,Rikuya Hoshino,2,264,138,126,2017,total_driving,NA
145,T155,Jonathan Byrd,5,265,72,193,2017,total_driving,NA
T146,T116,Maverick McNealy,9,266,89,177,2017,total_driving,NA
T146,T147,Xander Schauffele,3,266,231,35,2017,total_driving,NA
T148,154,Whee Kim,2,267,180,87,2017,total_driving,NA
T148,T141,Lucas Bjerregaard,3,267,18,249,2017,total_driving,NA
150,T152,Chip McDaniel,2,268,59,209,2017,total_driving,NA
T151,T178,Max Homa,6,269,187,82,2017,total_driving,NA
T151,T112,Bill Haas,6,269,147,122,2017,total_driving,NA
T151,146,J.B. Holmes,3,269,224,45,2017,total_driving,NA
T154,129,Zack Sucher,6,270,24,246,2017,total_driving,NA
T154,T157,Roberto Castro,5,270,183,87,2017,total_driving,NA
156,151,Kevin Tway,6,271,27,244,2017,total_driving,NA
T157,T155,Kevin Chappell,6,272,43,229,2017,total_driving,NA
T157,T152,Dominic Bozzelli,7,272,38,234,2017,total_driving,NA
T159,T147,David Hearn,9,273,206,67,2017,total_driving,NA
T159,174,Jimmy Walker,4,273,92,181,2017,total_driving,NA
161,165,Sangmoon Bae,6,274,64,210,2017,total_driving,NA
162,167,Michael Gellerman,8,275,135,140,2017,total_driving,NA
163,T159,Kevin Kisner,7,277,227,50,2017,total_driving,NA
T164,T159,Justin Thomas,5,278,161,117,2017,total_driving,NA
T164,T187,Troy Merritt,7,278,182,96,2017,total_driving,NA
T164,T163,Freddie Jacobson,3,278,141,137,2017,total_driving,NA
167,T175,Talor Gooch,8,280,122,158,2017,total_driving,NA
168,T103,Andrew Putnam,6,283,181,102,2017,total_driving,NA
T169,T157,Si Woo Kim,8,284,99,185,2017,total_driving,NA
T169,T97,Charley Hoffman,7,284,87,197,2017,total_driving,NA
T169,169,Seamus Power,5,284,83,201,2017,total_driving,NA
172,T133,John Huh,5,285,166,119,2017,total_driving,NA
T173,T172,Jason Day,3,286,80,206,2017,total_driving,NA
T173,T172,Chris Kirk,3,286,199,87,2017,total_driving,NA
T173,T175,Rafael Campos,9,286,67,219,2017,total_driving,NA
176,T159,Nate Lashley,8,287,204,83,2017,total_driving,NA
177,177,Brandt Snedeker,4,288,155,133,2017,total_driving,NA
178,T178,Peter Uihlein,6,289,38,251,2017,total_driving,NA
179,150,Kevin Na,7,290,203,87,2017,total_driving,NA
180,T170,Ben Taylor,10,291,134,157,2017,total_driving,NA
181,162,Anirban Lahiri,8,292,118,174,2017,total_driving,NA
182,T208,Roger Sloan,8,293,158,135,2017,total_driving,NA
T183,182,Johnson Wagner,5,294,207,87,2017,total_driving,NA
T183,T183,Robert Garrigus,5,294,52,242,2017,total_driving,NA
T183,T187,Wes Roach,7,294,151,143,2017,total_driving,NA
186,181,Zach Johnson,7,299,216,83,2017,total_driving,NA
187,191,Mikumu Horikawa,3,303,237,66,2017,total_driving,NA
T188,194,Will Gordon,4,304,64,240,2017,total_driving,NA
T188,210,Rory Sabbatini,7,304,219,85,2017,total_driving,NA
T188,T183,Dylan Frittelli,9,304,193,111,2017,total_driving,NA
191,185,Nelson Ledesma,10,305,57,248,2017,total_driving,NA
192,192,Marc Leishman,5,306,90,216,2017,total_driving,NA
193,166,Joseph Bramlett,7,307,94,213,2017,total_driving,NA
194,195,Joaquin Niemann,8,308,164,144,2017,total_driving,NA
T195,T196,Graeme McDowell,5,311,236,75,2017,total_driving,NA
T195,T201,Bronson Burgoon,8,311,130,181,2017,total_driving,NA
197,T187,Brian Gay,9,312,162,150,2017,total_driving,NA
198,193,Rhein Gibson,9,313,90,223,2017,total_driving,NA
199,T196,Tom Hoge,8,314,185,129,2017,total_driving,NA
200,200,Mark Anderson,7,319,132,187,2017,total_driving,NA
201,204,Smylie Kaufman,3,320,64,256,2017,total_driving,NA
T202,199,Zac Blair,10,322,225,97,2017,total_driving,NA
T202,214,Francesco Molinari,3,322,125,197,2017,total_driving,NA
T204,T170,John Senden,5,324,120,204,2017,total_driving,NA
T204,180,Ben Martin,6,324,223,101,2017,total_driving,NA
T206,T205,James Hahn,6,325,163,162,2017,total_driving,NA
T206,186,Aaron Baddeley,6,325,198,127,2017,total_driving,NA
208,T211,J.J. Spaun,9,330,118,212,2017,total_driving,NA
T209,203,Robert Streb,9,332,141,191,2017,total_driving,NA
T209,T208,Robert Allenby,3,332,164,168,2017,total_driving,NA
211,T211,Martin Trainer,8,339,94,245,2017,total_driving,NA
212,T205,"Ted Potter, Jr.",7,340,151,189,2017,total_driving,NA
213,T201,Chris Stroud,6,341,194,147,2017,total_driving,NA
T214,T205,Rob Oppenheim,10,342,200,142,2017,total_driving,NA
T214,198,Matt Every,7,342,122,220,2017,total_driving,NA
T214,213,Morgan Hoffmann,4,342,143,199,2017,total_driving,NA
217,215,Roberto Díaz,2,345,110,235,2017,total_driving,NA
218,216,Stewart Cink,4,350,112,238,2017,total_driving,NA
219,217,C.T. Pan,5,353,189,164,2017,total_driving,NA
220,T218,Patton Kizzire,9,354,158,196,2017,total_driving,NA
221,222,Hudson Swafford,4,356,183,173,2017,total_driving,NA
222,T218,George McNeill,6,359,145,214,2017,total_driving,NA
223,220,Patrick Reed,4,363,239,124,2017,total_driving,NA
224,221,Jamie Lovemark,4,365,114,251,2017,total_driving,NA
225,224,Luke Donald,2,378,232,146,2017,total_driving,NA
226,226,Bo Van Pelt,7,387,155,232,2017,total_driving,NA
227,225,Davis Love III,3,400,172,228,2017,total_driving,NA
228,228,Arjun Atwal,5,404,173,231,2017,total_driving,NA
T229,231,Daniel Chopra,3,411,157,254,2017,total_driving,NA
T229,227,Kevin Stadler,6,411,217,194,2017,total_driving,NA
231,229,John Rollins,4,414,209,205,2017,total_driving,NA
232,230,Parker McLachlin,4,421,201,220,2017,total_driving,NA
233,232,Peter Malnati,9,422,197,225,2017,total_driving,NA
234,233,Michael Kim,8,435,211,224,2017,total_driving,NA
235,235,Tommy Gainey,4,442,209,233,2017,total_driving,NA
236,234,D.A. Points,4,446,226,220,2017,total_driving,NA
237,236,Ricky Barnes,6,451,214,237,2017,total_driving,NA
238,237,Brendon de Jonge,3,462,205,257,2017,total_driving,NA
239,238,Shugo Imahira,2,490,235,255,2017,total_driving,NA
1,1,Andrew Novak,2,35,17,18,2018,total_driving,NA
2,3,Viktor Hovland,4,63,16,47,2018,total_driving,NA
3,4,Chase Koepka,2,72,34,38,2018,total_driving,NA
4,5,John Oda,2,74,70,4,2018,total_driving,NA
5,6,D.J. Trahan,7,91,47,44,2018,total_driving,NA
6,8,Gary Woodland,4,98,94,4,2018,total_driving,NA
7,9,Branden Grace,4,99,21,78,2018,total_driving,NA
T8,10,Patrick Cantlay,3,103,86,17,2018,total_driving,NA
T8,7,Doc Redman,10,103,77,26,2018,total_driving,NA
10,2,Ryan Moore,5,105,94,11,2018,total_driving,NA
11,13,Scottie Scheffler,8,126,15,111,2018,total_driving,NA
12,T19,Kyoung-Hoon Lee,10,128,106,22,2018,total_driving,NA
13,14,Martin Laird,8,129,42,87,2018,total_driving,NA
14,11,Kevin Streelman,9,130,62,68,2018,total_driving,NA
15,25,Jhonattan Vegas,6,132,24,108,2018,total_driving,NA
T16,15,Nick Taylor,8,133,109,24,2018,total_driving,NA
T16,T23,Brendan Steele,8,133,63,70,2018,total_driving,NA
18,12,Harris English,7,135,36,99,2018,total_driving,NA
T19,T27,Harry Higgs,10,140,79,61,2018,total_driving,NA
T19,T27,Sung Kang,7,140,53,87,2018,total_driving,NA
T21,22,Emiliano Grillo,7,142,110,32,2018,total_driving,NA
T21,18,Bubba Watson,4,142,1,141,2018,total_driving,NA
23,T19,Bryson DeChambeau,3,144,13,131,2018,total_driving,NA
24,T52,Matthew Wolff,5,145,40,105,2018,total_driving,NA
25,29,Joel Dahmen,8,149,100,49,2018,total_driving,NA
26,16,Jason Kokrak,5,153,8,145,2018,total_driving,NA
27,17,Josh Teater,6,156,83,73,2018,total_driving,NA
28,T23,Cameron Champ,7,157,2,155,2018,total_driving,NA
29,33,Ryan Palmer,5,160,146,14,2018,total_driving,NA
30,T35,Adam Hadwin,5,164,121,43,2018,total_driving,NA
31,26,Sungjae Im,8,165,50,115,2018,total_driving,NA
32,31,Henrik Norlander,10,168,132,36,2018,total_driving,NA
T33,38,Boo Weekley,5,169,147,22,2018,total_driving,NA
T33,T35,Harold Varner III,7,169,18,151,2018,total_driving,NA
35,37,Lanto Griffin,10,170,40,130,2018,total_driving,NA
36,T19,Lucas Glover,7,174,98,76,2018,total_driving,NA
37,34,Scott Brown,9,175,151,24,2018,total_driving,NA
38,T44,Sebastián Muñoz,10,176,60,116,2018,total_driving,NA
T39,40,Daniel Berger,6,177,56,121,2018,total_driving,NA
T39,42,Keegan Bradley,7,177,71,106,2018,total_driving,NA
41,39,Chesson Hadley,7,179,106,73,2018,total_driving,NA
42,43,Webb Simpson,3,182,170,12,2018,total_driving,NA
43,48,Danny Lee,7,185,9,176,2018,total_driving,NA
44,T50,Pat Perez,6,186,130,56,2018,total_driving,NA
45,T52,Matthew NeSmith,9,188,154,34,2018,total_driving,NA
46,T99,Sepp Straka,10,191,92,99,2018,total_driving,NA
T47,T90,Isaiah Salinda,3,192,14,178,2018,total_driving,NA
T47,T56,John Merrick,4,192,135,57,2018,total_driving,NA
T49,T50,Jim Furyk,3,193,192,1,2018,total_driving,NA
T49,55,Chad Campbell,4,193,178,15,2018,total_driving,NA
T49,T44,Wyndham Clark,7,193,32,161,2018,total_driving,NA
52,32,Alex Noren,4,195,108,87,2018,total_driving,NA
53,NA,Rickie Fowler,2,196,194,2,2018,total_driving,NA
T54,T56,Tony Finau,5,198,12,186,2018,total_driving,NA
T54,T62,Phil Mickelson,5,198,31,167,2018,total_driving,NA
T54,T62,Aaron Wise,7,198,51,147,2018,total_driving,NA
T54,T69,Chase Seiffert,9,198,127,71,2018,total_driving,NA
T58,T73,Abraham Ancer,8,199,113,86,2018,total_driving,NA
T58,61,Adam Schenk,10,199,33,166,2018,total_driving,NA
T58,T64,Scott Harrington,9,199,34,165,2018,total_driving,NA
T61,T52,Brian Harman,8,200,143,57,2018,total_driving,NA
T61,47,Jason Dufner,7,200,140,60,2018,total_driving,NA
T61,59,Cameron Smith,6,200,77,123,2018,total_driving,NA
T64,46,Kramer Hickok,9,201,124,77,2018,total_driving,NA
T64,60,Matt Jones,8,201,49,152,2018,total_driving,NA
66,30,Robby Shelton,10,202,88,114,2018,total_driving,NA
T67,83,Grayson Murray,6,203,4,199,2018,total_driving,NA
T67,T73,Russell Knox,8,203,138,65,2018,total_driving,NA
69,41,Denny McCarthy,8,204,101,103,2018,total_driving,NA
70,T80,Sam Ryder,10,209,53,156,2018,total_driving,NA
71,58,Brice Garnett,8,214,150,64,2018,total_driving,NA
72,66,Michael Thompson,7,215,175,40,2018,total_driving,NA
73,76,Collin Morikawa,6,216,168,48,2018,total_driving,NA
T74,T69,Derek Ernst,4,217,80,137,2018,total_driving,NA
T74,T67,Adam Long,10,217,189,28,2018,total_driving,NA
T74,96,Andrew Landry,9,217,171,46,2018,total_driving,NA
77,T84,Akshay Bhatia,5,218,7,211,2018,total_driving,NA
78,T69,Rod Pampling,3,220,28,192,2018,total_driving,NA
79,136,Nick Watney,7,222,73,149,2018,total_driving,NA
T80,T84,Hideki Matsuyama,6,223,115,108,2018,total_driving,NA
T80,115,Doug Ghim,7,223,116,107,2018,total_driving,NA
T80,T90,Kristoffer Ventura,9,223,44,179,2018,total_driving,NA
T83,T73,Byeong Hun An,8,225,10,215,2018,total_driving,NA
T83,T90,Chandler Phillips,2,225,57,168,2018,total_driving,NA
T83,T69,Brian Stuard,10,225,215,10,2018,total_driving,NA
T83,T97,Alex Cejka,5,225,175,50,2018,total_driving,NA
T83,T80,Ryan Armour,9,225,217,8,2018,total_driving,NA
T88,T90,Graham DeLaet,5,226,36,190,2018,total_driving,NA
T88,T77,Tim Wilkinson,6,226,189,37,2018,total_driving,NA
T88,T86,Brandon Wu,2,226,188,38,2018,total_driving,NA
T91,T88,Hank Lebioda,9,228,104,124,2018,total_driving,NA
T91,79,Charles Howell III,9,228,69,159,2018,total_driving,NA
93,T67,Tyler McCumber,9,229,11,218,2018,total_driving,NA
94,T90,Fabián Gómez,9,230,167,63,2018,total_driving,NA
95,T90,Brendon Todd,11,231,228,3,2018,total_driving,NA
T96,49,Cameron Percy,8,233,61,172,2018,total_driving,NA
T96,T99,Adam Scott,4,233,46,187,2018,total_driving,NA
T96,T80,Luke List,9,233,80,153,2018,total_driving,NA
T96,T86,Russell Henley,8,233,179,54,2018,total_driving,NA
T96,T130,Mackenzie Hughes,8,233,101,132,2018,total_driving,NA
101,T109,J.T. Poston,9,234,175,59,2018,total_driving,NA
102,T64,Vince Covello,8,235,73,162,2018,total_driving,NA
103,T99,Xinjun Zhang,10,236,116,120,2018,total_driving,NA
104,105,K.J. Choi,3,237,233,4,2018,total_driving,NA
T105,107,Tim Herron,4,238,220,18,2018,total_driving,NA
T105,T109,Corey Conners,7,238,186,52,2018,total_driving,NA
T107,108,Keith Mitchell,7,239,135,104,2018,total_driving,NA
T107,T130,Cameron Davis,8,239,22,217,2018,total_driving,NA
T107,T99,Richy Werenski,4,239,45,194,2018,total_driving,NA
T107,T88,Vaughn Taylor,8,239,212,27,2018,total_driving,NA
111,168,Chris Baker,9,240,168,72,2018,total_driving,NA
T112,T112,Jim Herman,8,241,221,20,2018,total_driving,NA
T112,T127,Scott Piercy,8,241,105,136,2018,total_driving,NA
T114,T120,J.J. Henry,5,242,173,69,2018,total_driving,NA
T114,T103,Tyler Duncan,10,242,221,21,2018,total_driving,NA
116,T112,Davis Riley,2,243,83,160,2018,total_driving,NA
T117,T125,Bo Hoag,10,244,127,117,2018,total_driving,NA
T117,T116,Chez Reavie,9,244,228,16,2018,total_driving,NA
119,T116,Matt Kuchar,4,245,238,7,2018,total_driving,NA
T120,223,Paul Casey,4,247,160,87,2018,total_driving,NA
T120,T116,Satoshi Kodaira,6,247,234,13,2018,total_driving,NA
T120,T127,Shawn Stefani,6,247,73,174,2018,total_driving,NA
123,106,Carlos Ortiz,8,248,67,181,2018,total_driving,NA
124,T122,Ben Crane,6,249,207,42,2018,total_driving,NA
125,T130,Tom Lewis,3,252,5,247,2018,total_driving,NA
126,T139,Michael Gligic,9,253,73,180,2018,total_driving,NA
T127,T139,Scott Stallings,8,254,47,207,2018,total_driving,NA
T127,T137,Kyle Stanley,8,254,213,41,2018,total_driving,NA
T129,T137,Henrik Stenson,2,255,202,53,2018,total_driving,NA
T129,T125,Austin Cook,8,255,127,128,2018,total_driving,NA
T131,T120,Beau Hossler,8,256,29,227,2018,total_driving,NA
T131,T122,Patrick Rodgers,10,256,26,230,2018,total_driving,NA
T131,T143,Sebastian Cappelen,8,256,30,226,2018,total_driving,NA
T131,T133,Kurt Kitayama,2,256,3,253,2018,total_driving,NA
T131,T77,Vincent Whaley,7,256,103,153,2018,total_driving,NA
T131,T141,Ryan Brehm,10,256,6,250,2018,total_driving,NA
137,T122,Mark Hubbard,10,257,149,108,2018,total_driving,NA
T138,T163,Brandon Hagy,8,258,22,236,2018,total_driving,NA
T138,T109,Billy Horschel,6,258,196,62,2018,total_driving,NA
T140,T147,Sam Burns,6,259,20,239,2018,total_driving,NA
T140,T133,David Lingmerth,5,259,230,29,2018,total_driving,NA
T142,T187,Bud Cauley,6,262,125,137,2018,total_driving,NA
T142,T143,Cameron Tringale,7,262,55,207,2018,total_driving,NA
144,T143,Rikuya Hoshino,2,264,138,126,2018,total_driving,NA
145,T155,Jonathan Byrd,5,265,72,193,2018,total_driving,NA
T146,T116,Maverick McNealy,9,266,89,177,2018,total_driving,NA
T146,T147,Xander Schauffele,3,266,231,35,2018,total_driving,NA
T148,154,Whee Kim,2,267,180,87,2018,total_driving,NA
T148,T141,Lucas Bjerregaard,3,267,18,249,2018,total_driving,NA
150,T152,Chip McDaniel,2,268,59,209,2018,total_driving,NA
T151,T178,Max Homa,6,269,187,82,2018,total_driving,NA
T151,T112,Bill Haas,6,269,147,122,2018,total_driving,NA
T151,146,J.B. Holmes,3,269,224,45,2018,total_driving,NA
T154,129,Zack Sucher,6,270,24,246,2018,total_driving,NA
T154,T157,Roberto Castro,5,270,183,87,2018,total_driving,NA
156,151,Kevin Tway,6,271,27,244,2018,total_driving,NA
T157,T155,Kevin Chappell,6,272,43,229,2018,total_driving,NA
T157,T152,Dominic Bozzelli,7,272,38,234,2018,total_driving,NA
T159,T147,David Hearn,9,273,206,67,2018,total_driving,NA
T159,174,Jimmy Walker,4,273,92,181,2018,total_driving,NA
161,165,Sangmoon Bae,6,274,64,210,2018,total_driving,NA
162,167,Michael Gellerman,8,275,135,140,2018,total_driving,NA
163,T159,Kevin Kisner,7,277,227,50,2018,total_driving,NA
T164,T159,Justin Thomas,5,278,161,117,2018,total_driving,NA
T164,T187,Troy Merritt,7,278,182,96,2018,total_driving,NA
T164,T163,Freddie Jacobson,3,278,141,137,2018,total_driving,NA
167,T175,Talor Gooch,8,280,122,158,2018,total_driving,NA
168,T103,Andrew Putnam,6,283,181,102,2018,total_driving,NA
T169,T157,Si Woo Kim,8,284,99,185,2018,total_driving,NA
T169,T97,Charley Hoffman,7,284,87,197,2018,total_driving,NA
T169,169,Seamus Power,5,284,83,201,2018,total_driving,NA
172,T133,John Huh,5,285,166,119,2018,total_driving,NA
T173,T172,Jason Day,3,286,80,206,2018,total_driving,NA
T173,T172,Chris Kirk,3,286,199,87,2018,total_driving,NA
T173,T175,Rafael Campos,9,286,67,219,2018,total_driving,NA
176,T159,Nate Lashley,8,287,204,83,2018,total_driving,NA
177,177,Brandt Snedeker,4,288,155,133,2018,total_driving,NA
178,T178,Peter Uihlein,6,289,38,251,2018,total_driving,NA
179,150,Kevin Na,7,290,203,87,2018,total_driving,NA
180,T170,Ben Taylor,10,291,134,157,2018,total_driving,NA
181,162,Anirban Lahiri,8,292,118,174,2018,total_driving,NA
182,T208,Roger Sloan,8,293,158,135,2018,total_driving,NA
T183,182,Johnson Wagner,5,294,207,87,2018,total_driving,NA
T183,T183,Robert Garrigus,5,294,52,242,2018,total_driving,NA
T183,T187,Wes Roach,7,294,151,143,2018,total_driving,NA
186,181,Zach Johnson,7,299,216,83,2018,total_driving,NA
187,191,Mikumu Horikawa,3,303,237,66,2018,total_driving,NA
T188,194,Will Gordon,4,304,64,240,2018,total_driving,NA
T188,210,Rory Sabbatini,7,304,219,85,2018,total_driving,NA
T188,T183,Dylan Frittelli,9,304,193,111,2018,total_driving,NA
191,185,Nelson Ledesma,10,305,57,248,2018,total_driving,NA
192,192,Marc Leishman,5,306,90,216,2018,total_driving,NA
193,166,Joseph Bramlett,7,307,94,213,2018,total_driving,NA
194,195,Joaquin Niemann,8,308,164,144,2018,total_driving,NA
T195,T196,Graeme McDowell,5,311,236,75,2018,total_driving,NA
T195,T201,Bronson Burgoon,8,311,130,181,2018,total_driving,NA
197,T187,Brian Gay,9,312,162,150,2018,total_driving,NA
198,193,Rhein Gibson,9,313,90,223,2018,total_driving,NA
199,T196,Tom Hoge,8,314,185,129,2018,total_driving,NA
200,200,Mark Anderson,7,319,132,187,2018,total_driving,NA
201,204,Smylie Kaufman,3,320,64,256,2018,total_driving,NA
T202,199,Zac Blair,10,322,225,97,2018,total_driving,NA
T202,214,Francesco Molinari,3,322,125,197,2018,total_driving,NA
T204,T170,John Senden,5,324,120,204,2018,total_driving,NA
T204,180,Ben Martin,6,324,223,101,2018,total_driving,NA
T206,T205,James Hahn,6,325,163,162,2018,total_driving,NA
T206,186,Aaron Baddeley,6,325,198,127,2018,total_driving,NA
208,T211,J.J. Spaun,9,330,118,212,2018,total_driving,NA
T209,203,Robert Streb,9,332,141,191,2018,total_driving,NA
T209,T208,Robert Allenby,3,332,164,168,2018,total_driving,NA
211,T211,Martin Trainer,8,339,94,245,2018,total_driving,NA
212,T205,"Ted Potter, Jr.",7,340,151,189,2018,total_driving,NA
213,T201,Chris Stroud,6,341,194,147,2018,total_driving,NA
T214,T205,Rob Oppenheim,10,342,200,142,2018,total_driving,NA
T214,198,Matt Every,7,342,122,220,2018,total_driving,NA
T214,213,Morgan Hoffmann,4,342,143,199,2018,total_driving,NA
217,215,Roberto Díaz,2,345,110,235,2018,total_driving,NA
218,216,Stewart Cink,4,350,112,238,2018,total_driving,NA
219,217,C.T. Pan,5,353,189,164,2018,total_driving,NA
220,T218,Patton Kizzire,9,354,158,196,2018,total_driving,NA
221,222,Hudson Swafford,4,356,183,173,2018,total_driving,NA
222,T218,George McNeill,6,359,145,214,2018,total_driving,NA
223,220,Patrick Reed,4,363,239,124,2018,total_driving,NA
224,221,Jamie Lovemark,4,365,114,251,2018,total_driving,NA
225,224,Luke Donald,2,378,232,146,2018,total_driving,NA
226,226,Bo Van Pelt,7,387,155,232,2018,total_driving,NA
227,225,Davis Love III,3,400,172,228,2018,total_driving,NA
228,228,Arjun Atwal,5,404,173,231,2018,total_driving,NA
T229,231,Daniel Chopra,3,411,157,254,2018,total_driving,NA
T229,227,Kevin Stadler,6,411,217,194,2018,total_driving,NA
231,229,John Rollins,4,414,209,205,2018,total_driving,NA
232,230,Parker McLachlin,4,421,201,220,2018,total_driving,NA
233,232,Peter Malnati,9,422,197,225,2018,total_driving,NA
234,233,Michael Kim,8,435,211,224,2018,total_driving,NA
235,235,Tommy Gainey,4,442,209,233,2018,total_driving,NA
236,234,D.A. Points,4,446,226,220,2018,total_driving,NA
237,236,Ricky Barnes,6,451,214,237,2018,total_driving,NA
238,237,Brendon de Jonge,3,462,205,257,2018,total_driving,NA
239,238,Shugo Imahira,2,490,235,255,2018,total_driving,NA
1,1,Andrew Novak,2,35,17,18,2019,total_driving,NA
2,3,Viktor Hovland,4,63,16,47,2019,total_driving,NA
3,4,Chase Koepka,2,72,34,38,2019,total_driving,NA
4,5,John Oda,2,74,70,4,2019,total_driving,NA
5,6,D.J. Trahan,7,91,47,44,2019,total_driving,NA
6,8,Gary Woodland,4,98,94,4,2019,total_driving,NA
7,9,Branden Grace,4,99,21,78,2019,total_driving,NA
T8,10,Patrick Cantlay,3,103,86,17,2019,total_driving,NA
T8,7,Doc Redman,10,103,77,26,2019,total_driving,NA
10,2,Ryan Moore,5,105,94,11,2019,total_driving,NA
11,13,Scottie Scheffler,8,126,15,111,2019,total_driving,NA
12,T19,Kyoung-Hoon Lee,10,128,106,22,2019,total_driving,NA
13,14,Martin Laird,8,129,42,87,2019,total_driving,NA
14,11,Kevin Streelman,9,130,62,68,2019,total_driving,NA
15,25,Jhonattan Vegas,6,132,24,108,2019,total_driving,NA
T16,15,Nick Taylor,8,133,109,24,2019,total_driving,NA
T16,T23,Brendan Steele,8,133,63,70,2019,total_driving,NA
18,12,Harris English,7,135,36,99,2019,total_driving,NA
T19,T27,Harry Higgs,10,140,79,61,2019,total_driving,NA
T19,T27,Sung Kang,7,140,53,87,2019,total_driving,NA
T21,22,Emiliano Grillo,7,142,110,32,2019,total_driving,NA
T21,18,Bubba Watson,4,142,1,141,2019,total_driving,NA
23,T19,Bryson DeChambeau,3,144,13,131,2019,total_driving,NA
24,T52,Matthew Wolff,5,145,40,105,2019,total_driving,NA
25,29,Joel Dahmen,8,149,100,49,2019,total_driving,NA
26,16,Jason Kokrak,5,153,8,145,2019,total_driving,NA
27,17,Josh Teater,6,156,83,73,2019,total_driving,NA
28,T23,Cameron Champ,7,157,2,155,2019,total_driving,NA
29,33,Ryan Palmer,5,160,146,14,2019,total_driving,NA
30,T35,Adam Hadwin,5,164,121,43,2019,total_driving,NA
31,26,Sungjae Im,8,165,50,115,2019,total_driving,NA
32,31,Henrik Norlander,10,168,132,36,2019,total_driving,NA
T33,38,Boo Weekley,5,169,147,22,2019,total_driving,NA
T33,T35,Harold Varner III,7,169,18,151,2019,total_driving,NA
35,37,Lanto Griffin,10,170,40,130,2019,total_driving,NA
36,T19,Lucas Glover,7,174,98,76,2019,total_driving,NA
37,34,Scott Brown,9,175,151,24,2019,total_driving,NA
38,T44,Sebastián Muñoz,10,176,60,116,2019,total_driving,NA
T39,40,Daniel Berger,6,177,56,121,2019,total_driving,NA
T39,42,Keegan Bradley,7,177,71,106,2019,total_driving,NA
41,39,Chesson Hadley,7,179,106,73,2019,total_driving,NA
42,43,Webb Simpson,3,182,170,12,2019,total_driving,NA
43,48,Danny Lee,7,185,9,176,2019,total_driving,NA
44,T50,Pat Perez,6,186,130,56,2019,total_driving,NA
45,T52,Matthew NeSmith,9,188,154,34,2019,total_driving,NA
46,T99,Sepp Straka,10,191,92,99,2019,total_driving,NA
T47,T90,Isaiah Salinda,3,192,14,178,2019,total_driving,NA
T47,T56,John Merrick,4,192,135,57,2019,total_driving,NA
T49,T50,Jim Furyk,3,193,192,1,2019,total_driving,NA
T49,55,Chad Campbell,4,193,178,15,2019,total_driving,NA
T49,T44,Wyndham Clark,7,193,32,161,2019,total_driving,NA
52,32,Alex Noren,4,195,108,87,2019,total_driving,NA
53,NA,Rickie Fowler,2,196,194,2,2019,total_driving,NA
T54,T56,Tony Finau,5,198,12,186,2019,total_driving,NA
T54,T62,Phil Mickelson,5,198,31,167,2019,total_driving,NA
T54,T62,Aaron Wise,7,198,51,147,2019,total_driving,NA
T54,T69,Chase Seiffert,9,198,127,71,2019,total_driving,NA
T58,T73,Abraham Ancer,8,199,113,86,2019,total_driving,NA
T58,61,Adam Schenk,10,199,33,166,2019,total_driving,NA
T58,T64,Scott Harrington,9,199,34,165,2019,total_driving,NA
T61,T52,Brian Harman,8,200,143,57,2019,total_driving,NA
T61,47,Jason Dufner,7,200,140,60,2019,total_driving,NA
T61,59,Cameron Smith,6,200,77,123,2019,total_driving,NA
T64,46,Kramer Hickok,9,201,124,77,2019,total_driving,NA
T64,60,Matt Jones,8,201,49,152,2019,total_driving,NA
66,30,Robby Shelton,10,202,88,114,2019,total_driving,NA
T67,83,Grayson Murray,6,203,4,199,2019,total_driving,NA
T67,T73,Russell Knox,8,203,138,65,2019,total_driving,NA
69,41,Denny McCarthy,8,204,101,103,2019,total_driving,NA
70,T80,Sam Ryder,10,209,53,156,2019,total_driving,NA
71,58,Brice Garnett,8,214,150,64,2019,total_driving,NA
72,66,Michael Thompson,7,215,175,40,2019,total_driving,NA
73,76,Collin Morikawa,6,216,168,48,2019,total_driving,NA
T74,T69,Derek Ernst,4,217,80,137,2019,total_driving,NA
T74,T67,Adam Long,10,217,189,28,2019,total_driving,NA
T74,96,Andrew Landry,9,217,171,46,2019,total_driving,NA
77,T84,Akshay Bhatia,5,218,7,211,2019,total_driving,NA
78,T69,Rod Pampling,3,220,28,192,2019,total_driving,NA
79,136,Nick Watney,7,222,73,149,2019,total_driving,NA
T80,T84,Hideki Matsuyama,6,223,115,108,2019,total_driving,NA
T80,115,Doug Ghim,7,223,116,107,2019,total_driving,NA
T80,T90,Kristoffer Ventura,9,223,44,179,2019,total_driving,NA
T83,T73,Byeong Hun An,8,225,10,215,2019,total_driving,NA
T83,T90,Chandler Phillips,2,225,57,168,2019,total_driving,NA
T83,T69,Brian Stuard,10,225,215,10,2019,total_driving,NA
T83,T97,Alex Cejka,5,225,175,50,2019,total_driving,NA
T83,T80,Ryan Armour,9,225,217,8,2019,total_driving,NA
T88,T90,Graham DeLaet,5,226,36,190,2019,total_driving,NA
T88,T77,Tim Wilkinson,6,226,189,37,2019,total_driving,NA
T88,T86,Brandon Wu,2,226,188,38,2019,total_driving,NA
T91,T88,Hank Lebioda,9,228,104,124,2019,total_driving,NA
T91,79,Charles Howell III,9,228,69,159,2019,total_driving,NA
93,T67,Tyler McCumber,9,229,11,218,2019,total_driving,NA
94,T90,Fabián Gómez,9,230,167,63,2019,total_driving,NA
95,T90,Brendon Todd,11,231,228,3,2019,total_driving,NA
T96,49,Cameron Percy,8,233,61,172,2019,total_driving,NA
T96,T99,Adam Scott,4,233,46,187,2019,total_driving,NA
T96,T80,Luke List,9,233,80,153,2019,total_driving,NA
T96,T86,Russell Henley,8,233,179,54,2019,total_driving,NA
T96,T130,Mackenzie Hughes,8,233,101,132,2019,total_driving,NA
101,T109,J.T. Poston,9,234,175,59,2019,total_driving,NA
102,T64,Vince Covello,8,235,73,162,2019,total_driving,NA
103,T99,Xinjun Zhang,10,236,116,120,2019,total_driving,NA
104,105,K.J. Choi,3,237,233,4,2019,total_driving,NA
T105,107,Tim Herron,4,238,220,18,2019,total_driving,NA
T105,T109,Corey Conners,7,238,186,52,2019,total_driving,NA
T107,108,Keith Mitchell,7,239,135,104,2019,total_driving,NA
T107,T130,Cameron Davis,8,239,22,217,2019,total_driving,NA
T107,T99,Richy Werenski,4,239,45,194,2019,total_driving,NA
T107,T88,Vaughn Taylor,8,239,212,27,2019,total_driving,NA
111,168,Chris Baker,9,240,168,72,2019,total_driving,NA
T112,T112,Jim Herman,8,241,221,20,2019,total_driving,NA
T112,T127,Scott Piercy,8,241,105,136,2019,total_driving,NA
T114,T120,J.J. Henry,5,242,173,69,2019,total_driving,NA
T114,T103,Tyler Duncan,10,242,221,21,2019,total_driving,NA
116,T112,Davis Riley,2,243,83,160,2019,total_driving,NA
T117,T125,Bo Hoag,10,244,127,117,2019,total_driving,NA
T117,T116,Chez Reavie,9,244,228,16,2019,total_driving,NA
119,T116,Matt Kuchar,4,245,238,7,2019,total_driving,NA
T120,223,Paul Casey,4,247,160,87,2019,total_driving,NA
T120,T116,Satoshi Kodaira,6,247,234,13,2019,total_driving,NA
T120,T127,Shawn Stefani,6,247,73,174,2019,total_driving,NA
123,106,Carlos Ortiz,8,248,67,181,2019,total_driving,NA
124,T122,Ben Crane,6,249,207,42,2019,total_driving,NA
125,T130,Tom Lewis,3,252,5,247,2019,total_driving,NA
126,T139,Michael Gligic,9,253,73,180,2019,total_driving,NA
T127,T139,Scott Stallings,8,254,47,207,2019,total_driving,NA
T127,T137,Kyle Stanley,8,254,213,41,2019,total_driving,NA
T129,T137,Henrik Stenson,2,255,202,53,2019,total_driving,NA
T129,T125,Austin Cook,8,255,127,128,2019,total_driving,NA
T131,T120,Beau Hossler,8,256,29,227,2019,total_driving,NA
T131,T122,Patrick Rodgers,10,256,26,230,2019,total_driving,NA
T131,T143,Sebastian Cappelen,8,256,30,226,2019,total_driving,NA
T131,T133,Kurt Kitayama,2,256,3,253,2019,total_driving,NA
T131,T77,Vincent Whaley,7,256,103,153,2019,total_driving,NA
T131,T141,Ryan Brehm,10,256,6,250,2019,total_driving,NA
137,T122,Mark Hubbard,10,257,149,108,2019,total_driving,NA
T138,T163,Brandon Hagy,8,258,22,236,2019,total_driving,NA
T138,T109,Billy Horschel,6,258,196,62,2019,total_driving,NA
T140,T147,Sam Burns,6,259,20,239,2019,total_driving,NA
T140,T133,David Lingmerth,5,259,230,29,2019,total_driving,NA
T142,T187,Bud Cauley,6,262,125,137,2019,total_driving,NA
T142,T143,Cameron Tringale,7,262,55,207,2019,total_driving,NA
144,T143,Rikuya Hoshino,2,264,138,126,2019,total_driving,NA
145,T155,Jonathan Byrd,5,265,72,193,2019,total_driving,NA
T146,T116,Maverick McNealy,9,266,89,177,2019,total_driving,NA
T146,T147,Xander Schauffele,3,266,231,35,2019,total_driving,NA
T148,154,Whee Kim,2,267,180,87,2019,total_driving,NA
T148,T141,Lucas Bjerregaard,3,267,18,249,2019,total_driving,NA
150,T152,Chip McDaniel,2,268,59,209,2019,total_driving,NA
T151,T178,Max Homa,6,269,187,82,2019,total_driving,NA
T151,T112,Bill Haas,6,269,147,122,2019,total_driving,NA
T151,146,J.B. Holmes,3,269,224,45,2019,total_driving,NA
T154,129,Zack Sucher,6,270,24,246,2019,total_driving,NA
T154,T157,Roberto Castro,5,270,183,87,2019,total_driving,NA
156,151,Kevin Tway,6,271,27,244,2019,total_driving,NA
T157,T155,Kevin Chappell,6,272,43,229,2019,total_driving,NA
T157,T152,Dominic Bozzelli,7,272,38,234,2019,total_driving,NA
T159,T147,David Hearn,9,273,206,67,2019,total_driving,NA
T159,174,Jimmy Walker,4,273,92,181,2019,total_driving,NA
161,165,Sangmoon Bae,6,274,64,210,2019,total_driving,NA
162,167,Michael Gellerman,8,275,135,140,2019,total_driving,NA
163,T159,Kevin Kisner,7,277,227,50,2019,total_driving,NA
T164,T159,Justin Thomas,5,278,161,117,2019,total_driving,NA
T164,T187,Troy Merritt,7,278,182,96,2019,total_driving,NA
T164,T163,Freddie Jacobson,3,278,141,137,2019,total_driving,NA
167,T175,Talor Gooch,8,280,122,158,2019,total_driving,NA
168,T103,Andrew Putnam,6,283,181,102,2019,total_driving,NA
T169,T157,Si Woo Kim,8,284,99,185,2019,total_driving,NA
T169,T97,Charley Hoffman,7,284,87,197,2019,total_driving,NA
T169,169,Seamus Power,5,284,83,201,2019,total_driving,NA
172,T133,John Huh,5,285,166,119,2019,total_driving,NA
T173,T172,Jason Day,3,286,80,206,2019,total_driving,NA
T173,T172,Chris Kirk,3,286,199,87,2019,total_driving,NA
T173,T175,Rafael Campos,9,286,67,219,2019,total_driving,NA
176,T159,Nate Lashley,8,287,204,83,2019,total_driving,NA
177,177,Brandt Snedeker,4,288,155,133,2019,total_driving,NA
178,T178,Peter Uihlein,6,289,38,251,2019,total_driving,NA
179,150,Kevin Na,7,290,203,87,2019,total_driving,NA
180,T170,Ben Taylor,10,291,134,157,2019,total_driving,NA
181,162,Anirban Lahiri,8,292,118,174,2019,total_driving,NA
182,T208,Roger Sloan,8,293,158,135,2019,total_driving,NA
T183,182,Johnson Wagner,5,294,207,87,2019,total_driving,NA
T183,T183,Robert Garrigus,5,294,52,242,2019,total_driving,NA
T183,T187,Wes Roach,7,294,151,143,2019,total_driving,NA
186,181,Zach Johnson,7,299,216,83,2019,total_driving,NA
187,191,Mikumu Horikawa,3,303,237,66,2019,total_driving,NA
T188,194,Will Gordon,4,304,64,240,2019,total_driving,NA
T188,210,Rory Sabbatini,7,304,219,85,2019,total_driving,NA
T188,T183,Dylan Frittelli,9,304,193,111,2019,total_driving,NA
191,185,Nelson Ledesma,10,305,57,248,2019,total_driving,NA
192,192,Marc Leishman,5,306,90,216,2019,total_driving,NA
193,166,Joseph Bramlett,7,307,94,213,2019,total_driving,NA
194,195,Joaquin Niemann,8,308,164,144,2019,total_driving,NA
T195,T196,Graeme McDowell,5,311,236,75,2019,total_driving,NA
T195,T201,Bronson Burgoon,8,311,130,181,2019,total_driving,NA
197,T187,Brian Gay,9,312,162,150,2019,total_driving,NA
198,193,Rhein Gibson,9,313,90,223,2019,total_driving,NA
199,T196,Tom Hoge,8,314,185,129,2019,total_driving,NA
200,200,Mark Anderson,7,319,132,187,2019,total_driving,NA
201,204,Smylie Kaufman,3,320,64,256,2019,total_driving,NA
T202,199,Zac Blair,10,322,225,97,2019,total_driving,NA
T202,214,Francesco Molinari,3,322,125,197,2019,total_driving,NA
T204,T170,John Senden,5,324,120,204,2019,total_driving,NA
T204,180,Ben Martin,6,324,223,101,2019,total_driving,NA
T206,T205,James Hahn,6,325,163,162,2019,total_driving,NA
T206,186,Aaron Baddeley,6,325,198,127,2019,total_driving,NA
208,T211,J.J. Spaun,9,330,118,212,2019,total_driving,NA
T209,203,Robert Streb,9,332,141,191,2019,total_driving,NA
T209,T208,Robert Allenby,3,332,164,168,2019,total_driving,NA
211,T211,Martin Trainer,8,339,94,245,2019,total_driving,NA
212,T205,"Ted Potter, Jr.",7,340,151,189,2019,total_driving,NA
213,T201,Chris Stroud,6,341,194,147,2019,total_driving,NA
T214,T205,Rob Oppenheim,10,342,200,142,2019,total_driving,NA
T214,198,Matt Every,7,342,122,220,2019,total_driving,NA
T214,213,Morgan Hoffmann,4,342,143,199,2019,total_driving,NA
217,215,Roberto Díaz,2,345,110,235,2019,total_driving,NA
218,216,Stewart Cink,4,350,112,238,2019,total_driving,NA
219,217,C.T. Pan,5,353,189,164,2019,total_driving,NA
220,T218,Patton Kizzire,9,354,158,196,2019,total_driving,NA
221,222,Hudson Swafford,4,356,183,173,2019,total_driving,NA
222,T218,George McNeill,6,359,145,214,2019,total_driving,NA
223,220,Patrick Reed,4,363,239,124,2019,total_driving,NA
224,221,Jamie Lovemark,4,365,114,251,2019,total_driving,NA
225,224,Luke Donald,2,378,232,146,2019,total_driving,NA
226,226,Bo Van Pelt,7,387,155,232,2019,total_driving,NA
227,225,Davis Love III,3,400,172,228,2019,total_driving,NA
228,228,Arjun Atwal,5,404,173,231,2019,total_driving,NA
T229,231,Daniel Chopra,3,411,157,254,2019,total_driving,NA
T229,227,Kevin Stadler,6,411,217,194,2019,total_driving,NA
231,229,John Rollins,4,414,209,205,2019,total_driving,NA
232,230,Parker McLachlin,4,421,201,220,2019,total_driving,NA
233,232,Peter Malnati,9,422,197,225,2019,total_driving,NA
234,233,Michael Kim,8,435,211,224,2019,total_driving,NA
235,235,Tommy Gainey,4,442,209,233,2019,total_driving,NA
236,234,D.A. Points,4,446,226,220,2019,total_driving,NA
237,236,Ricky Barnes,6,451,214,237,2019,total_driving,NA
238,237,Brendon de Jonge,3,462,205,257,2019,total_driving,NA
239,238,Shugo Imahira,2,490,235,255,2019,total_driving,NA
NA,1,Jeff Brehaut,34,79,62,17,2004,total_driving,1
NA,2,John Senden,28,94,23,71,2004,total_driving,2
NA,T3,Lucas Glover,30,99,6,93,2004,total_driving,T3
NA,T3,Ted Purdy,35,99,76,23,2004,total_driving,T3
NA,T5,Joe Durant,26,101,97,4,2004,total_driving,T5
NA,T5,J.J. Henry,30,101,10,91,2004,total_driving,T5
NA,7,Jason Bohn,29,110,41,69,2004,total_driving,7
NA,8,Craig Barlow,25,111,61,50,2004,total_driving,8
NA,9,Brian Bateman,24,113,48,65,2004,total_driving,9
NA,10,Bo Van Pelt,30,114,36,78,2004,total_driving,10
NA,11,Robert Allenby,26,116,34,82,2004,total_driving,11
NA,12,Harrison Frazar,25,117,18,99,2004,total_driving,12
NA,13,Jay Williamson,33,118,85,33,2004,total_driving,13
NA,T14,Cameron Beckman,30,121,59,62,2004,total_driving,T14
NA,T14,Geoff Ogilvy,26,121,7,114,2004,total_driving,T14
NA,T16,Scott McCarron,27,123,39,84,2004,total_driving,T16
NA,T16,Joey Sindelar,31,123,53,70,2004,total_driving,T16
NA,18,Vaughn Taylor,27,125,46,79,2004,total_driving,18
NA,19,Tom Lehman,19,126,97,29,2004,total_driving,19
NA,20,Mike Heinen,17,127,4,123,2004,total_driving,20
NA,21,Zach Johnson,30,128,113,15,2004,total_driving,21
NA,22,Roland Thatcher,23,129,43,86,2004,total_driving,22
NA,23,Kent Jones,32,130,103,27,2004,total_driving,23
NA,24,Pat Perez,32,134,54,80,2004,total_driving,24
NA,25,John Rollins,29,137,101,36,2004,total_driving,25
NA,26,Billy Mayfair,32,140,118,22,2004,total_driving,26
NA,27,Notah Begay III,23,141,110,31,2004,total_driving,27
NA,28,Ryan Palmer,33,142,29,113,2004,total_driving,28
NA,29,Brent Geiberger,31,143,56,87,2004,total_driving,29
NA,T30,Bart Bryant,23,145,138,7,2004,total_driving,T30
NA,T30,Steve Elkington,20,145,100,45,2004,total_driving,T30
NA,32,Mark Calcavecchia,24,148,56,92,2004,total_driving,32
NA,33,Olin Browne,30,150,142,8,2004,total_driving,33
NA,34,Phil Mickelson,22,151,30,121,2004,total_driving,34
NA,T35,Jonathan Kaye,25,152,62,90,2004,total_driving,T35
NA,T35,Mark Wilson,19,152,138,14,2004,total_driving,T35
NA,T37,Frank Lickliter II,27,154,94,60,2004,total_driving,T37
NA,T37,Kenny Perry,23,154,26,128,2004,total_driving,T37
NA,39,Matt Gogel,25,155,113,42,2004,total_driving,39
NA,T40,Briny Baird,30,156,73,83,2004,total_driving,T40
NA,T40,J.L. Lewis,32,156,83,73,2004,total_driving,T40
NA,T40,Rocco Mediate,19,156,131,25,2004,total_driving,T40
NA,T40,Tom Pernice Jr.,31,156,109,47,2004,total_driving,T40
NA,T40,Duffy Waldorf,26,156,116,40,2004,total_driving,T40
NA,45,Arron Oberholser,23,159,122,37,2004,total_driving,45
NA,46,Rich Beem,28,160,22,138,2004,total_driving,46
NA,T47,Chris Smith,33,161,5,156,2004,total_driving,T47
NA,T47,Kevin Sutherland,27,161,105,56,2004,total_driving,T47
NA,T47,Hidemichi Tanaka,27,161,150,11,2004,total_driving,T47
NA,T50,Jonathan Byrd,27,162,28,134,2004,total_driving,T50
NA,T50,Robert Gamez,31,162,85,77,2004,total_driving,T50
NA,T52,Dennis Paulson,21,163,14,149,2004,total_driving,T52
NA,T52,Vijay Singh,29,163,13,150,2004,total_driving,T52
NA,T54,Retief Goosen,16,164,38,126,2004,total_driving,T54
NA,T54,Brian Kortan,24,164,47,117,2004,total_driving,T54
NA,T56,Richard Johnson,32,165,131,34,2004,total_driving,T56
NA,T56,Davis Love III,24,165,14,151,2004,total_driving,T56
NA,58,Stuart Appleby,25,167,42,125,2004,total_driving,58
NA,59,Woody Austin,29,168,56,112,2004,total_driving,59
NA,60,D.J. Brigman,27,169,65,104,2004,total_driving,60
NA,T61,Steve Allan,33,170,11,159,2004,total_driving,T61
NA,T61,Stephen Ames,27,170,89,81,2004,total_driving,T61
NA,T61,David Branshaw,30,170,110,60,2004,total_driving,T61
NA,T61,John Huston,20,170,103,67,2004,total_driving,T61
NA,65,José Coceres,20,172,166,6,2004,total_driving,65
NA,66,Mark Hensby,29,173,122,51,2004,total_driving,66
NA,T67,Heath Slocum,31,175,157,18,2004,total_driving,T67
NA,T67,Scott Verplank,24,175,173,2,2004,total_driving,T67
NA,69,Hunter Mahan,30,176,45,131,2004,total_driving,69
NA,70,Charles Howell III,30,177,82,95,2004,total_driving,70
NA,71,Kris Cox,26,178,16,162,2004,total_driving,71
NA,T72,Glen Day,33,179,107,72,2004,total_driving,T72
NA,T72,Kirk Triplett,24,179,167,12,2004,total_driving,T72
NA,T74,Tim Clark,26,181,168,13,2004,total_driving,T74
NA,T74,Roger Tambellini,28,181,21,160,2004,total_driving,T74
NA,T76,Jeff Maggert,20,183,148,35,2004,total_driving,T76
NA,T76,Hirofumi Miyase,27,183,163,20,2004,total_driving,T76
NA,78,Deane Pappas,22,184,32,152,2004,total_driving,78
NA,79,Andre Stolz,20,185,20,165,2004,total_driving,79
NA,80,Justin Leonard,25,187,134,53,2004,total_driving,80
NA,81,Scott Simpson,18,188,169,19,2004,total_driving,81
NA,T82,Chad Campbell,28,189,87,102,2004,total_driving,T82
NA,T82,Chris Couch,24,189,8,181,2004,total_driving,T82
NA,T82,Matt Kuchar,28,189,94,95,2004,total_driving,T82
NA,T85,Scott Hend,29,191,2,189,2004,total_driving,T85
NA,T85,Skip Kendall,29,191,146,45,2004,total_driving,T85
NA,T85,Patrick Sheehan,33,191,72,119,2004,total_driving,T85
NA,T85,Tiger Woods,19,191,9,182,2004,total_driving,T85
NA,T89,Luke Donald,21,192,162,30,2004,total_driving,T89
NA,T89,Jason Dufner,28,192,65,127,2004,total_driving,T89
NA,T89,Scott Hoch,17,192,154,38,2004,total_driving,T89
NA,T89,Tag Ridings,18,192,12,180,2004,total_driving,T89
NA,T93,Fred Funk,29,193,192,1,2004,total_driving,T93
NA,T93,Jerry Kelly,29,193,172,21,2004,total_driving,T93
NA,T95,Tom Byrum,25,195,190,5,2004,total_driving,T95
NA,T95,Daniel Chopra,33,195,26,169,2004,total_driving,T95
NA,T95,John Daly,22,195,3,192,2004,total_driving,T95
NA,T98,Craig Bowden,30,196,193,3,2004,total_driving,T98
NA,T98,Peter Lonard,23,196,54,142,2004,total_driving,T98
NA,T98,Kevin Na,32,196,157,39,2004,total_driving,T98
NA,T101,Hank Kuehne,30,197,1,196,2004,total_driving,T101
NA,T101,Dicky Pride,23,197,153,44,2004,total_driving,T101
NA,T103,Tommy Armour III,28,199,70,129,2004,total_driving,T103
NA,T103,Danny Briggs,28,199,125,74,2004,total_driving,T103
NA,T105,Fred Couples,16,201,35,166,2004,total_driving,T105
NA,T105,Omar Uresti,28,201,191,10,2004,total_driving,T105
NA,T107,Robert Damron,28,202,178,24,2004,total_driving,T107
NA,T107,Spike McRoy,33,202,145,57,2004,total_driving,T107
NA,T109,John Cook,19,203,194,9,2004,total_driving,T109
NA,T109,J.P. Hayes,27,203,152,51,2004,total_driving,T109
NA,T111,Ernie Els,16,204,19,185,2004,total_driving,T111
NA,T111,Sergio Garcia,18,204,33,171,2004,total_driving,T111
NA,T111,Rod Pampling,26,204,50,154,2004,total_driving,T111
NA,T111,Adam Scott,16,204,30,174,2004,total_driving,T111
NA,115,Tim Petrovic,32,205,97,108,2004,total_driving,115
NA,116,Rich Barcelo,26,206,43,163,2004,total_driving,116
NA,117,Pat Bates,32,207,181,26,2004,total_driving,117
NA,T118,Darren Clarke,16,208,78,130,2004,total_driving,T118
NA,T118,Justin Rose,22,208,65,143,2004,total_driving,T118
NA,T120,Shaun Micheel,27,209,93,116,2004,total_driving,T120
NA,T120,Rory Sabbatini,26,209,48,161,2004,total_driving,T120
NA,T122,Tom Carter,35,210,24,186,2004,total_driving,T122
NA,T122,Alex Cejka,24,210,110,100,2004,total_driving,T122
NA,124,Carl Pettersson,28,211,64,147,2004,total_driving,124
NA,T125,Guy Boros,24,212,149,63,2004,total_driving,T125
NA,T125,Jay Delsing,26,212,79,133,2004,total_driving,T125
NA,T125,Brenden Pappas,34,212,17,195,2004,total_driving,T125
NA,T125,Corey Pavin,23,212,196,16,2004,total_driving,T125
NA,T129,Tim Herron,26,213,40,173,2004,total_driving,T129
NA,T129,Jeff Sluman,28,213,165,48,2004,total_driving,T129
NA,131,Brett Quigley,31,214,37,177,2004,total_driving,131
NA,132,Steve Pate,24,216,128,88,2004,total_driving,132
NA,T133,Chris DiMarco,27,217,176,41,2004,total_driving,T133
NA,T133,Niclas Fasth,22,217,77,140,2004,total_driving,T133
NA,T135,Ben Crane,27,219,125,94,2004,total_driving,T135
NA,T135,Dan Olsen,31,219,25,194,2004,total_driving,T135
NA,T137,Mathias Grönberg,32,220,50,170,2004,total_driving,T137
NA,T137,David Morland IV,27,220,188,32,2004,total_driving,T137
NA,T137,Gene Sauers,30,220,156,64,2004,total_driving,T137
NA,T140,Arjun Atwal,30,221,73,148,2004,total_driving,T140
NA,T140,Danny Ellis,26,221,101,120,2004,total_driving,T140
NA,T142,Stephen Leaney,24,223,135,88,2004,total_driving,T142
NA,T142,Loren Roberts,22,223,195,28,2004,total_driving,T142
NA,144,Joe Ogilvie,32,224,79,145,2004,total_driving,144
NA,T145,Carlos Franco,27,227,69,158,2004,total_driving,T145
NA,T145,Neal Lancaster,33,227,52,175,2004,total_driving,T145
NA,T145,Len Mattiace,25,227,173,54,2004,total_driving,T145
NA,T148,Dudley Hart,23,228,113,115,2004,total_driving,T148
NA,T148,David Toms,24,228,117,111,2004,total_driving,T148
NA,150,Steve Flesch,31,229,161,68,2004,total_driving,150
NA,151,Russ Cochran,25,230,155,75,2004,total_driving,151
NA,T152,Nick Price,15,231,188,43,2004,total_driving,T152
NA,T152,Esteban Toledo,36,231,182,49,2004,total_driving,T152
NA,154,Greg Chalmers,22,233,94,139,2004,total_driving,154
NA,T155,Bob Burns,30,235,180,55,2004,total_driving,T155
NA,T155,Ben Curtis,20,235,138,97,2004,total_driving,T155
NA,157,Stewart Cink,28,238,70,168,2004,total_driving,157
NA,T158,Michael Allen,28,239,60,179,2004,total_driving,T158
NA,T158,Lee Janzen,25,239,107,132,2004,total_driving,T158
NA,T158,Mike Weir,22,239,138,101,2004,total_driving,T158
NA,T161,Dan Forsman,28,240,142,98,2004,total_driving,T161
NA,T161,Grant Waite,29,240,83,157,2004,total_driving,T161
NA,T163,Tripp Isenhour,22,242,106,136,2004,total_driving,T163
NA,T163,Jesper Parnevik,24,242,89,153,2004,total_driving,T163
NA,165,Mark Brooks,31,243,184,59,2004,total_driving,165
NA,166,Mark O'Meara,17,245,187,58,2004,total_driving,166
NA,T167,Brian Gay,32,248,163,85,2004,total_driving,T167
NA,T167,Kevin Muncrief,21,248,65,183,2004,total_driving,T167
NA,T169,Steve Lowery,28,251,79,172,2004,total_driving,T169
NA,T169,David Peoples,26,251,146,105,2004,total_driving,T169
NA,171,David Frost,26,252,186,66,2004,total_driving,171
NA,T172,Cliff Kresge,33,253,131,122,2004,total_driving,T172
NA,T172,Dean Wilson,33,253,136,117,2004,total_driving,T172
NA,174,Jay Haas,23,259,183,76,2004,total_driving,174
NA,175,Bernhard Langer,15,260,136,124,2004,total_driving,175
NA,T176,Blaine McCallister,27,261,151,110,2004,total_driving,T176
NA,T176,Craig Perks,27,261,73,188,2004,total_driving,T176
NA,T178,Shigeki Maruyama,26,264,157,107,2004,total_driving,T178
NA,T178,John Riegger,17,264,120,144,2004,total_driving,T178
NA,180,K.J. Choi,24,266,120,146,2004,total_driving,180
NA,181,Bob Estes,23,272,170,102,2004,total_driving,181
NA,182,Freddie Jacobson,24,273,89,184,2004,total_driving,182
NA,183,Bob Tway,26,275,170,105,2004,total_driving,183
NA,184,Aaron Baddeley,27,278,87,191,2004,total_driving,184
NA,185,Tommy Tolles,25,282,92,190,2004,total_driving,185
NA,186,Billy Andrade,31,283,128,155,2004,total_driving,186
NA,187,Ken Duke,30,287,124,163,2004,total_driving,187
NA,188,Craig Parry,16,288,179,109,2004,total_driving,188
NA,189,Todd Fischer,33,294,157,137,2004,total_driving,189
NA,T190,Paul Azinger,23,295,119,176,2004,total_driving,T190
NA,T190,Todd Hamilton,27,295,128,167,2004,total_driving,T190
NA,192,Chris Riley,23,311,176,135,2004,total_driving,192
NA,193,David Gossett,25,312,125,187,2004,total_driving,193
NA,194,Brad Faxon,28,326,185,141,2004,total_driving,194
NA,195,Steve Stricker,27,337,144,193,2004,total_driving,195
NA,196,José María Olazábal,17,353,175,178,2004,total_driving,196
NA,1,David Hearn,24,72,45,27,2005,total_driving,1
NA,2,Kenny Perry,23,98,9,89,2005,total_driving,2
NA,3,Harrison Frazar,31,104,17,87,2005,total_driving,3
NA,4,Joe Durant,25,105,92,13,2005,total_driving,4
NA,5,Charles Warren,31,106,27,79,2005,total_driving,5
NA,6,Mathias Grönberg,19,108,15,93,2005,total_driving,6
NA,7,Bradley Hughes,20,113,75,38,2005,total_driving,7
NA,8,Joey Snyder III,31,118,68,50,2005,total_driving,8
NA,9,Billy Mayfair,31,125,103,22,2005,total_driving,9
NA,10,John Senden,29,131,77,54,2005,total_driving,10
NA,11,Will MacKenzie,25,132,20,112,2005,total_driving,11
NA,T12,Zach Johnson,30,133,86,47,2005,total_driving,T12
NA,T12,Michael Long,26,133,29,104,2005,total_driving,T12
NA,T12,John Rollins,30,133,49,84,2005,total_driving,T12
NA,15,Jeff Brehaut,23,134,114,20,2005,total_driving,15
NA,T16,D.J. Brigman,26,136,42,94,2005,total_driving,T16
NA,T16,Ted Purdy,34,136,45,91,2005,total_driving,T16
NA,T16,Justin Rose,28,136,51,85,2005,total_driving,T16
NA,19,Roland Thatcher,26,137,67,70,2005,total_driving,19
NA,20,Mark Calcavecchia,27,140,91,49,2005,total_driving,20
NA,21,Robert Allenby,31,142,33,109,2005,total_driving,21
NA,22,Briny Baird,33,143,100,43,2005,total_driving,22
NA,23,Joey Sindelar,29,144,113,31,2005,total_driving,23
NA,T24,Richard Johnson,16,145,117,28,2005,total_driving,T24
NA,T24,Jonathan Kaye,24,145,80,65,2005,total_driving,T24
NA,26,Sean O'Hair,29,150,23,127,2005,total_driving,26
NA,T27,Lucas Glover,28,151,12,139,2005,total_driving,T27
NA,T27,J.L. Lewis,30,151,71,80,2005,total_driving,T27
NA,T27,Jeff Maggert,25,151,135,16,2005,total_driving,T27
NA,T30,Bart Bryant,26,153,147,6,2005,total_driving,T30
NA,T30,Alex Cejka,31,153,114,39,2005,total_driving,T30
NA,32,Bo Van Pelt,33,157,59,98,2005,total_driving,32
NA,T33,Craig Barlow,26,159,88,71,2005,total_driving,T33
NA,T33,D.J. Trahan,28,159,41,118,2005,total_driving,T33
NA,35,John Huston,31,161,56,105,2005,total_driving,35
NA,T36,Vaughn Taylor,32,162,84,78,2005,total_driving,T36
NA,T36,David Toms,25,162,107,55,2005,total_driving,T36
NA,T38,Brian Davis,23,163,155,8,2005,total_driving,T38
NA,T38,Marco Dawson,23,163,63,100,2005,total_driving,T38
NA,T38,Sergio Garcia,20,163,10,153,2005,total_driving,T38
NA,T38,Kent Jones,32,163,102,61,2005,total_driving,T38
NA,T42,Vijay Singh,30,164,16,148,2005,total_driving,T42
NA,T42,Lee Westwood,15,164,38,126,2005,total_driving,T42
NA,T44,Tommy Armour III,29,165,112,53,2005,total_driving,T44
NA,T44,K.J. Choi,24,165,98,67,2005,total_driving,T44
NA,T44,Paul Claxton,29,165,153,12,2005,total_driving,T44
NA,T44,J.J. Henry,32,165,34,131,2005,total_driving,T44
NA,T44,Chris Smith,32,165,18,147,2005,total_driving,T44
NA,T44,Darron Stiles,26,165,142,23,2005,total_driving,T44
NA,T50,Rocco Mediate,24,168,108,60,2005,total_driving,T50
NA,T50,D.A. Points,33,168,82,86,2005,total_driving,T50
NA,T50,Kevin Stadler,33,168,23,145,2005,total_driving,T50
NA,T50,Scott Verplank,25,168,159,9,2005,total_driving,T50
NA,T54,Scott Gutschewski,27,169,4,165,2005,total_driving,T54
NA,T54,Jay Williamson,16,169,155,14,2005,total_driving,T54
NA,T56,Geoff Ogilvy,26,170,31,139,2005,total_driving,T56
NA,T56,Heath Slocum,29,170,159,11,2005,total_driving,T56
NA,58,Duffy Waldorf,28,172,149,23,2005,total_driving,58
NA,T59,Stuart Appleby,25,174,19,155,2005,total_driving,T59
NA,T59,Davis Love III,24,174,8,166,2005,total_driving,T59
NA,61,Jason Bohn,28,175,62,113,2005,total_driving,61
NA,T62,Chad Campbell,27,176,52,124,2005,total_driving,T62
NA,T62,Kevin Sutherland,26,176,108,68,2005,total_driving,T62
NA,64,Olin Browne,29,177,173,4,2005,total_driving,64
NA,T65,Tom Pernice Jr.,32,179,80,99,2005,total_driving,T65
NA,T65,Hidemichi Tanaka,34,179,150,29,2005,total_driving,T65
NA,67,Arjun Atwal,17,180,50,130,2005,total_driving,67
NA,68,Nick Watney,31,182,28,154,2005,total_driving,68
NA,T69,Cameron Beckman,31,183,120,63,2005,total_driving,T69
NA,T69,Steve Lowery,32,183,77,106,2005,total_driving,T69
NA,T69,Hunter Mahan,34,183,55,128,2005,total_driving,T69
NA,T72,Mark Hensby,21,185,83,102,2005,total_driving,T72
NA,T72,Brett Wetterich,28,185,3,182,2005,total_driving,T72
NA,T74,Rod Pampling,26,186,40,146,2005,total_driving,T74
NA,T74,Mario Tiziani,23,186,122,64,2005,total_driving,T74
NA,T76,Brian Bateman,32,187,76,111,2005,total_driving,T76
NA,T76,Tim Herron,28,187,65,122,2005,total_driving,T76
NA,T76,Phil Mickelson,21,187,26,161,2005,total_driving,T76
NA,T76,Greg Owen,24,187,71,116,2005,total_driving,T76
NA,T80,Jonathan Byrd,31,188,37,151,2005,total_driving,T80
NA,T80,Jerry Kelly,31,188,155,33,2005,total_driving,T80
NA,82,Brandt Jobe,27,189,11,178,2005,total_driving,82
NA,83,Tjaart van der Walt,19,190,140,50,2005,total_driving,83
NA,T84,José Coceres,22,191,184,7,2005,total_driving,T84
NA,T84,Robert Damron,28,191,181,10,2005,total_driving,T84
NA,T86,Arron Oberholser,21,193,145,48,2005,total_driving,T86
NA,T86,Tiger Woods,21,193,2,191,2005,total_driving,T86
NA,T88,Steve Allan,32,194,32,162,2005,total_driving,T88
NA,T88,Omar Uresti,27,194,191,3,2005,total_driving,T88
NA,90,Matt Kuchar,21,195,170,25,2005,total_driving,90
NA,T91,Ryan Palmer,32,196,47,149,2005,total_driving,T91
NA,T91,Bob Tway,26,196,114,82,2005,total_driving,T91
NA,93,Tom Lehman,20,197,121,76,2005,total_driving,93
NA,T94,Tim Clark,26,199,140,59,2005,total_driving,T94
NA,T94,Fred Funk,30,199,197,2,2005,total_driving,T94
NA,T94,Brendan Jones,28,199,14,185,2005,total_driving,T94
NA,T94,Adam Scott,19,199,23,176,2005,total_driving,T94
NA,98,Phillip Price,25,200,142,58,2005,total_driving,98
NA,T99,Doug Barron,24,201,175,26,2005,total_driving,T99
NA,T99,Steve Elkington,20,201,145,56,2005,total_driving,T99
NA,T99,Retief Goosen,18,201,44,157,2005,total_driving,T99
NA,T102,Jim Furyk,26,202,170,32,2005,total_driving,T102
NA,T102,Jeff Hart,23,202,201,1,2005,total_driving,T102
NA,T102,Skip Kendall,32,202,187,15,2005,total_driving,T102
NA,T102,Justin Leonard,24,202,128,74,2005,total_driving,T102
NA,106,Scott Hend,28,203,1,202,2005,total_driving,106
NA,T107,Frank Lickliter II,33,204,103,101,2005,total_driving,T107
NA,T107,Brenden Pappas,15,204,6,198,2005,total_driving,T107
NA,T107,Kirk Triplett,18,204,187,17,2005,total_driving,T107
NA,T110,Gavin Coles,22,205,200,5,2005,total_driving,T110
NA,T110,John Daly,25,205,5,200,2005,total_driving,T110
NA,T110,Tom Gillis,28,205,133,72,2005,total_driving,T110
NA,T110,Pat Perez,28,205,68,137,2005,total_driving,T110
NA,T110,Carl Pettersson,34,205,70,135,2005,total_driving,T110
NA,115,Hank Kuehne,30,206,7,199,2005,total_driving,115
NA,116,Robert Gamez,28,208,162,46,2005,total_driving,116
NA,T117,John Elliott,25,209,13,196,2005,total_driving,T117
NA,T117,Tag Ridings,31,209,20,189,2005,total_driving,T117
NA,119,Luke Donald,18,210,135,75,2005,total_driving,119
NA,120,Larry Mize,18,211,192,19,2005,total_driving,120
NA,T121,Tom Byrum,27,213,195,18,2005,total_driving,T121
NA,T121,Fred Couples,22,213,39,174,2005,total_driving,T121
NA,T121,Peter Lonard,27,213,93,120,2005,total_driving,T121
NA,T124,Jim Carter,25,215,185,30,2005,total_driving,T124
NA,T124,Dan Forsman,17,215,52,163,2005,total_driving,T124
NA,T124,Shaun Micheel,29,215,101,114,2005,total_driving,T124
NA,T124,Mark Wilson,25,215,174,41,2005,total_driving,T124
NA,T128,John Cook,26,217,196,21,2005,total_driving,T128
NA,T128,Neal Lancaster,31,217,58,159,2005,total_driving,T128
NA,T128,Stephen Leaney,29,217,182,35,2005,total_driving,T128
NA,T131,Scott McCarron,24,218,77,141,2005,total_driving,T131
NA,T131,Dennis Paulson,24,218,30,188,2005,total_driving,T131
NA,T131,Jeff Sluman,28,218,176,42,2005,total_driving,T131
NA,T131,Dean Wilson,27,218,152,66,2005,total_driving,T131
NA,T135,Bob Estes,25,219,142,77,2005,total_driving,T135
NA,T135,Shigeki Maruyama,29,219,98,121,2005,total_driving,T135
NA,137,Jason Allred,29,221,20,201,2005,total_driving,137
NA,T138,Danny Briggs,29,222,185,37,2005,total_driving,T138
NA,T138,Daniel Chopra,34,222,35,187,2005,total_driving,T138
NA,T138,Chris Riley,25,222,178,44,2005,total_driving,T138
NA,T138,Rory Sabbatini,26,222,36,186,2005,total_driving,T138
NA,142,Carlos Franco,25,223,48,175,2005,total_driving,142
NA,143,Steve Jones,20,224,167,57,2005,total_driving,143
NA,144,Glen Day,27,225,118,107,2005,total_driving,144
NA,145,Todd Hamilton,31,227,110,117,2005,total_driving,145
NA,146,Charles Howell III,29,228,56,172,2005,total_driving,146
NA,T147,Paul Gow,27,230,178,52,2005,total_driving,T147
NA,T147,Brett Quigley,31,230,59,171,2005,total_driving,T147
NA,T147,Patrick Sheehan,35,230,96,134,2005,total_driving,T147
NA,150,Loren Roberts,18,231,197,34,2005,total_driving,150
NA,151,Jesper Parnevik,24,232,64,168,2005,total_driving,151
NA,152,Brian Gay,33,233,193,40,2005,total_driving,152
NA,T153,Matt Davidson,20,234,165,69,2005,total_driving,T153
NA,T153,Bill Glasson,21,234,139,95,2005,total_driving,T153
NA,T153,Joe Ogilvie,30,234,131,103,2005,total_driving,T153
NA,T156,Woody Austin,30,235,93,142,2005,total_driving,T156
NA,T156,Mark Brooks,28,235,199,36,2005,total_driving,T156
NA,T156,Steve Flesch,30,235,138,97,2005,total_driving,T156
NA,159,James Driscoll,26,237,42,195,2005,total_driving,159
NA,160,Ian Poulter,20,239,132,107,2005,total_driving,160
NA,161,Mike Weir,23,240,158,82,2005,total_driving,161
NA,T162,Billy Andrade,26,241,151,90,2005,total_driving,T162
NA,T162,Bob Heintz,24,241,71,170,2005,total_driving,T162
NA,164,Padraig Harrington,15,243,54,189,2005,total_driving,164
NA,T165,Ben Crane,21,244,61,183,2005,total_driving,T165
NA,T165,Charlie Wi,23,244,129,115,2005,total_driving,T165
NA,T167,Hunter Haas,28,247,88,159,2005,total_driving,T167
NA,T167,Corey Pavin,23,247,202,45,2005,total_driving,T167
NA,169,Jay Haas,16,249,187,62,2005,total_driving,169
NA,170,Dudley Hart,29,250,127,123,2005,total_driving,170
NA,T171,Justin Bolli,24,252,96,156,2005,total_driving,T171
NA,T171,Ryuji Imada,25,252,85,167,2005,total_driving,T171
NA,173,Stephen Ames,24,254,122,132,2005,total_driving,173
NA,174,Michael Allen,30,257,65,192,2005,total_driving,174
NA,T175,Chris Anderson,25,258,177,81,2005,total_driving,T175
NA,T175,Ben Curtis,24,258,170,88,2005,total_driving,T175
NA,T175,Brent Geiberger,21,258,162,96,2005,total_driving,T175
NA,T175,Glen Hnatiuk,21,258,148,110,2005,total_driving,T175
NA,179,Todd Fischer,35,260,187,73,2005,total_driving,179
NA,T180,Matt Gogel,28,261,169,92,2005,total_driving,T180
NA,T180,José María Olazábal,16,261,103,158,2005,total_driving,T180
NA,182,Bernhard Langer,19,262,93,169,2005,total_driving,182
NA,183,Hideto Tanihara,20,264,135,129,2005,total_driving,183
NA,184,Freddie Jacobson,23,266,90,176,2005,total_driving,184
NA,T185,Aaron Baddeley,27,268,74,194,2005,total_driving,T185
NA,T185,Andrew Magee,29,268,87,181,2005,total_driving,T185
NA,T187,Paul Azinger,22,269,133,136,2005,total_driving,T187
NA,T187,Stewart Cink,26,269,126,143,2005,total_driving,T187
NA,189,Rich Beem,26,270,106,164,2005,total_driving,189
NA,190,Kevin Na,32,285,167,118,2005,total_driving,190
NA,191,Chris DiMarco,24,289,164,125,2005,total_driving,191
NA,192,Thomas Levet,20,290,110,180,2005,total_driving,192
NA,T193,J.P. Hayes,22,297,153,144,2005,total_driving,T193
NA,T193,Tim Petrovic,32,297,118,179,2005,total_driving,T193
NA,195,Lee Janzen,26,309,125,184,2005,total_driving,195
NA,196,Craig Perks,27,315,122,193,2005,total_driving,196
NA,197,Mark O'Meara,21,316,183,133,2005,total_driving,197
NA,198,Rob Rashell,25,318,166,152,2005,total_driving,198
NA,199,Steve Stricker,21,326,129,197,2005,total_driving,199
NA,200,Len Mattiace,34,328,178,150,2005,total_driving,200
NA,T201,Brad Faxon,23,332,194,138,2005,total_driving,T201
NA,T201,Franklin Langham,31,332,159,173,2005,total_driving,T201
NA,1,Scott Gutschewski,19,83,11,72,2006,total_driving,1
NA,2,Chris Smith,21,84,24,60,2006,total_driving,2
NA,3,Nicholas Thompson,32,89,48,41,2006,total_driving,3
NA,4,Hunter Mahan,29,91,57,34,2006,total_driving,4
NA,5,Robert Allenby,22,93,64,29,2006,total_driving,5
NA,6,Joe Durant,28,94,93,1,2006,total_driving,6
NA,7,Greg Owen,24,101,54,47,2006,total_driving,7
NA,8,Kenny Perry,22,102,69,33,2006,total_driving,8
NA,9,Charles Warren,27,104,20,84,2006,total_driving,9
NA,10,Lucas Glover,31,114,23,91,2006,total_driving,10
NA,11,Jonathan Byrd,20,115,33,82,2006,total_driving,11
NA,12,John Senden,28,117,44,73,2006,total_driving,12
NA,13,Padraig Harrington,15,119,60,59,2006,total_driving,13
NA,14,Ian Poulter,15,120,100,20,2006,total_driving,14
NA,15,Ryan Moore,22,124,74,50,2006,total_driving,15
NA,16,Brett Wetterich,25,126,4,122,2006,total_driving,16
NA,17,Jonathan Kaye,32,128,61,67,2006,total_driving,17
NA,18,John Rollins,28,129,50,79,2006,total_driving,18
NA,19,Bubba Dickerson,32,132,27,105,2006,total_driving,19
NA,20,Adam Scott,19,133,16,117,2006,total_driving,20
NA,21,Steve Elkington,17,134,127,7,2006,total_driving,21
NA,T22,David Branshaw,29,137,102,35,2006,total_driving,T22
NA,T22,Brian Davis,28,137,115,22,2006,total_driving,T22
NA,24,Nick Watney,29,139,18,121,2006,total_driving,24
NA,25,Mathew Goggin,26,140,45,95,2006,total_driving,25
NA,T26,Will MacKenzie,29,143,40,103,2006,total_driving,T26
NA,T26,Kevin Sutherland,29,143,67,76,2006,total_driving,T26
NA,T28,Harrison Frazar,29,145,9,136,2006,total_driving,T28
NA,T28,Tiger Woods,15,145,6,139,2006,total_driving,T28
NA,T30,Rich Beem,27,146,48,98,2006,total_driving,T30
NA,T30,Henrik Bjornstad,31,146,39,107,2006,total_driving,T30
NA,32,Kent Jones,32,147,110,37,2006,total_driving,32
NA,33,Jason Bohn,29,148,95,53,2006,total_driving,33
NA,34,Briny Baird,25,151,135,16,2006,total_driving,34
NA,35,Jeff Gove,29,152,88,64,2006,total_driving,35
NA,T36,Eric Axley,29,153,61,92,2006,total_driving,T36
NA,T36,Alex Cejka,30,153,96,57,2006,total_driving,T36
NA,T36,Duffy Waldorf,28,153,115,38,2006,total_driving,T36
NA,39,Daisuke Maruyama,25,154,139,15,2006,total_driving,39
NA,40,Chris Couch,27,155,21,134,2006,total_driving,40
NA,41,Chris Riley,27,157,139,18,2006,total_driving,41
NA,42,Davis Love III,23,158,14,144,2006,total_driving,42
NA,43,J.P. Hayes,19,159,108,51,2006,total_driving,43
NA,T44,Brent Geiberger,30,161,113,48,2006,total_driving,T44
NA,T44,Sean O'Hair,30,161,71,90,2006,total_driving,T44
NA,46,Ted Purdy,33,162,101,61,2006,total_driving,46
NA,T47,Ryan Palmer,30,163,47,116,2006,total_driving,T47
NA,T47,David Toms,22,163,133,30,2006,total_driving,T47
NA,T49,Mathias Grönberg,30,164,54,110,2006,total_driving,T49
NA,T49,Matt Hansen,25,164,19,145,2006,total_driving,T49
NA,T51,Jason Gore,29,165,22,143,2006,total_driving,T51
NA,T51,Brandt Jobe,28,165,37,128,2006,total_driving,T51
NA,T53,Bart Bryant,26,167,156,11,2006,total_driving,T53
NA,T53,Jim Furyk,24,167,159,8,2006,total_driving,T53
NA,T53,D.J. Trahan,33,167,81,86,2006,total_driving,T53
NA,56,Heath Slocum,30,169,165,4,2006,total_driving,56
NA,T57,Zach Johnson,27,171,145,26,2006,total_driving,T57
NA,T57,Justin Rose,28,171,82,89,2006,total_driving,T57
NA,59,Geoff Ogilvy,20,172,53,119,2006,total_driving,59
NA,T60,Trevor Immelman,24,173,58,115,2006,total_driving,T60
NA,T60,Bo Van Pelt,28,173,35,138,2006,total_driving,T60
NA,62,Tjaart van der Walt,21,174,150,24,2006,total_driving,62
NA,63,Billy Mayfair,29,175,154,21,2006,total_driving,63
NA,T64,Patrick Sheehan,34,176,105,71,2006,total_driving,T64
NA,T64,Paul Stankowski,22,176,51,125,2006,total_driving,T64
NA,T66,Charley Hoffman,29,177,10,167,2006,total_driving,T66
NA,T66,Phil Mickelson,19,177,17,160,2006,total_driving,T66
NA,T66,Omar Uresti,22,177,171,6,2006,total_driving,T66
NA,T69,Skip Kendall,22,178,165,13,2006,total_driving,T69
NA,T69,Jeff Maggert,26,178,164,14,2006,total_driving,T69
NA,T69,Camilo Villegas,29,178,13,165,2006,total_driving,T69
NA,T72,Troy Matteson,32,179,28,151,2006,total_driving,T72
NA,T72,Kirk Triplett,18,179,168,11,2006,total_driving,T72
NA,T74,Robert Garrigus,28,180,3,177,2006,total_driving,T74
NA,T74,Frank Lickliter II,29,180,125,55,2006,total_driving,T74
NA,76,K.J. Choi,26,182,112,70,2006,total_driving,76
NA,T77,Jeff Brehaut,33,183,125,58,2006,total_driving,T77
NA,T77,Larry Mize,18,183,178,5,2006,total_driving,T77
NA,T77,Steve Stricker,17,183,134,49,2006,total_driving,T77
NA,T80,Kris Cox,28,184,30,154,2006,total_driving,T80
NA,T80,Richard Johnson,29,184,148,36,2006,total_driving,T80
NA,T80,David McKenzie,28,184,142,42,2006,total_driving,T80
NA,T80,Pat Perez,19,184,30,154,2006,total_driving,T80
NA,84,Brian Bateman,26,186,40,146,2006,total_driving,84
NA,85,Jeff Overton,28,187,26,161,2006,total_driving,85
NA,86,J.J. Henry,28,188,46,142,2006,total_driving,86
NA,T87,Stephen Ames,21,189,88,101,2006,total_driving,T87
NA,T87,Steve Flesch,33,189,124,65,2006,total_driving,T87
NA,T87,J.B. Holmes,26,189,2,187,2006,total_driving,T87
NA,T87,Bob May,21,189,71,118,2006,total_driving,T87
NA,T87,Scott Verplank,25,189,186,3,2006,total_driving,T87
NA,T92,Joe Ogilvie,29,192,107,85,2006,total_driving,T92
NA,T92,Bubba Watson,27,192,1,191,2006,total_driving,T92
NA,T94,Olin Browne,30,193,184,9,2006,total_driving,T94
NA,T94,Ron Whittaker,28,193,161,32,2006,total_driving,T94
NA,T96,John Daly,21,195,5,190,2006,total_driving,T96
NA,T96,Freddie Jacobson,18,195,84,111,2006,total_driving,T96
NA,T98,Fred Funk,29,196,194,2,2006,total_driving,T98
NA,T98,Tag Ridings,33,196,8,188,2006,total_driving,T98
NA,100,Luke Donald,18,197,145,52,2006,total_driving,100
NA,T101,Jerry Kelly,31,198,179,19,2006,total_driving,T101
NA,T101,Roger Tambellini,25,198,24,174,2006,total_driving,T101
NA,T103,John Cook,22,199,182,17,2006,total_driving,T103
NA,T103,Justin Leonard,26,199,154,45,2006,total_driving,T103
NA,T105,Arjun Atwal,33,200,102,98,2006,total_driving,T105
NA,T105,Sergio Garcia,17,200,71,129,2006,total_driving,T105
NA,T105,Thomas Levet,18,200,113,87,2006,total_driving,T105
NA,T108,Fred Couples,17,201,15,186,2006,total_driving,T108
NA,T108,Robert Gamez,30,201,174,27,2006,total_driving,T108
NA,T108,Ryan Hietala,23,201,7,194,2006,total_driving,T108
NA,T108,Mike Sposa,25,201,138,63,2006,total_driving,T108
NA,112,Paul Goydos,24,202,192,10,2006,total_driving,112
NA,T113,Marco Dawson,27,203,77,126,2006,total_driving,T113
NA,T113,Mark Wilson,24,203,157,46,2006,total_driving,T113
NA,115,Alex Aragon,26,204,12,192,2006,total_driving,115
NA,116,Jerry Smith,29,205,180,25,2006,total_driving,116
NA,T117,Tommy Armour III,25,206,152,54,2006,total_driving,T117
NA,T117,Danny Ellis,23,206,66,140,2006,total_driving,T117
NA,T117,David Howell,14,206,93,113,2006,total_driving,T117
NA,T117,D.A. Points,28,206,92,114,2006,total_driving,T117
NA,121,Bob Estes,25,207,120,87,2006,total_driving,121
NA,T122,Daniel Chopra,33,208,29,179,2006,total_driving,T122
NA,T122,Ian Leggatt,29,208,77,131,2006,total_driving,T122
NA,T124,Jesper Parnevik,24,209,86,123,2006,total_driving,T124
NA,T124,Joey Sindelar,29,209,143,66,2006,total_driving,T124
NA,T126,Retief Goosen,18,210,34,176,2006,total_driving,T126
NA,T126,Bill Haas,30,210,40,170,2006,total_driving,T126
NA,T126,Greg Kraft,26,210,187,23,2006,total_driving,T126
NA,T126,Jon Mills,27,210,32,178,2006,total_driving,T126
NA,130,Vaughn Taylor,26,212,115,97,2006,total_driving,130
NA,131,Tom Pernice Jr.,33,213,144,69,2006,total_driving,131
NA,132,Shaun Micheel,29,217,97,120,2006,total_driving,132
NA,133,Vijay Singh,27,218,65,153,2006,total_driving,133
NA,T134,Shane Bertsch,34,219,176,43,2006,total_driving,T134
NA,T134,Steve Lowery,31,219,110,109,2006,total_driving,T134
NA,T136,Mark Brooks,36,220,192,28,2006,total_driving,T136
NA,T136,Mark Calcavecchia,27,220,152,68,2006,total_driving,T136
NA,T136,Brian Gay,31,220,189,31,2006,total_driving,T136
NA,T136,Tim Herron,27,220,59,161,2006,total_driving,T136
NA,T140,Ben Crane,26,221,127,94,2006,total_driving,T140
NA,T140,Jason Schultz,28,221,69,152,2006,total_driving,T140
NA,142,Stewart Cink,26,223,75,148,2006,total_driving,142
NA,143,Ernie Els,18,225,54,171,2006,total_driving,143
NA,144,Tim Clark,22,227,183,44,2006,total_driving,144
NA,T145,Doug Barron,28,228,188,40,2006,total_driving,T145
NA,T145,David Duval,24,228,35,193,2006,total_driving,T145
NA,147,Craig Barlow,22,229,63,166,2006,total_driving,147
NA,148,Chad Campbell,25,230,83,147,2006,total_driving,148
NA,149,Woody Austin,31,231,102,129,2006,total_driving,149
NA,T150,Paul Azinger,30,233,127,106,2006,total_driving,T150
NA,T150,Ben Curtis,26,233,177,56,2006,total_driving,T150
NA,T150,Charles Howell III,30,233,51,182,2006,total_driving,T150
NA,T150,John Huston,27,233,75,158,2006,total_driving,T150
NA,154,Jimmy Walker,21,234,38,196,2006,total_driving,154
NA,T155,Aaron Baddeley,25,235,98,137,2006,total_driving,T155
NA,T155,Corey Pavin,23,235,196,39,2006,total_driving,T155
NA,157,Billy Andrade,24,236,132,104,2006,total_driving,157
NA,158,James Driscoll,29,238,43,195,2006,total_driving,158
NA,159,Bernhard Langer,24,239,127,112,2006,total_driving,159
NA,T160,Stuart Appleby,23,240,90,150,2006,total_driving,T160
NA,T160,Rod Pampling,24,240,99,141,2006,total_driving,T160
NA,162,Arron Oberholser,23,244,136,108,2006,total_driving,162
NA,T163,Shigeki Maruyama,30,245,122,123,2006,total_driving,T163
NA,T163,Dean Wilson,34,245,149,96,2006,total_driving,T163
NA,165,Michael Allen,25,246,79,167,2006,total_driving,165
NA,T166,Stephen Leaney,27,247,185,62,2006,total_driving,T166
NA,T166,Carl Pettersson,28,247,115,132,2006,total_driving,T166
NA,T166,Jeff Sluman,29,247,172,75,2006,total_driving,T166
NA,T169,Brett Quigley,33,248,91,157,2006,total_driving,T169
NA,T169,Mike Weir,24,248,165,83,2006,total_driving,T169
NA,171,"Wes Short, Jr.",33,249,80,169,2006,total_driving,171
NA,172,Tom Lehman,20,250,115,135,2006,total_driving,172
NA,173,Peter Lonard,22,251,170,81,2006,total_driving,173
NA,T174,Chris DiMarco,26,253,175,78,2006,total_driving,T174
NA,T174,Carlos Franco,29,253,68,185,2006,total_driving,T174
NA,T174,J.L. Lewis,17,253,173,80,2006,total_driving,T174
NA,T177,Nathan Green,30,257,157,100,2006,total_driving,T177
NA,T177,José María Olazábal,18,257,108,149,2006,total_driving,T177
NA,179,Steve Jones,27,258,181,77,2006,total_driving,179
NA,180,Tim Petrovic,30,261,168,93,2006,total_driving,180
NA,T181,Robert Damron,31,264,162,102,2006,total_driving,T181
NA,T181,Todd Fischer,35,264,190,74,2006,total_driving,T181
NA,183,Len Mattiace,22,265,85,180,2006,total_driving,183
NA,184,Bob Tway,25,266,139,127,2006,total_driving,184
NA,185,Rory Sabbatini,24,268,87,181,2006,total_driving,185
NA,186,"John Engler, Jr.",27,270,106,164,2006,total_driving,186
NA,187,Dudley Hart,29,285,122,163,2006,total_driving,187
NA,188,Michael Connell,22,292,159,133,2006,total_driving,188
NA,189,Ryuji Imada,31,296,137,159,2006,total_driving,189
NA,190,Vance Veazey,20,299,127,172,2006,total_driving,190
NA,191,Greg Chalmers,28,309,120,189,2006,total_driving,191
NA,192,Hidemichi Tanaka,31,318,162,156,2006,total_driving,192
NA,193,Todd Hamilton,27,331,147,184,2006,total_driving,193
NA,194,Lee Janzen,28,332,150,182,2006,total_driving,194
NA,195,Mark O'Meara,18,366,191,175,2006,total_driving,195
NA,196,Brad Faxon,26,368,195,173,2006,total_driving,196
NA,1,Charles Warren,29,59,9,50,2007,total_driving,1
NA,2,Mathew Goggin,30,70,26,44,2007,total_driving,2
NA,3,Hunter Mahan,27,73,36,37,2007,total_driving,3
NA,4,Jay Williamson,14,84,72,12,2007,total_driving,4
NA,5,Kenny Perry,24,104,22,82,2007,total_driving,5
NA,6,Cameron Beckman,29,109,69,40,2007,total_driving,6
NA,7,Jason Gore,27,110,8,102,2007,total_driving,7
NA,8,Sean O'Hair,28,113,34,79,2007,total_driving,8
NA,9,John Senden,27,115,55,60,2007,total_driving,9
NA,10,D.J. Trahan,30,116,48,68,2007,total_driving,10
NA,11,Boo Weekley,29,118,37,81,2007,total_driving,11
NA,12,Bill Haas,30,120,11,109,2007,total_driving,12
NA,13,Briny Baird,31,121,66,55,2007,total_driving,13
NA,14,Jeff Overton,19,122,24,98,2007,total_driving,14
NA,15,Matt Hendrix,24,129,15,114,2007,total_driving,15
NA,T16,Alex Cejka,25,130,94,36,2007,total_driving,T16
NA,T16,Greg Owen,29,130,40,90,2007,total_driving,T16
NA,18,Peter Lonard,27,131,80,51,2007,total_driving,18
NA,19,Jeff Brehaut,21,133,76,57,2007,total_driving,19
NA,T20,Lucas Glover,29,135,46,89,2007,total_driving,T20
NA,T20,Billy Mayfair,30,135,117,18,2007,total_driving,T20
NA,T22,Daisuke Maruyama,28,140,98,42,2007,total_driving,T22
NA,T22,Chris Stroud,24,140,87,53,2007,total_driving,T22
NA,24,Ted Purdy,33,142,57,85,2007,total_driving,24
NA,25,Kent Jones,30,143,111,32,2007,total_driving,25
NA,T26,Ken Duke,31,144,103,41,2007,total_driving,T26
NA,T26,Joe Durant,28,144,139,5,2007,total_driving,T26
NA,T26,Jim Rutledge,23,144,99,45,2007,total_driving,T26
NA,T29,Michael Allen,22,146,61,85,2007,total_driving,T29
NA,T29,Anthony Kim,26,146,12,134,2007,total_driving,T29
NA,31,Nick Watney,26,147,17,130,2007,total_driving,31
NA,T32,Jeff Gove,30,148,84,64,2007,total_driving,T32
NA,T32,J.J. Henry,26,148,54,94,2007,total_driving,T32
NA,34,Bubba Dickerson,19,149,25,124,2007,total_driving,34
NA,T35,Tommy Armour III,24,150,126,24,2007,total_driving,T35
NA,T35,Rich Beem,29,150,79,71,2007,total_driving,T35
NA,37,Robert Allenby,28,154,22,132,2007,total_driving,37
NA,38,David Branshaw,30,155,93,62,2007,total_driving,38
NA,39,Steve Allan,18,156,12,144,2007,total_driving,39
NA,40,Ryan Armour,32,157,135,22,2007,total_driving,40
NA,41,John Merrick,29,158,33,125,2007,total_driving,41
NA,42,Mark Calcavecchia,28,159,86,73,2007,total_driving,42
NA,T43,John Rollins,29,162,85,77,2007,total_driving,T43
NA,T43,Jaco Van Zyl,21,162,131,31,2007,total_driving,T43
NA,45,Tiger Woods,16,164,12,152,2007,total_driving,45
NA,46,Steve Marino,31,165,29,136,2007,total_driving,46
NA,47,Pat Perez,27,166,37,129,2007,total_driving,47
NA,48,Darron Stiles,24,167,134,33,2007,total_driving,48
NA,49,Bo Van Pelt,30,168,50,118,2007,total_driving,49
NA,T50,Steve Lowery,22,169,67,102,2007,total_driving,T50
NA,T50,Camilo Villegas,24,169,27,142,2007,total_driving,T50
NA,52,Mathias Grönberg,31,170,16,154,2007,total_driving,52
NA,T53,Tom Byrum,20,171,156,15,2007,total_driving,T53
NA,T53,J.B. Holmes,24,171,3,168,2007,total_driving,T53
NA,55,Justin Leonard,29,173,148,25,2007,total_driving,55
NA,T56,Jim Furyk,23,174,171,3,2007,total_driving,T56
NA,T56,Ryan Moore,28,174,82,92,2007,total_driving,T56
NA,T58,Craig Barlow,16,176,45,131,2007,total_driving,T58
NA,T58,Steve Wheatcroft,25,176,122,54,2007,total_driving,T58
NA,T58,Charlie Wi,27,176,124,52,2007,total_driving,T58
NA,T61,Zach Johnson,23,177,169,8,2007,total_driving,T61
NA,T61,George McNeill,30,177,28,149,2007,total_driving,T61
NA,T61,Shaun Micheel,29,177,138,39,2007,total_driving,T61
NA,T61,Brett Wetterich,28,177,7,170,2007,total_driving,T61
NA,T61,Mark Wilson,25,177,131,46,2007,total_driving,T61
NA,T66,Steve Elkington,25,178,164,14,2007,total_driving,T66
NA,T66,Adam Scott,19,178,18,160,2007,total_driving,T66
NA,T66,Heath Slocum,28,178,172,6,2007,total_driving,T66
NA,69,Bart Bryant,25,179,160,19,2007,total_driving,69
NA,T70,Michael Boyd,21,180,176,4,2007,total_driving,T70
NA,T70,Joey Sindelar,25,180,111,69,2007,total_driving,T70
NA,T72,Tag Ridings,18,181,6,175,2007,total_driving,T72
NA,T72,Jason Schultz,22,181,43,138,2007,total_driving,T72
NA,T72,Duffy Waldorf,23,181,107,74,2007,total_driving,T72
NA,75,Chris Tidland,21,182,62,120,2007,total_driving,75
NA,76,Jason Bohn,17,183,111,72,2007,total_driving,76
NA,T77,Glen Day,27,184,164,20,2007,total_driving,T77
NA,T77,Chris Riley,17,184,167,17,2007,total_driving,T77
NA,T79,Brian Davis,28,185,172,13,2007,total_driving,T79
NA,T79,Troy Matteson,26,185,37,148,2007,total_driving,T79
NA,T81,Robert Gamez,30,186,159,27,2007,total_driving,T81
NA,T81,Tom Johnson,27,186,103,83,2007,total_driving,T81
NA,T83,Paul Stankowski,18,188,43,145,2007,total_driving,T83
NA,T83,Scott Verplank,23,188,172,16,2007,total_driving,T83
NA,T83,Mike Weir,23,188,92,96,2007,total_driving,T83
NA,T86,John Mallinger,29,189,163,26,2007,total_driving,T86
NA,T86,Bubba Watson,26,189,1,188,2007,total_driving,T86
NA,88,Scott Gutschewski,22,190,5,185,2007,total_driving,88
NA,T89,Will MacKenzie,30,191,74,117,2007,total_driving,T89
NA,T89,Justin Rose,16,191,96,95,2007,total_driving,T89
NA,91,José Coceres,17,192,191,1,2007,total_driving,91
NA,92,Trevor Immelman,21,193,118,75,2007,total_driving,92
NA,T93,Fred Funk,22,195,193,2,2007,total_driving,T93
NA,T93,J.P. Hayes,28,195,69,126,2007,total_driving,T93
NA,T93,Charley Hoffman,30,195,19,176,2007,total_driving,T93
NA,T93,Tripp Isenhour,32,195,111,84,2007,total_driving,T93
NA,97,Jerry Kelly,28,196,162,34,2007,total_driving,97
NA,T98,Craig Bowden,25,197,190,7,2007,total_driving,T98
NA,T98,Robert Garrigus,28,197,4,193,2007,total_driving,T98
NA,T98,Michael Sim,17,197,78,119,2007,total_driving,T98
NA,T101,John Daly,24,198,2,196,2007,total_driving,T101
NA,T101,Doug LaBelle II,33,198,187,11,2007,total_driving,T101
NA,T101,Jarrod Lyle,24,198,65,133,2007,total_driving,T101
NA,T104,Mark Brooks,18,199,189,10,2007,total_driving,T104
NA,T104,Harrison Frazar,32,199,9,190,2007,total_driving,T104
NA,106,Michael Putnam,29,200,53,147,2007,total_driving,106
NA,107,Stephen Ames,23,201,154,47,2007,total_driving,107
NA,T108,Chris Couch,30,202,20,182,2007,total_driving,T108
NA,T108,Kyle Reifers,27,202,41,161,2007,total_driving,T108
NA,T108,Kirk Triplett,25,202,181,21,2007,total_driving,T108
NA,T111,Brian Gay,32,203,194,9,2007,total_driving,T111
NA,T111,Davis Love III,21,203,34,169,2007,total_driving,T111
NA,T111,Kevin Stadler,31,203,62,141,2007,total_driving,T111
NA,T114,Jeff Maggert,26,205,142,63,2007,total_driving,T114
NA,T114,Tom Pernice Jr.,31,205,156,49,2007,total_driving,T114
NA,116,Tim Clark,19,206,178,28,2007,total_driving,116
NA,T117,Steve Flesch,31,207,107,100,2007,total_driving,T117
NA,T117,Frank Lickliter II,30,207,142,65,2007,total_driving,T117
NA,T119,D.J. Brigman,22,210,94,116,2007,total_driving,T119
NA,T119,Ernie Els,16,210,31,179,2007,total_driving,T119
NA,T119,Phil Mickelson,22,210,29,181,2007,total_driving,T119
NA,122,Bob Heintz,27,211,133,78,2007,total_driving,122
NA,T123,Luke Donald,20,212,177,35,2007,total_driving,T123
NA,T123,Anders Hansen,17,212,164,48,2007,total_driving,T123
NA,T123,Geoff Ogilvy,22,212,47,165,2007,total_driving,T123
NA,T123,Kevin Sutherland,25,212,75,137,2007,total_driving,T123
NA,T127,Jeff Quinney,29,213,155,58,2007,total_driving,T127
NA,T127,Vijay Singh,27,213,58,155,2007,total_driving,T127
NA,129,Jesper Parnevik,27,214,99,115,2007,total_driving,129
NA,T130,Aaron Baddeley,23,215,69,146,2007,total_driving,T130
NA,T130,Charles Howell III,26,215,20,195,2007,total_driving,T130
NA,T132,Jonathan Byrd,23,216,67,149,2007,total_driving,T132
NA,T132,Mark Hensby,25,216,115,101,2007,total_driving,T132
NA,T132,Rocco Mediate,22,216,178,38,2007,total_driving,T132
NA,T135,Brendon de Jonge,26,217,58,159,2007,total_driving,T135
NA,T135,Johnson Wagner,33,217,129,88,2007,total_driving,T135
NA,T137,Gavin Coles,28,218,195,23,2007,total_driving,T137
NA,T137,Joe Ogilvie,31,218,91,127,2007,total_driving,T137
NA,139,Bob Estes,28,219,149,70,2007,total_driving,139
NA,140,Stuart Appleby,24,220,80,140,2007,total_driving,140
NA,T141,Andrew Buckle,26,221,50,171,2007,total_driving,T141
NA,T141,Daniel Chopra,34,221,32,189,2007,total_driving,T141
NA,T141,Paul Goydos,19,221,192,29,2007,total_driving,T141
NA,T141,Rod Pampling,25,221,119,102,2007,total_driving,T141
NA,T141,Henrik Stenson,15,221,41,180,2007,total_driving,T141
NA,T146,Kevin Na,27,222,109,113,2007,total_driving,T146
NA,T146,Ryan Palmer,30,222,49,173,2007,total_driving,T146
NA,148,K.J. Choi,25,223,144,79,2007,total_driving,148
NA,T149,Chad Campbell,28,225,115,110,2007,total_driving,T149
NA,T149,Jason Dufner,32,225,90,135,2007,total_driving,T149
NA,T151,Richard Johnson,32,226,160,66,2007,total_driving,T151
NA,T151,Corey Pavin,25,226,196,30,2007,total_driving,T151
NA,T151,David Toms,22,226,151,75,2007,total_driving,T151
NA,154,Woody Austin,27,227,122,105,2007,total_driving,154
NA,T155,Ben Curtis,25,228,185,43,2007,total_driving,T155
NA,T155,Tom Lehman,19,228,137,91,2007,total_driving,T155
NA,157,Tim Herron,27,232,110,122,2007,total_driving,157
NA,158,Stewart Cink,25,233,50,183,2007,total_driving,158
NA,T159,Padraig Harrington,18,234,60,174,2007,total_driving,T159
NA,T159,Freddie Jacobson,20,234,135,99,2007,total_driving,T159
NA,T159,Vaughn Taylor,28,234,147,87,2007,total_driving,T159
NA,162,Paul Gow,26,237,170,67,2007,total_driving,162
NA,163,Marco Dawson,23,238,89,149,2007,total_driving,163
NA,T164,Brian Bateman,18,239,72,167,2007,total_driving,T164
NA,T164,Sergio Garcia,19,239,55,184,2007,total_driving,T164
NA,166,Matt Kuchar,26,241,185,56,2007,total_driving,166
NA,167,Craig Kanada,34,242,183,59,2007,total_driving,167
NA,T168,Stephen Leaney,26,243,182,61,2007,total_driving,T168
NA,T168,Steve Stricker,23,243,146,97,2007,total_driving,T168
NA,170,Rory Sabbatini,23,250,88,162,2007,total_driving,170
NA,171,Craig Lile,24,251,145,106,2007,total_driving,171
NA,172,Arron Oberholser,21,252,129,123,2007,total_driving,172
NA,173,Retief Goosen,14,254,62,192,2007,total_driving,173
NA,174,Cliff Kresge,30,255,127,128,2007,total_driving,174
NA,175,Carl Pettersson,31,256,99,157,2007,total_driving,175
NA,176,Ian Poulter,18,258,151,107,2007,total_driving,176
NA,177,Nathan Green,29,259,139,120,2007,total_driving,177
NA,178,Tim Petrovic,32,262,119,143,2007,total_driving,178
NA,179,Bryce Molder,21,267,76,191,2007,total_driving,179
NA,T180,Lee Janzen,24,268,105,163,2007,total_driving,T180
NA,T180,Dicky Pride,25,268,156,112,2007,total_driving,T180
NA,T180,Brett Quigley,25,268,82,186,2007,total_driving,T180
NA,183,Todd Hamilton,28,273,96,177,2007,total_driving,183
NA,184,Dean Wilson,28,275,183,92,2007,total_driving,184
NA,T185,Billy Andrade,27,277,121,156,2007,total_driving,T185
NA,T185,Parker McLachlin,28,277,99,178,2007,total_driving,T185
NA,187,Bob Tway,32,278,139,139,2007,total_driving,187
NA,188,Brandt Snedeker,29,280,127,153,2007,total_driving,188
NA,189,Nick O'Hern,22,286,175,111,2007,total_driving,189
NA,190,Shigeki Maruyama,31,288,180,108,2007,total_driving,190
NA,191,Eric Axley,36,293,106,187,2007,total_driving,191
NA,192,Rich Barcelo,26,296,124,172,2007,total_driving,192
NA,193,Ryuji Imada,32,315,149,166,2007,total_driving,193
NA,194,Chris DiMarco,24,317,153,164,2007,total_driving,194
NA,195,Jeff Sluman,21,325,168,157,2007,total_driving,195
NA,196,José María Olazábal,16,382,188,194,2007,total_driving,196
NA,1,Jason Gore,33,56,15,41,2008,total_driving,1
NA,2,Charles Warren,29,85,10,75,2008,total_driving,2
NA,3,Nicholas Thompson,36,88,36,52,2008,total_driving,3
NA,4,John Merrick,28,100,20,80,2008,total_driving,4
NA,5,John Riegger,24,105,74,31,2008,total_driving,5
NA,6,Charley Hoffman,29,107,12,95,2008,total_driving,6
NA,7,Joe Durant,28,110,102,8,2008,total_driving,7
NA,8,Jeff Gove,18,114,103,11,2008,total_driving,8
NA,9,John Senden,28,116,81,35,2008,total_driving,9
NA,T10,Mathew Goggin,27,118,34,84,2008,total_driving,T10
NA,T10,John Rollins,28,118,80,38,2008,total_driving,T10
NA,12,Ryan Moore,24,122,56,66,2008,total_driving,12
NA,T13,Michael Allen,28,126,101,25,2008,total_driving,T13
NA,T13,Ryan Armour,32,126,103,23,2008,total_driving,T13
NA,15,Paul Casey,16,127,18,109,2008,total_driving,15
NA,16,Ben Crane,25,128,86,42,2008,total_driving,16
NA,T17,Todd Demsey,25,130,53,77,2008,total_driving,T17
NA,T17,John Huston,18,130,65,65,2008,total_driving,T17
NA,19,Robert Allenby,28,131,61,70,2008,total_driving,19
NA,20,J.J. Henry,34,132,61,71,2008,total_driving,20
NA,21,Nick Watney,27,135,7,128,2008,total_driving,21
NA,22,Rich Beem,29,136,88,48,2008,total_driving,22
NA,23,Hunter Mahan,27,137,75,62,2008,total_driving,23
NA,T24,Mathias Grönberg,30,140,38,102,2008,total_driving,T24
NA,T24,Steve Marino,32,140,49,91,2008,total_driving,T24
NA,T24,Charlie Wi,27,140,95,45,2008,total_driving,T24
NA,27,Pat Perez,27,141,44,97,2008,total_driving,27
NA,T28,Billy Mayfair,29,142,129,13,2008,total_driving,T28
NA,T28,Mark Wilson,29,142,122,20,2008,total_driving,T28
NA,30,Chad Campbell,28,143,75,68,2008,total_driving,30
NA,T31,Ryan Palmer,22,144,44,100,2008,total_driving,T31
NA,T31,D.J. Trahan,27,144,66,78,2008,total_driving,T31
NA,33,Martin Laird,29,145,31,114,2008,total_driving,33
NA,34,Boo Weekley,24,146,61,85,2008,total_driving,34
NA,35,Jay Williamson,33,147,123,24,2008,total_driving,35
NA,36,Lucas Glover,26,148,23,125,2008,total_driving,36
NA,37,Rod Pampling,28,151,82,69,2008,total_driving,37
NA,T38,Kenny Perry,26,153,33,120,2008,total_driving,T38
NA,T38,Chris Stroud,29,153,95,58,2008,total_driving,T38
NA,40,Harrison Frazar,23,154,14,140,2008,total_driving,40
NA,41,Kenneth Ferrie,25,155,119,36,2008,total_driving,41
NA,T42,Kent Jones,23,157,141,16,2008,total_driving,T42
NA,T42,Michael Letzig,29,157,69,88,2008,total_driving,T42
NA,T44,Jonathan Byrd,27,160,114,46,2008,total_driving,T44
NA,T44,Robert Gamez,26,160,153,7,2008,total_driving,T44
NA,T44,Jeff Maggert,28,160,110,50,2008,total_driving,T44
NA,47,Chez Reavie,30,161,152,9,2008,total_driving,47
NA,48,Nick Flanagan,29,164,60,104,2008,total_driving,48
NA,49,Troy Matteson,30,165,38,127,2008,total_driving,49
NA,T50,Steve Allan,21,166,5,161,2008,total_driving,T50
NA,T50,Jason Day,28,166,27,139,2008,total_driving,T50
NA,52,Heath Slocum,29,167,164,3,2008,total_driving,52
NA,53,Ben Curtis,22,168,121,47,2008,total_driving,53
NA,T54,Scott McCarron,22,169,139,30,2008,total_driving,T54
NA,T54,Joe Ogilvie,29,169,88,81,2008,total_driving,T54
NA,T54,Kevin Streelman,32,169,54,115,2008,total_driving,T54
NA,T57,Bart Bryant,23,170,166,4,2008,total_driving,T57
NA,T57,Steve Elkington,25,170,148,22,2008,total_driving,T57
NA,T57,Anthony Kim,22,170,11,159,2008,total_driving,T57
NA,T60,Bill Haas,31,171,29,142,2008,total_driving,T60
NA,T60,Davis Love III,23,171,9,162,2008,total_driving,T60
NA,62,Tommy Gainey,24,172,24,148,2008,total_driving,62
NA,63,Trevor Immelman,22,173,66,107,2008,total_driving,63
NA,T64,Woody Austin,30,174,114,60,2008,total_driving,T64
NA,T64,Tag Ridings,29,174,6,168,2008,total_driving,T64
NA,T64,Bo Van Pelt,32,174,58,116,2008,total_driving,T64
NA,67,Vijay Singh,23,175,25,150,2008,total_driving,67
NA,T68,Rory Sabbatini,23,176,58,118,2008,total_driving,T68
NA,T68,Scott Verplank,24,176,170,6,2008,total_driving,T68
NA,70,Briny Baird,30,177,116,61,2008,total_driving,70
NA,71,Todd Hamilton,28,180,129,51,2008,total_driving,71
NA,T72,Robert Garrigus,29,181,2,179,2008,total_driving,T72
NA,T72,Patrick Sheehan,35,181,125,56,2008,total_driving,T72
NA,74,Tom Scherrer,20,182,88,94,2008,total_driving,74
NA,T75,Tommy Armour III,25,183,88,95,2008,total_driving,T75
NA,T75,Brian Davis,34,183,173,10,2008,total_driving,T75
NA,T75,Tim Herron,28,183,52,131,2008,total_driving,T75
NA,T75,Tim Petrovic,32,183,129,54,2008,total_driving,T75
NA,T79,Ted Purdy,25,184,54,130,2008,total_driving,T79
NA,T79,Bubba Watson,29,184,1,183,2008,total_driving,T79
NA,T81,Fred Couples,18,185,16,169,2008,total_driving,T81
NA,T81,Kevin Stadler,30,185,68,117,2008,total_driving,T81
NA,T81,Omar Uresti,24,185,183,2,2008,total_driving,T81
NA,T84,Padraig Harrington,15,186,32,154,2008,total_driving,T84
NA,T84,Zach Johnson,25,186,181,5,2008,total_driving,T84
NA,86,Scott Sterling,28,188,125,63,2008,total_driving,86
NA,T87,Jim Furyk,26,190,162,28,2008,total_driving,T87
NA,T87,Doug LaBelle II,22,190,153,37,2008,total_driving,T87
NA,T89,Justin Bolli,28,191,125,66,2008,total_driving,T89
NA,T89,Ron Whittaker,22,191,177,14,2008,total_driving,T89
NA,T91,Cameron Beckman,29,192,150,42,2008,total_driving,T91
NA,T91,George McNeill,29,192,40,152,2008,total_driving,T91
NA,T91,Kevin Sutherland,26,192,71,121,2008,total_driving,T91
NA,T91,Vaughn Taylor,32,192,82,110,2008,total_driving,T91
NA,T95,Adam Scott,15,193,8,185,2008,total_driving,T95
NA,T95,Y.E. Yang,29,193,100,93,2008,total_driving,T95
NA,T97,Olin Browne,27,195,194,1,2008,total_driving,T97
NA,T97,Dustin Johnson,30,195,4,191,2008,total_driving,T97
NA,T97,John Mallinger,29,195,169,26,2008,total_driving,T97
NA,T97,Nick O'Hern,26,195,183,12,2008,total_driving,T97
NA,T97,Marc Turnesa,29,195,117,78,2008,total_driving,T97
NA,T102,Sergio Garcia,19,196,43,153,2008,total_driving,T102
NA,T102,Justin Leonard,25,196,156,40,2008,total_driving,T102
NA,104,Kevin Na,29,197,158,39,2008,total_driving,104
NA,T105,Paul Claxton,23,198,180,18,2008,total_driving,T105
NA,T105,J.B. Holmes,26,198,3,195,2008,total_driving,T105
NA,T105,Brandt Jobe,19,198,21,177,2008,total_driving,T105
NA,108,Bob Estes,28,201,145,56,2008,total_driving,108
NA,109,Brad Elder,23,202,78,124,2008,total_driving,109
NA,T110,Jason Allred,23,206,22,184,2008,total_driving,T110
NA,T110,Travis Perkins,23,206,16,190,2008,total_driving,T110
NA,T112,Frank Lickliter II,32,207,125,82,2008,total_driving,T112
NA,T112,Sean O'Hair,25,207,69,138,2008,total_driving,T112
NA,T114,Shane Bertsch,29,208,187,21,2008,total_driving,T114
NA,T114,Alejandro Cañizares,16,208,97,111,2008,total_driving,T114
NA,T116,Ángel Cabrera,17,209,13,196,2008,total_driving,T116
NA,T116,Stewart Cink,23,209,28,181,2008,total_driving,T116
NA,T116,Paul Goydos,25,209,190,19,2008,total_driving,T116
NA,T116,Jon Mills,32,209,51,158,2008,total_driving,T116
NA,120,Gavin Coles,16,210,195,15,2008,total_driving,120
NA,T121,Brenden Pappas,24,211,42,169,2008,total_driving,T121
NA,T121,Andres Romero,20,211,19,192,2008,total_driving,T121
NA,T121,Bob Tway,20,211,167,44,2008,total_driving,T121
NA,T124,Mark Calcavecchia,25,213,139,74,2008,total_driving,T124
NA,T124,Brian Gay,31,213,196,17,2008,total_driving,T124
NA,T124,Will MacKenzie,21,213,108,105,2008,total_driving,T124
NA,T124,Jeff Overton,32,213,26,187,2008,total_driving,T124
NA,128,Glen Day,19,215,183,32,2008,total_driving,128
NA,T129,David Lutterus,23,216,84,132,2008,total_driving,T129
NA,T129,Phil Mickelson,21,216,35,181,2008,total_driving,T129
NA,T129,Brett Quigley,25,216,94,122,2008,total_driving,T129
NA,T129,Camilo Villegas,22,216,50,166,2008,total_driving,T129
NA,T133,Richard Johnson,29,217,29,188,2008,total_driving,T133
NA,T133,Peter Lonard,30,217,153,64,2008,total_driving,T133
NA,T135,Alex Cejka,25,218,142,76,2008,total_driving,T135
NA,T135,David Toms,20,218,146,72,2008,total_driving,T135
NA,T135,Tim Wilkinson,29,218,165,53,2008,total_driving,T135
NA,T138,Craig Kanada,23,219,192,27,2008,total_driving,T138
NA,T138,Jin Park,30,219,186,33,2008,total_driving,T138
NA,T138,Bob Sowards,22,219,84,135,2008,total_driving,T138
NA,T138,Kyle Thompson,26,219,111,108,2008,total_driving,T138
NA,T142,J.P. Hayes,26,222,124,98,2008,total_driving,T142
NA,T142,Geoff Ogilvy,20,222,57,165,2008,total_driving,T142
NA,T144,Aaron Baddeley,22,223,73,150,2008,total_driving,T144
NA,T144,Charles Howell III,31,223,48,175,2008,total_driving,T144
NA,T144,Greg Kraft,21,223,189,34,2008,total_driving,T144
NA,T144,Chris Riley,17,223,168,55,2008,total_driving,T144
NA,148,Mike Weir,26,225,119,106,2008,total_driving,148
NA,149,Corey Pavin,20,226,197,29,2008,total_driving,149
NA,T150,James Driscoll,28,229,40,189,2008,total_driving,T150
NA,T150,Jesper Parnevik,29,229,93,136,2008,total_driving,T150
NA,T150,Jimmy Walker,24,229,36,193,2008,total_driving,T150
NA,153,Ken Duke,33,230,118,112,2008,total_driving,153
NA,154,K.J. Choi,21,232,106,126,2008,total_driving,154
NA,T155,Lee Janzen,28,233,132,101,2008,total_driving,T155
NA,T155,Matt Jones,31,233,47,186,2008,total_driving,T155
NA,T157,Richard Johnson,21,235,146,89,2008,total_driving,T157
NA,T157,Jerry Kelly,31,235,176,59,2008,total_driving,T157
NA,T157,Tom Lehman,17,235,148,87,2008,total_driving,T157
NA,T160,Stephen Ames,24,236,133,103,2008,total_driving,T160
NA,T160,Stuart Appleby,23,236,72,164,2008,total_driving,T160
NA,162,Ernie Els,16,237,64,173,2008,total_driving,162
NA,163,Daniel Chopra,27,238,44,194,2008,total_driving,163
NA,164,Mark Hensby,26,239,79,160,2008,total_driving,164
NA,T165,Tim Clark,27,240,157,83,2008,total_driving,T165
NA,T165,Stephen Leaney,17,240,191,49,2008,total_driving,T165
NA,167,Brad Adamonis,29,242,75,167,2008,total_driving,167
NA,168,Steve Lowery,25,243,99,144,2008,total_driving,168
NA,169,Marco Dawson,21,247,106,141,2008,total_driving,169
NA,170,Tom Pernice Jr.,30,251,161,90,2008,total_driving,170
NA,171,Carl Pettersson,29,253,108,145,2008,total_driving,171
NA,T172,Matt Kuchar,27,255,182,73,2008,total_driving,T172
NA,T172,Jim McGovern,26,255,163,92,2008,total_driving,T172
NA,174,Rocco Mediate,27,256,170,86,2008,total_driving,174
NA,175,Cody Freeman,26,257,86,171,2008,total_driving,175
NA,176,Parker McLachlin,27,262,105,157,2008,total_driving,176
NA,177,Eric Axley,35,264,88,176,2008,total_driving,177
NA,T178,Retief Goosen,18,271,97,174,2008,total_driving,T178
NA,T178,Cliff Kresge,28,271,158,113,2008,total_driving,T178
NA,T178,Johnson Wagner,26,271,138,133,2008,total_driving,T178
NA,181,Chris DiMarco,29,274,175,99,2008,total_driving,181
NA,182,Carlos Franco,25,275,112,163,2008,total_driving,182
NA,183,Ian Poulter,15,281,135,146,2008,total_driving,183
NA,184,Nathan Green,30,283,134,149,2008,total_driving,184
NA,T185,Steve Flesch,29,284,150,134,2008,total_driving,T185
NA,T185,Freddie Jacobson,24,284,142,142,2008,total_driving,T185
NA,187,Billy Andrade,24,292,137,155,2008,total_driving,187
NA,188,Brandt Snedeker,26,297,160,137,2008,total_driving,188
NA,189,Dean Wilson,32,301,178,123,2008,total_driving,189
NA,190,Dudley Hart,22,308,179,129,2008,total_driving,190
NA,191,David Duval,20,310,113,197,2008,total_driving,191
NA,192,Jeff Quinney,28,312,193,119,2008,total_driving,192
NA,193,Steve Stricker,22,313,135,178,2008,total_driving,193
NA,194,Ryuji Imada,25,317,170,147,2008,total_driving,194
NA,195,Brett Rumford,26,322,142,180,2008,total_driving,195
NA,196,Chad Collins,24,330,174,156,2008,total_driving,196
NA,197,Shigeki Maruyama,18,360,188,172,2008,total_driving,197
NA,1,Jonathan Byrd,25,92,33,59,2009,total_driving,1
NA,2,Lucas Glover,26,95,25,70,2009,total_driving,2
NA,T3,Kenny Perry,24,97,48,49,2009,total_driving,T3
NA,T3,John Rollins,27,97,30,67,2009,total_driving,T3
NA,T5,Robert Allenby,21,98,48,50,2009,total_driving,T5
NA,T5,Boo Weekley,22,98,62,36,2009,total_driving,T5
NA,7,Hunter Mahan,25,102,28,74,2009,total_driving,7
NA,T8,Ryan Moore,27,104,33,71,2009,total_driving,T8
NA,T8,Greg Owen,30,104,59,45,2009,total_driving,T8
NA,T8,Heath Slocum,30,104,97,7,2009,total_driving,T8
NA,11,Kirk Triplett,20,105,100,5,2009,total_driving,11
NA,12,Tiger Woods,17,107,21,86,2009,total_driving,12
NA,13,Charles Warren,20,111,18,93,2009,total_driving,13
NA,14,Scott McCarron,27,117,114,3,2009,total_driving,14
NA,15,John Senden,29,118,40,78,2009,total_driving,15
NA,16,Michael Allen,22,119,80,39,2009,total_driving,16
NA,T17,Martin Laird,24,121,14,107,2009,total_driving,T17
NA,T17,Jeff Maggert,28,121,83,38,2009,total_driving,T17
NA,19,Kris Blanks,20,122,65,57,2009,total_driving,19
NA,20,David Toms,27,123,119,4,2009,total_driving,20
NA,21,Bo Van Pelt,30,124,56,68,2009,total_driving,21
NA,T22,Jason Bohn,25,126,108,18,2009,total_driving,T22
NA,T22,D.J. Trahan,30,126,79,47,2009,total_driving,T22
NA,T24,Tommy Armour III,19,129,95,34,2009,total_driving,T24
NA,T24,Nicholas Thompson,31,129,38,91,2009,total_driving,T24
NA,26,Mathew Goggin,26,131,69,62,2009,total_driving,26
NA,T27,Jason Gore,24,132,72,60,2009,total_driving,T27
NA,T27,Bill Haas,29,132,22,110,2009,total_driving,T27
NA,29,Ted Purdy,30,134,45,89,2009,total_driving,29
NA,T30,Steve Marino,29,139,35,104,2009,total_driving,T30
NA,T30,Billy Mayfair,28,139,119,20,2009,total_driving,T30
NA,32,Will MacKenzie,24,140,78,62,2009,total_driving,32
NA,33,Steve Elkington,23,142,107,35,2009,total_driving,33
NA,34,Steve Lowery,27,143,74,69,2009,total_driving,34
NA,35,Peter Tomasulo,25,144,50,94,2009,total_driving,35
NA,36,Ernie Els,19,145,68,77,2009,total_driving,36
NA,T37,Troy Matteson,30,146,9,137,2009,total_driving,T37
NA,T37,Mark Wilson,28,146,118,28,2009,total_driving,T37
NA,39,Jason Dufner,26,148,102,46,2009,total_driving,39
NA,T40,Bill Lunde,27,149,57,92,2009,total_driving,T40
NA,T40,Jay Williamson,22,149,123,26,2009,total_driving,T40
NA,42,Ben Crane,27,150,109,41,2009,total_driving,42
NA,43,Tim Clark,23,152,150,2,2009,total_driving,43
NA,44,Zach Johnson,26,153,143,10,2009,total_driving,44
NA,T45,John Merrick,28,154,29,125,2009,total_driving,T45
NA,T45,Ryan Palmer,26,154,26,128,2009,total_driving,T45
NA,47,Justin Leonard,26,155,123,32,2009,total_driving,47
NA,T48,Sergio Garcia,17,156,18,138,2009,total_driving,T48
NA,T48,Scott Verplank,24,156,145,11,2009,total_driving,T48
NA,T50,Davis Love III,27,157,14,143,2009,total_driving,T50
NA,T50,Steve Stricker,22,157,104,53,2009,total_driving,T50
NA,T52,Joe Durant,20,158,157,1,2009,total_driving,T52
NA,T52,Marc Leishman,28,158,17,141,2009,total_driving,T52
NA,54,Kevin Streelman,29,159,30,129,2009,total_driving,54
NA,T55,Jeff Klauk,29,160,147,13,2009,total_driving,T55
NA,T55,Matt Weibring,22,160,84,76,2009,total_driving,T55
NA,57,Nick Watney,24,161,6,155,2009,total_driving,57
NA,T58,Robert Garrigus,25,162,1,161,2009,total_driving,T58
NA,T58,Patrick Sheehan,15,162,146,16,2009,total_driving,T58
NA,60,Charlie Wi,28,164,112,52,2009,total_driving,60
NA,61,Darron Stiles,20,165,153,12,2009,total_driving,61
NA,T62,Stephen Ames,23,167,94,73,2009,total_driving,T62
NA,T62,Alex Cejka,25,167,143,24,2009,total_driving,T62
NA,T62,Charley Hoffman,27,167,11,156,2009,total_driving,T62
NA,65,Kent Jones,24,168,141,27,2009,total_driving,65
NA,T66,Sean O'Hair,23,169,46,123,2009,total_driving,T66
NA,T66,Tag Ridings,16,169,4,165,2009,total_driving,T66
NA,T66,Justin Rose,22,169,90,79,2009,total_driving,T66
NA,69,J.J. Henry,28,171,44,127,2009,total_driving,69
NA,T70,Jason Day,18,172,36,136,2009,total_driving,T70
NA,T70,Dustin Johnson,25,172,3,169,2009,total_driving,T70
NA,T70,Vijay Singh,21,172,41,131,2009,total_driving,T70
NA,T70,Chris Stroud,28,172,72,100,2009,total_driving,T70
NA,T70,Johnson Wagner,26,172,88,84,2009,total_driving,T70
NA,T75,Chad Campbell,26,173,70,103,2009,total_driving,T75
NA,T75,Chez Reavie,27,173,154,19,2009,total_driving,T75
NA,77,James Nitties,27,174,63,111,2009,total_driving,77
NA,T78,Chris Riley,22,176,167,9,2009,total_driving,T78
NA,T78,Camilo Villegas,21,176,50,126,2009,total_driving,T78
NA,T80,Bob Estes,23,177,137,40,2009,total_driving,T80
NA,T80,Jim Furyk,23,177,152,25,2009,total_driving,T80
NA,T80,Colt Knost,24,177,154,23,2009,total_driving,T80
NA,T80,Michael Letzig,28,177,43,134,2009,total_driving,T80
NA,T84,Brian Davis,32,178,127,51,2009,total_driving,T84
NA,T84,D.A. Points,29,178,141,37,2009,total_driving,T84
NA,86,Scott Piercy,28,179,12,167,2009,total_driving,86
NA,87,Bubba Watson,24,180,2,178,2009,total_driving,87
NA,T88,Harrison Frazar,28,182,10,172,2009,total_driving,T88
NA,T88,Gary Woodland,18,182,5,177,2009,total_driving,T88
NA,90,Bart Bryant,17,183,175,8,2009,total_driving,90
NA,T91,Daniel Chopra,28,185,26,159,2009,total_driving,T91
NA,T91,Adam Scott,19,185,37,148,2009,total_driving,T91
NA,T91,Vaughn Taylor,28,185,129,56,2009,total_driving,T91
NA,94,Briny Baird,28,186,138,48,2009,total_driving,94
NA,T95,Bob Heintz,20,187,123,64,2009,total_driving,T95
NA,T95,Rod Pampling,23,187,90,97,2009,total_driving,T95
NA,T97,Stewart Cink,22,188,39,149,2009,total_driving,T97
NA,T97,Tim Petrovic,31,188,133,55,2009,total_driving,T97
NA,T99,Ángel Cabrera,17,189,8,181,2009,total_driving,T99
NA,T99,Brian Gay,27,189,183,6,2009,total_driving,T99
NA,T101,Fred Couples,16,190,24,166,2009,total_driving,T101
NA,T101,Brandt Snedeker,26,190,169,21,2009,total_driving,T101
NA,T103,J.B. Holmes,25,191,7,184,2009,total_driving,T103
NA,T103,Anthony Kim,22,191,16,175,2009,total_driving,T103
NA,T103,Brian Vranesh,20,191,89,102,2009,total_driving,T103
NA,T103,Casey Wittenberg,25,191,109,82,2009,total_driving,T103
NA,T107,Matt Jones,17,192,23,169,2009,total_driving,T107
NA,T107,Phil Mickelson,18,192,13,179,2009,total_driving,T107
NA,T107,Kevin Stadler,20,192,75,117,2009,total_driving,T107
NA,T107,Kevin Sutherland,27,192,80,112,2009,total_driving,T107
NA,T111,K.J. Choi,22,193,150,43,2009,total_driving,T111
NA,T111,Jerry Kelly,26,193,114,79,2009,total_driving,T111
NA,T113,Matt Kuchar,24,194,128,66,2009,total_driving,T113
NA,T113,Bryce Molder,21,194,129,65,2009,total_driving,T113
NA,T115,Glen Day,26,195,174,21,2009,total_driving,T115
NA,T115,John Mallinger,27,195,164,31,2009,total_driving,T115
NA,T117,Brendon de Jonge,29,196,75,121,2009,total_driving,T117
NA,T117,Todd Hamilton,29,196,113,83,2009,total_driving,T117
NA,T117,Tom Lehman,16,196,179,17,2009,total_driving,T117
NA,T117,George McNeill,26,196,61,135,2009,total_driving,T117
NA,T117,Pat Perez,22,196,87,109,2009,total_driving,T117
NA,T122,Woody Austin,24,197,99,98,2009,total_driving,T122
NA,T122,Mark Brooks,17,197,182,15,2009,total_driving,T122
NA,T122,Retief Goosen,20,197,58,139,2009,total_driving,T122
NA,T125,Leif Olson,21,198,30,168,2009,total_driving,T125
NA,T125,Corey Pavin,23,198,184,14,2009,total_driving,T125
NA,T125,Andres Romero,20,198,18,180,2009,total_driving,T125
NA,T128,Charles Howell III,29,199,53,146,2009,total_driving,T128
NA,T128,Nick O'Hern,27,199,170,29,2009,total_driving,T128
NA,130,Y.E. Yang,23,200,67,133,2009,total_driving,130
NA,T131,Matt Bettencourt,31,201,52,149,2009,total_driving,T131
NA,T131,Rory Sabbatini,25,201,47,154,2009,total_driving,T131
NA,133,Paul Goydos,25,202,172,30,2009,total_driving,133
NA,T134,Rich Beem,26,203,114,89,2009,total_driving,T134
NA,T134,Scott Sterling,16,203,109,94,2009,total_driving,T134
NA,136,Ricky Barnes,23,207,55,152,2009,total_driving,136
NA,137,Ian Poulter,17,208,133,75,2009,total_driving,137
NA,138,Richard Johnson,26,209,176,33,2009,total_driving,138
NA,139,Rick Price,21,210,166,44,2009,total_driving,139
NA,140,Chris DiMarco,29,211,157,54,2009,total_driving,140
NA,141,Tim Herron,27,212,59,153,2009,total_driving,141
NA,142,Geoff Ogilvy,20,214,63,151,2009,total_driving,142
NA,T143,Cameron Beckman,26,215,97,118,2009,total_driving,T143
NA,T143,Peter Lonard,30,215,157,58,2009,total_driving,T143
NA,T143,Jeff Overton,28,215,41,174,2009,total_driving,T143
NA,146,Rocco Mediate,22,217,129,88,2009,total_driving,146
NA,T147,Greg Chalmers,26,218,119,99,2009,total_driving,T147
NA,T147,Marc Turnesa,30,218,157,61,2009,total_driving,T147
NA,T149,Stuart Appleby,25,219,77,142,2009,total_driving,T149
NA,T149,Jarrod Lyle,21,219,95,124,2009,total_driving,T149
NA,T149,Jeff Quinney,26,219,177,42,2009,total_driving,T149
NA,152,Cliff Kresge,28,221,149,72,2009,total_driving,152
NA,153,Joe Ogilvie,29,223,65,158,2009,total_driving,153
NA,154,Steve Flesch,27,225,117,108,2009,total_driving,154
NA,155,Tom Pernice Jr.,26,226,140,86,2009,total_driving,155
NA,156,Mark Calcavecchia,23,234,104,130,2009,total_driving,156
NA,157,David Duval,22,236,53,183,2009,total_driving,157
NA,158,Brett Quigley,28,237,93,144,2009,total_driving,158
NA,159,Ben Curtis,18,238,157,81,2009,total_driving,159
NA,160,Kevin Na,26,240,136,104,2009,total_driving,160
NA,T161,Brad Adamonis,25,242,82,160,2009,total_driving,T161
NA,T161,Ken Duke,29,242,129,113,2009,total_driving,T161
NA,T161,Webb Simpson,30,242,102,140,2009,total_driving,T161
NA,164,Carl Pettersson,29,243,86,157,2009,total_driving,164
NA,165,Jimmy Walker,24,246,70,176,2009,total_driving,165
NA,166,Brian Bateman,25,248,84,164,2009,total_driving,166
NA,167,Aron Price,27,250,154,96,2009,total_driving,167
NA,168,Lee Janzen,23,254,139,115,2009,total_driving,168
NA,T169,Aaron Baddeley,23,255,92,163,2009,total_driving,T169
NA,T169,Nathan Green,30,255,123,132,2009,total_driving,T169
NA,171,Derek Fathauer,25,262,100,162,2009,total_driving,171
NA,172,David Mathis,27,264,148,116,2009,total_driving,172
NA,173,Dean Wilson,29,266,181,85,2009,total_driving,173
NA,T174,Freddie Jacobson,25,269,122,147,2009,total_driving,T174
NA,T174,Mike Weir,24,269,163,106,2009,total_driving,T174
NA,176,Padraig Harrington,20,277,106,171,2009,total_driving,176
NA,177,Greg Kraft,21,279,178,101,2009,total_driving,177
NA,178,Spencer Levin,25,284,165,119,2009,total_driving,178
NA,179,Luke Donald,21,287,173,114,2009,total_driving,179
NA,180,Ryuji Imada,25,290,168,122,2009,total_driving,180
NA,181,Brendon Todd,21,291,171,120,2009,total_driving,181
NA,182,Eric Axley,30,315,133,182,2009,total_driving,182
NA,183,Brad Faxon,23,324,180,144,2009,total_driving,183
NA,184,Parker McLachlin,25,330,157,173,2009,total_driving,184
NA,1,Charles Warren,21,70,9,61,2010,total_driving,1
NA,2,Graham DeLaet,28,84,6,78,2010,total_driving,2
NA,3,Hunter Mahan,25,95,57,38,2010,total_driving,3
NA,T4,Davis Love III,24,102,17,85,2010,total_driving,T4
NA,T4,Boo Weekley,27,102,55,47,2010,total_driving,T4
NA,6,Kenny Perry,20,104,68,36,2010,total_driving,6
NA,7,John Rollins,26,110,30,80,2010,total_driving,7
NA,T8,Chris Couch,23,111,49,62,2010,total_driving,T8
NA,T8,Ryan Moore,24,111,75,36,2010,total_driving,T8
NA,10,John Merrick,31,113,60,53,2010,total_driving,10
NA,T11,Blake Adams,26,115,63,52,2010,total_driving,T11
NA,T11,Steve Elkington,22,115,80,35,2010,total_driving,T11
NA,T11,Tom Gillis,27,115,86,29,2010,total_driving,T11
NA,T14,Joe Durant,19,118,116,2,2010,total_driving,T14
NA,T14,John Senden,30,118,72,46,2010,total_driving,T14
NA,16,J.J. Henry,27,120,46,74,2010,total_driving,16
NA,17,Jarrod Lyle,18,122,23,99,2010,total_driving,17
NA,T18,Mathias Grönberg,22,123,40,83,2010,total_driving,T18
NA,T18,Will MacKenzie,23,123,66,57,2010,total_driving,T18
NA,T18,Bo Van Pelt,28,123,53,70,2010,total_driving,T18
NA,21,Rory McIlroy,16,127,12,115,2010,total_driving,21
NA,22,Bill Haas,25,130,42,88,2010,total_driving,22
NA,23,Scott McCarron,29,131,88,43,2010,total_driving,23
NA,24,Rickie Fowler,28,133,47,86,2010,total_driving,24
NA,25,Kevin Streelman,28,134,70,64,2010,total_driving,25
NA,T26,Retief Goosen,19,136,60,76,2010,total_driving,T26
NA,T26,Nick Watney,24,136,20,116,2010,total_driving,T26
NA,T28,Lucas Glover,23,138,27,111,2010,total_driving,T28
NA,T28,Paul Stankowski,18,138,70,68,2010,total_driving,T28
NA,30,Jay Williamson,24,139,119,20,2010,total_driving,30
NA,T31,Stewart Cink,23,141,49,92,2010,total_driving,T31
NA,T31,Billy Mayfair,26,141,124,17,2010,total_driving,T31
NA,T31,Josh Teater,31,141,44,97,2010,total_driving,T31
NA,34,Sergio Garcia,15,142,47,95,2010,total_driving,34
NA,T35,Charley Hoffman,24,143,15,128,2010,total_driving,T35
NA,T35,Adam Scott,20,143,33,110,2010,total_driving,T35
NA,T35,D.J. Trahan,27,143,10,133,2010,total_driving,T35
NA,T38,Chad Campbell,28,144,119,25,2010,total_driving,T38
NA,T38,Matt Kuchar,26,144,105,39,2010,total_driving,T38
NA,T40,Ben Crane,24,145,136,9,2010,total_driving,T40
NA,T40,Kevin Sutherland,25,145,96,49,2010,total_driving,T40
NA,42,Mathew Goggin,28,147,78,69,2010,total_driving,42
NA,43,David Toms,25,151,144,7,2010,total_driving,43
NA,44,Vijay Singh,24,153,51,102,2010,total_driving,44
NA,45,Vaughn Taylor,26,155,122,33,2010,total_driving,45
NA,46,Cliff Kresge,17,156,128,28,2010,total_driving,46
NA,47,Robert Allenby,22,159,82,77,2010,total_driving,47
NA,48,Kris Blanks,30,161,110,51,2010,total_driving,48
NA,T49,Jason Dufner,25,164,140,24,2010,total_driving,T49
NA,T49,Zach Johnson,25,164,156,8,2010,total_driving,T49
NA,T49,Martin Laird,26,164,20,144,2010,total_driving,T49
NA,T49,Troy Matteson,28,164,22,142,2010,total_driving,T49
NA,T49,Steve Stricker,19,164,134,30,2010,total_driving,T49
NA,T54,Aron Price,22,166,121,45,2010,total_driving,T54
NA,T54,Brett Wetterich,16,166,4,162,2010,total_driving,T54
NA,T56,Garth Mulroy,19,167,29,138,2010,total_driving,T56
NA,T56,Garrett Willis,24,167,153,14,2010,total_driving,T56
NA,T58,Paul Casey,17,169,35,134,2010,total_driving,T58
NA,T58,Justin Rose,22,169,97,72,2010,total_driving,T58
NA,T58,Heath Slocum,25,169,163,6,2010,total_driving,T58
NA,T61,Brendon de Jonge,32,170,105,65,2010,total_driving,T61
NA,T61,Sean O'Hair,25,170,78,92,2010,total_driving,T61
NA,T61,Y.E. Yang,21,170,88,82,2010,total_driving,T61
NA,T64,Henrik Bjornstad,26,171,93,78,2010,total_driving,T64
NA,T64,Roger Tambellini,26,171,53,118,2010,total_driving,T64
NA,T64,Nicholas Thompson,29,171,80,91,2010,total_driving,T64
NA,67,Pat Perez,27,172,102,70,2010,total_driving,67
NA,T68,Jerry Kelly,29,173,160,13,2010,total_driving,T68
NA,T68,Michael Letzig,27,173,75,98,2010,total_driving,T68
NA,T70,Dustin Johnson,23,175,3,172,2010,total_driving,T70
NA,T70,John Mallinger,29,175,152,23,2010,total_driving,T70
NA,T70,James Nitties,30,175,112,63,2010,total_driving,T70
NA,T73,Robert Garrigus,22,176,1,175,2010,total_driving,T73
NA,T73,Mark Wilson,28,176,150,26,2010,total_driving,T73
NA,T75,Jason Day,24,178,15,163,2010,total_driving,T75
NA,T75,Chris DiMarco,25,178,160,18,2010,total_driving,T75
NA,T75,Skip Kendall,18,178,157,21,2010,total_driving,T75
NA,T75,Bubba Watson,22,178,2,176,2010,total_driving,T75
NA,79,Kevin Stadler,28,180,72,108,2010,total_driving,79
NA,80,Dean Wilson,18,183,142,41,2010,total_driving,80
NA,81,Aaron Baddeley,26,184,14,170,2010,total_driving,81
NA,82,Alex Prugh,28,185,27,158,2010,total_driving,82
NA,83,Richard Johnson,27,186,175,11,2010,total_driving,83
NA,84,Matt Every,18,187,64,123,2010,total_driving,84
NA,85,J.B. Holmes,26,188,5,183,2010,total_driving,85
NA,T86,Alex Cejka,28,189,173,16,2010,total_driving,T86
NA,T86,Jim Furyk,21,189,179,10,2010,total_driving,T86
NA,T86,Cameron Tringale,22,189,32,157,2010,total_driving,T86
NA,T89,Ángel Cabrera,19,190,8,182,2010,total_driving,T89
NA,T89,Marc Leishman,26,190,31,159,2010,total_driving,T89
NA,T89,Greg Owen,27,190,60,130,2010,total_driving,T89
NA,T89,Ryan Palmer,27,190,26,164,2010,total_driving,T89
NA,T89,Omar Uresti,27,190,189,1,2010,total_driving,T89
NA,T94,K.J. Choi,22,191,131,60,2010,total_driving,T94
NA,T94,Steve Wheatcroft,27,191,102,89,2010,total_driving,T94
NA,T96,Tim Clark,24,192,188,4,2010,total_driving,T96
NA,T96,Steve Marino,24,192,68,124,2010,total_driving,T96
NA,T96,Rod Pampling,26,192,126,66,2010,total_driving,T96
NA,T96,Cameron Percy,25,192,36,156,2010,total_driving,T96
NA,T96,Scott Piercy,28,192,19,173,2010,total_driving,T96
NA,T101,Stephen Ames,23,193,138,55,2010,total_driving,T101
NA,T101,Jonathan Byrd,26,193,64,129,2010,total_driving,T101
NA,T103,Brian Davis,32,194,163,31,2010,total_driving,T103
NA,T103,Jeff Gove,22,194,86,108,2010,total_driving,T103
NA,T103,Justin Leonard,27,194,172,22,2010,total_driving,T103
NA,T106,John Daly,20,195,6,189,2010,total_driving,T106
NA,T106,Brian Gay,30,195,192,3,2010,total_driving,T106
NA,T106,Jeff Overton,26,195,18,177,2010,total_driving,T106
NA,T109,Craig Bowden,20,196,191,5,2010,total_driving,T109
NA,T109,Chris Riley,24,196,169,27,2010,total_driving,T109
NA,111,Paul Goydos,25,197,185,12,2010,total_driving,111
NA,T112,Justin Bolli,23,199,141,58,2010,total_driving,T112
NA,T112,Jeff Maggert,28,199,159,40,2010,total_driving,T112
NA,T112,Chris Tidland,24,199,93,106,2010,total_driving,T112
NA,115,Trevor Immelman,19,200,110,90,2010,total_driving,115
NA,T116,Woody Austin,29,201,147,54,2010,total_driving,T116
NA,T116,Matt Bettencourt,32,201,36,165,2010,total_driving,T116
NA,T116,Ben Curtis,24,201,182,19,2010,total_driving,T116
NA,T116,Phil Mickelson,20,201,13,188,2010,total_driving,T116
NA,T116,Jeff Quinney,29,201,186,15,2010,total_driving,T116
NA,T116,Scott Verplank,22,201,167,34,2010,total_driving,T116
NA,T122,Rocco Mediate,25,202,170,32,2010,total_driving,T122
NA,T122,Tom Pernice Jr.,22,202,154,48,2010,total_driving,T122
NA,T122,Andres Romero,21,202,24,178,2010,total_driving,T122
NA,T125,Martin Flores,26,203,11,192,2010,total_driving,T125
NA,T125,Camilo Villegas,20,203,77,126,2010,total_driving,T125
NA,T127,Briny Baird,28,204,138,66,2010,total_driving,T127
NA,T127,Jason Bohn,25,204,155,49,2010,total_driving,T127
NA,T129,Andrew McLardy,21,205,74,131,2010,total_driving,T129
NA,T129,Ted Purdy,30,205,66,139,2010,total_driving,T129
NA,131,Tim Petrovic,32,206,165,41,2010,total_driving,131
NA,T132,James Driscoll,26,207,39,168,2010,total_driving,T132
NA,T132,Chris Wilson,26,207,58,149,2010,total_driving,T132
NA,134,Chris Stroud,27,208,101,107,2010,total_driving,134
NA,135,Matt Jones,27,209,42,167,2010,total_driving,135
NA,136,Brian Stuard,28,210,105,105,2010,total_driving,136
NA,137,Cameron Beckman,25,211,115,96,2010,total_driving,137
NA,138,D.A. Points,29,214,133,81,2010,total_driving,138
NA,139,Charles Howell III,28,215,34,181,2010,total_driving,139
NA,T140,Daniel Chopra,28,216,25,191,2010,total_driving,T140
NA,T140,Derek Lamely,28,216,36,180,2010,total_driving,T140
NA,142,Padraig Harrington,18,221,52,169,2010,total_driving,142
NA,T143,Bill Lunde,28,222,85,137,2010,total_driving,T143
NA,T143,Ian Poulter,15,222,109,113,2010,total_driving,T143
NA,T145,J.P. Hayes,25,223,148,75,2010,total_driving,T145
NA,T145,Spencer Levin,31,223,150,73,2010,total_driving,T145
NA,T145,Kevin Na,26,223,167,56,2010,total_driving,T145
NA,T148,Brent Delahoussaye,21,225,181,44,2010,total_driving,T148
NA,T148,George McNeill,28,225,41,184,2010,total_driving,T148
NA,T148,Rory Sabbatini,26,225,82,143,2010,total_driving,T148
NA,151,David Lutterus,25,226,55,171,2010,total_driving,151
NA,152,Michael Sim,20,228,127,101,2010,total_driving,152
NA,T153,Steve Flesch,25,232,173,59,2010,total_driving,T153
NA,T153,Charlie Wi,27,232,146,86,2010,total_driving,T153
NA,155,Jimmy Walker,27,235,45,190,2010,total_driving,155
NA,T156,Stuart Appleby,31,236,84,152,2010,total_driving,T156
NA,T156,Jeev Milkha Singh,19,236,100,136,2010,total_driving,T156
NA,T158,Ernie Els,20,237,90,147,2010,total_driving,T158
NA,T158,Steve Lowery,25,237,112,125,2010,total_driving,T158
NA,160,Shaun Micheel,21,242,128,114,2010,total_driving,160
NA,T161,Michael Connell,25,243,144,99,2010,total_driving,T161
NA,T161,Roland Thatcher,26,243,95,148,2010,total_driving,T161
NA,163,Tim Herron,24,244,58,186,2010,total_driving,163
NA,164,Troy Merritt,29,246,92,154,2010,total_driving,164
NA,165,Lee Janzen,26,248,98,150,2010,total_driving,165
NA,166,Carl Pettersson,29,249,137,112,2010,total_driving,166
NA,167,Johnson Wagner,28,252,135,117,2010,total_driving,167
NA,168,Freddie Jacobson,24,253,131,122,2010,total_driving,168
NA,169,Bob Estes,26,257,125,132,2010,total_driving,169
NA,170,Webb Simpson,31,258,118,140,2010,total_driving,170
NA,171,Brandt Snedeker,26,260,176,84,2010,total_driving,171
NA,172,Geoff Ogilvy,19,265,104,161,2010,total_driving,172
NA,T173,Mark Calcavecchia,16,269,148,121,2010,total_driving,T173
NA,T173,Ryuji Imada,28,269,165,104,2010,total_driving,T173
NA,T173,Joe Ogilvie,32,269,114,155,2010,total_driving,T173
NA,T173,Brenden Pappas,24,269,90,179,2010,total_driving,T173
NA,177,David Duval,24,271,105,166,2010,total_driving,177
NA,178,Kevin Johnson,26,272,178,94,2010,total_driving,178
NA,T179,Bryce Molder,26,274,171,103,2010,total_driving,T179
NA,T179,Brett Quigley,29,274,128,146,2010,total_driving,T179
NA,181,Ricky Barnes,28,276,117,159,2010,total_driving,181
NA,182,Michael Bradley,24,284,143,141,2010,total_driving,182
NA,T183,Rich Barcelo,25,286,99,187,2010,total_driving,T183
NA,T183,Jerod Turner,21,286,160,126,2010,total_driving,T183
NA,185,Nathan Green,27,292,157,135,2010,total_driving,185
NA,T186,Luke Donald,20,297,177,120,2010,total_driving,T186
NA,T186,Vance Veazey,23,297,123,174,2010,total_driving,T186
NA,188,Greg Kraft,22,306,187,119,2010,total_driving,188
NA,189,Chad Collins,26,324,180,144,2010,total_driving,189
NA,190,Greg Chalmers,27,333,182,151,2010,total_driving,190
NA,191,Brad Faxon,23,343,190,153,2010,total_driving,191
NA,192,Mike Weir,19,369,184,185,2010,total_driving,192
NA,1,John Merrick,21,66,41,25,2011,total_driving,1
NA,2,John Rollins,27,74,46,28,2011,total_driving,2
NA,3,Brandt Jobe,28,76,33,43,2011,total_driving,3
NA,4,Boo Weekley,23,79,48,31,2011,total_driving,4
NA,5,Adam Scott,18,86,24,62,2011,total_driving,5
NA,6,Chris Couch,21,93,44,49,2011,total_driving,6
NA,7,Chez Reavie,27,95,71,24,2011,total_driving,7
NA,8,John Senden,26,101,72,29,2011,total_driving,8
NA,9,Bo Van Pelt,27,105,38,67,2011,total_driving,9
NA,10,Josh Teater,31,113,15,98,2011,total_driving,10
NA,11,Bill Haas,26,115,48,67,2011,total_driving,11
NA,T12,Keegan Bradley,28,116,20,96,2011,total_driving,T12
NA,T12,Rod Pampling,21,116,84,32,2011,total_driving,T12
NA,14,Blake Adams,34,125,80,45,2011,total_driving,14
NA,15,Brendan Steele,27,127,77,50,2011,total_driving,15
NA,16,J.J. Henry,28,128,92,36,2011,total_driving,16
NA,17,Briny Baird,19,129,112,17,2011,total_driving,17
NA,T18,Billy Horschel,25,133,94,39,2011,total_driving,T18
NA,T18,Kyle Stanley,28,133,9,124,2011,total_driving,T18
NA,20,Charley Hoffman,27,136,22,114,2011,total_driving,20
NA,T21,Scott McCarron,22,138,84,54,2011,total_driving,T21
NA,T21,Charl Schwartzel,15,138,43,95,2011,total_driving,T21
NA,23,Gary Woodland,25,142,5,137,2011,total_driving,23
NA,24,Webb Simpson,26,143,51,92,2011,total_driving,24
NA,25,Justin Hicks,23,145,132,13,2011,total_driving,25
NA,T26,Martin Laird,23,147,13,134,2011,total_driving,T26
NA,T26,Graeme McDowell,16,147,109,38,2011,total_driving,T26
NA,T28,Steve Elkington,17,149,135,14,2011,total_driving,T28
NA,T28,Kevin Stadler,27,149,74,75,2011,total_driving,T28
NA,30,Dustin Johnson,21,150,3,147,2011,total_driving,30
NA,T31,Joe Durant,25,152,151,1,2011,total_driving,T31
NA,T31,D.J. Trahan,30,152,31,121,2011,total_driving,T31
NA,T31,Nick Watney,22,152,16,136,2011,total_driving,T31
NA,34,Troy Matteson,28,153,21,132,2011,total_driving,34
NA,T35,Will Strickler,19,154,10,144,2011,total_driving,T35
NA,T35,Bubba Watson,22,154,2,152,2011,total_driving,T35
NA,37,Bobby Gates,29,155,38,117,2011,total_driving,37
NA,38,Pat Perez,24,156,90,66,2011,total_driving,38
NA,39,D.A. Points,26,157,122,35,2011,total_driving,39
NA,40,Davis Love III,22,158,33,125,2011,total_driving,40
NA,T41,Woody Austin,18,160,120,40,2011,total_driving,T41
NA,T41,Jason Bohn,22,160,139,21,2011,total_driving,T41
NA,T43,Sung Kang,21,161,68,93,2011,total_driving,T43
NA,T43,Scott Piercy,23,161,7,154,2011,total_driving,T43
NA,T45,Tom Gillis,19,162,103,59,2011,total_driving,T45
NA,T45,Billy Mayfair,29,162,153,9,2011,total_driving,T45
NA,T45,Tag Ridings,28,162,12,150,2011,total_driving,T45
NA,T48,Brian Davis,30,163,153,10,2011,total_driving,T48
NA,T48,Mark Wilson,26,163,143,20,2011,total_driving,T48
NA,50,Scott Stallings,28,164,11,153,2011,total_driving,50
NA,T51,Chad Campbell,29,165,92,73,2011,total_driving,T51
NA,T51,Ben Crane,23,165,139,26,2011,total_driving,T51
NA,T51,Heath Slocum,29,165,163,2,2011,total_driving,T51
NA,54,Steve Marino,23,166,59,107,2011,total_driving,54
NA,T55,Sergio Garcia,16,167,28,139,2011,total_driving,T55
NA,T55,Lucas Glover,23,167,63,104,2011,total_driving,T55
NA,T55,Hunter Mahan,25,167,84,83,2011,total_driving,T55
NA,T58,David Hearn,26,168,96,72,2011,total_driving,T58
NA,T58,Carl Pettersson,27,168,81,87,2011,total_driving,T58
NA,T60,Jason Dufner,23,169,125,44,2011,total_driving,T60
NA,T60,Jim Herman,22,169,18,151,2011,total_driving,T60
NA,T60,Aron Price,18,169,158,11,2011,total_driving,T60
NA,63,Jeff Overton,26,170,58,112,2011,total_driving,63
NA,64,Jim Renner,22,171,44,127,2011,total_driving,64
NA,T65,Stephen Ames,22,172,150,22,2011,total_driving,T65
NA,T65,Andres Gonzales,21,172,75,97,2011,total_driving,T65
NA,T65,Cameron Tringale,32,172,66,106,2011,total_driving,T65
NA,T68,Zack Miller,30,173,25,148,2011,total_driving,T68
NA,T68,Justin Rose,23,173,99,74,2011,total_driving,T68
NA,70,Scott Gutschewski,23,174,36,138,2011,total_driving,70
NA,71,Steven Bowditch,28,175,6,169,2011,total_driving,71
NA,T72,Tommy Gainey,34,176,46,130,2011,total_driving,T72
NA,T72,Alex Prugh,29,176,31,145,2011,total_driving,T72
NA,T72,Kevin Streelman,26,176,111,65,2011,total_driving,T72
NA,75,Roland Thatcher,22,177,75,102,2011,total_driving,75
NA,T76,Hunter Haas,30,178,114,64,2011,total_driving,T76
NA,T76,Kent Jones,25,178,137,41,2011,total_driving,T76
NA,78,Brendon de Jonge,30,179,119,60,2011,total_driving,78
NA,T79,Joseph Bramlett,25,180,57,123,2011,total_driving,T79
NA,T79,Matt Kuchar,24,180,128,52,2011,total_driving,T79
NA,T79,Ben Martin,25,180,109,71,2011,total_driving,T79
NA,T79,George McNeill,21,180,60,120,2011,total_driving,T79
NA,T79,Ryan Moore,22,180,103,77,2011,total_driving,T79
NA,T84,Robert Allenby,25,181,100,81,2011,total_driving,T84
NA,T84,David Toms,23,181,175,6,2011,total_driving,T84
NA,T84,Jhonattan Vegas,25,181,8,173,2011,total_driving,T84
NA,T87,Rickie Fowler,24,182,25,157,2011,total_driving,T87
NA,T87,Jim Furyk,26,182,164,18,2011,total_driving,T87
NA,T87,Lee Janzen,19,182,103,79,2011,total_driving,T87
NA,T90,J.B. Holmes,16,183,1,182,2011,total_driving,T90
NA,T90,Charles Howell III,30,183,40,143,2011,total_driving,T90
NA,T90,Robert Karlsson,18,183,28,155,2011,total_driving,T90
NA,T90,Johnson Wagner,25,183,160,23,2011,total_driving,T90
NA,T94,Kevin Chappell,26,184,55,129,2011,total_driving,T94
NA,T94,Robert Garrigus,26,184,4,180,2011,total_driving,T94
NA,T94,Alexandre Rocha,22,184,96,88,2011,total_driving,T94
NA,T97,Ben Curtis,23,185,180,5,2011,total_driving,T97
NA,T97,Zach Johnson,23,185,177,8,2011,total_driving,T97
NA,T97,Brandt Snedeker,26,185,124,61,2011,total_driving,T97
NA,T100,Jason Day,21,186,14,172,2011,total_driving,T100
NA,T100,Jerry Kelly,26,186,183,3,2011,total_driving,T100
NA,T100,Chris Riley,25,186,174,12,2011,total_driving,T100
NA,T103,Geoff Ogilvy,21,188,106,82,2011,total_driving,T103
NA,T103,Vijay Singh,25,188,66,122,2011,total_driving,T103
NA,T103,Y.E. Yang,18,188,100,88,2011,total_driving,T103
NA,T106,Ángel Cabrera,17,189,19,170,2011,total_driving,T106
NA,T106,Nick O'Hern,29,189,182,7,2011,total_driving,T106
NA,T108,Brian Gay,26,190,186,4,2011,total_driving,T108
NA,T108,David Mathis,25,190,161,29,2011,total_driving,T108
NA,T108,Matt McQuillan,21,190,135,55,2011,total_driving,T108
NA,T108,Garrett Willis,24,190,171,19,2011,total_driving,T108
NA,T112,Rich Beem,21,192,129,63,2011,total_driving,T112
NA,T112,Bill Lunde,28,192,89,103,2011,total_driving,T112
NA,114,Fabián Gómez,26,194,116,78,2011,total_driving,114
NA,T115,Shane Bertsch,20,195,168,27,2011,total_driving,T115
NA,T115,Bryce Molder,27,195,161,34,2011,total_driving,T115
NA,T117,James Driscoll,24,196,33,163,2011,total_driving,T117
NA,T117,Spencer Levin,31,196,127,69,2011,total_driving,T117
NA,119,Steve Stricker,19,198,113,85,2011,total_driving,119
NA,T120,Jonathan Byrd,26,199,84,115,2011,total_driving,T120
NA,T120,Phil Mickelson,21,199,22,177,2011,total_driving,T120
NA,T122,Paul Goydos,25,200,185,15,2011,total_driving,T122
NA,T122,Rocco Mediate,23,200,184,16,2011,total_driving,T122
NA,T124,Harrison Frazar,19,201,17,184,2011,total_driving,T124
NA,T124,Ryan Palmer,24,201,25,176,2011,total_driving,T124
NA,126,Andres Romero,22,202,61,141,2011,total_driving,126
NA,T127,Alex Cejka,21,204,167,37,2011,total_driving,T127
NA,T127,Luke Donald,19,204,147,57,2011,total_driving,T127
NA,T129,Ricky Barnes,23,205,72,133,2011,total_driving,T129
NA,T129,Vaughn Taylor,27,205,147,58,2011,total_driving,T129
NA,T129,Camilo Villegas,25,205,65,140,2011,total_driving,T129
NA,T132,Retief Goosen,16,206,107,99,2011,total_driving,T132
NA,T132,Ian Poulter,16,206,155,51,2011,total_driving,T132
NA,T134,Trevor Immelman,25,208,114,94,2011,total_driving,T134
NA,T134,Jimmy Walker,24,208,30,178,2011,total_driving,T134
NA,T136,Chris Stroud,28,210,91,119,2011,total_driving,T136
NA,T136,Michael Thompson,25,210,94,116,2011,total_driving,T136
NA,138,Chris DiMarco,31,211,178,33,2011,total_driving,138
NA,139,Michael Putnam,21,212,41,171,2011,total_driving,139
NA,140,J.P. Hayes,19,213,157,56,2011,total_driving,140
NA,T141,Kris Blanks,29,215,139,76,2011,total_driving,T141
NA,T141,Justin Leonard,26,215,168,47,2011,total_driving,T141
NA,T141,Troy Merritt,23,215,125,90,2011,total_driving,T141
NA,T144,Aaron Baddeley,22,217,51,166,2011,total_driving,T144
NA,T144,Chris Kirk,28,217,56,161,2011,total_driving,T144
NA,T146,Michael Connell,26,218,173,45,2011,total_driving,T146
NA,T146,Colt Knost,27,218,176,42,2011,total_driving,T146
NA,T146,William McGirt,32,218,107,111,2011,total_driving,T146
NA,149,Tim Petrovic,29,219,166,53,2011,total_driving,149
NA,150,Derek Lamely,26,222,37,185,2011,total_driving,150
NA,151,Daniel Summerhays,29,223,139,84,2011,total_driving,151
NA,152,K.J. Choi,22,225,134,91,2011,total_driving,152
NA,T153,Tim Herron,28,227,81,146,2011,total_driving,T153
NA,T153,Sean O'Hair,24,227,63,164,2011,total_driving,T153
NA,T153,Dean Wilson,22,227,179,48,2011,total_driving,T153
NA,156,Marc Leishman,27,228,54,174,2011,total_driving,156
NA,157,Freddie Jacobson,25,232,122,110,2011,total_driving,157
NA,158,David Duval,24,233,50,183,2011,total_driving,158
NA,T159,Bio Kim,25,234,53,181,2011,total_driving,T159
NA,T159,Rory Sabbatini,24,234,78,156,2011,total_driving,T159
NA,T159,Charlie Wi,25,234,133,101,2011,total_driving,T159
NA,T162,Ernie Els,21,235,118,117,2011,total_driving,T162
NA,T162,Marc Turnesa,20,235,155,80,2011,total_driving,T162
NA,164,Matt Jones,25,237,70,167,2011,total_driving,164
NA,T165,Stewart Cink,22,240,81,159,2011,total_driving,T165
NA,T165,Padraig Harrington,18,240,61,179,2011,total_driving,T165
NA,167,Joe Ogilvie,24,242,84,158,2011,total_driving,167
NA,168,Michael Bradley,24,247,98,149,2011,total_driving,168
NA,169,Cameron Beckman,25,249,145,104,2011,total_driving,169
NA,170,Richard Johnson,23,251,181,70,2011,total_driving,170
NA,T171,Anthony Kim,26,254,68,186,2011,total_driving,T171
NA,T171,Kevin Kisner,24,254,145,109,2011,total_driving,T171
NA,T171,Martin Piller,23,254,79,175,2011,total_driving,T171
NA,174,Stuart Appleby,24,256,121,135,2011,total_driving,174
NA,175,Greg Chalmers,28,258,172,86,2011,total_driving,175
NA,176,Steve Flesch,27,259,159,100,2011,total_driving,176
NA,177,Jarrod Lyle,29,260,129,131,2011,total_driving,177
NA,178,Nathan Green,26,263,137,126,2011,total_driving,178
NA,179,Ryuji Imada,29,265,152,113,2011,total_driving,179
NA,180,D.J. Brigman,23,268,100,168,2011,total_driving,180
NA,181,Nate Smith,24,272,165,107,2011,total_driving,181
NA,T182,Matt Bettencourt,30,277,117,160,2011,total_driving,T182
NA,T182,Paul Stankowski,24,277,149,128,2011,total_driving,T182
NA,184,Shaun Micheel,27,294,129,165,2011,total_driving,184
NA,185,Arjun Atwal,29,305,143,162,2011,total_driving,185
NA,186,Kevin Na,26,312,170,142,2011,total_driving,186
NA,1,Boo Weekley,25,74,36,38,2012,total_driving,1
NA,2,Hunter Mahan,23,78,61,17,2012,total_driving,2
NA,3,Bo Van Pelt,24,84,40,44,2012,total_driving,3
NA,T4,Chris Couch,21,85,54,31,2012,total_driving,T4
NA,T4,Jason Dufner,22,85,64,21,2012,total_driving,T4
NA,6,Tiger Woods,19,87,32,55,2012,total_driving,6
NA,7,Louis Oosthuizen,19,90,23,67,2012,total_driving,7
NA,8,Brandt Jobe,18,91,25,66,2012,total_driving,8
NA,9,John Rollins,26,98,47,51,2012,total_driving,9
NA,10,Kevin Stadler,25,102,62,40,2012,total_driving,10
NA,T11,Keegan Bradley,25,103,16,87,2012,total_driving,T11
NA,T11,John Senden,22,103,79,24,2012,total_driving,T11
NA,T13,John Merrick,26,105,58,47,2012,total_driving,T13
NA,T13,Lee Westwood,15,105,29,76,2012,total_driving,T13
NA,T15,Rickie Fowler,23,108,60,48,2012,total_driving,T15
NA,T15,Justin Rose,19,108,80,28,2012,total_driving,T15
NA,17,Billy Horschel,17,111,89,22,2012,total_driving,17
NA,18,Roberto Castro,27,117,83,34,2012,total_driving,18
NA,T19,Will Claxton,28,119,85,34,2012,total_driving,T19
NA,T19,Charley Hoffman,27,119,46,73,2012,total_driving,T19
NA,21,Brian Harman,30,120,87,33,2012,total_driving,21
NA,22,Bill Haas,23,122,66,56,2012,total_driving,22
NA,T23,Graham DeLaet,23,123,13,110,2012,total_driving,T23
NA,T23,Josh Teater,30,123,27,96,2012,total_driving,T23
NA,25,John Huh,28,124,113,11,2012,total_driving,25
NA,26,Tom Gillis,23,126,103,23,2012,total_driving,26
NA,27,Kyle Stanley,27,132,8,124,2012,total_driving,27
NA,28,Adam Scott,16,133,10,123,2012,total_driving,28
NA,29,Cameron Tringale,26,134,85,49,2012,total_driving,29
NA,30,Charl Schwartzel,16,135,42,93,2012,total_driving,30
NA,31,Bubba Watson,19,136,1,135,2012,total_driving,31
NA,32,Vijay Singh,27,137,47,90,2012,total_driving,32
NA,33,Blake Adams,32,139,112,27,2012,total_driving,33
NA,T34,Charlie Beljan,22,141,2,139,2012,total_driving,T34
NA,T34,Graeme McDowell,16,141,136,5,2012,total_driving,T34
NA,T36,Richard Lee,24,144,134,10,2012,total_driving,T36
NA,T36,Pat Perez,23,144,75,69,2012,total_driving,T36
NA,38,Harris English,27,145,20,125,2012,total_driving,38
NA,T39,Ryan Moore,24,146,117,29,2012,total_driving,T39
NA,T39,Seung-Yul Noh,28,146,19,127,2012,total_driving,T39
NA,T41,Sean O'Hair,24,149,31,118,2012,total_driving,T41
NA,T41,Henrik Stenson,15,149,96,53,2012,total_driving,T41
NA,43,Jeff Overton,29,150,68,82,2012,total_driving,43
NA,T44,Russell Knox,23,152,132,20,2012,total_driving,T44
NA,T44,Kevin Streelman,26,152,63,89,2012,total_driving,T44
NA,46,Greg Owen,27,156,41,115,2012,total_driving,46
NA,T47,Martin Laird,22,157,28,129,2012,total_driving,T47
NA,T47,Scott Stallings,27,157,17,140,2012,total_driving,T47
NA,T49,Bobby Gates,29,158,21,137,2012,total_driving,T49
NA,T49,Billy Mayfair,28,158,122,36,2012,total_driving,T49
NA,51,Ryan Palmer,24,159,15,144,2012,total_driving,51
NA,T52,Robert Garrigus,26,160,3,157,2012,total_driving,T52
NA,T52,Jeff Maggert,27,160,141,19,2012,total_driving,T52
NA,T54,Rory McIlroy,16,161,5,156,2012,total_driving,T54
NA,T54,D.J. Trahan,27,161,66,95,2012,total_driving,T54
NA,T56,Sergio Garcia,16,162,64,98,2012,total_driving,T56
NA,T56,Dustin Johnson,19,162,4,158,2012,total_driving,T56
NA,58,Brendan Steele,24,163,105,58,2012,total_driving,58
NA,59,Brendon de Jonge,31,164,105,59,2012,total_driving,59
NA,60,Camilo Villegas,25,165,87,78,2012,total_driving,60
NA,61,Geoff Ogilvy,20,168,90,78,2012,total_driving,61
NA,T62,Davis Love III,20,169,39,130,2012,total_driving,T62
NA,T62,Rod Pampling,26,169,105,64,2012,total_driving,T62
NA,T64,Matt Kuchar,22,170,128,42,2012,total_driving,T64
NA,T64,Nick Watney,26,170,36,134,2012,total_driving,T64
NA,66,Erik Compton,26,171,33,138,2012,total_driving,66
NA,T67,Ben Crane,23,172,122,50,2012,total_driving,T67
NA,T67,Garth Mulroy,20,172,55,117,2012,total_driving,T67
NA,T69,Gary Christian,28,173,164,9,2012,total_driving,T69
NA,T69,John Daly,15,173,9,164,2012,total_driving,T69
NA,T69,Scott Piercy,28,173,12,161,2012,total_driving,T69
NA,T72,Kris Blanks,23,174,148,26,2012,total_driving,T72
NA,T72,Chez Reavie,26,174,161,13,2012,total_driving,T72
NA,T74,Ángel Cabrera,20,175,22,153,2012,total_driving,T74
NA,T74,Jim Furyk,24,175,171,4,2012,total_driving,T74
NA,T76,Padraig Harrington,18,177,57,120,2012,total_driving,T76
NA,T76,Kyle Reifers,27,177,92,85,2012,total_driving,T76
NA,T76,Heath Slocum,29,177,175,2,2012,total_driving,T76
NA,79,J.J. Henry,28,178,115,63,2012,total_driving,79
NA,T80,J.B. Holmes,25,179,6,173,2012,total_driving,T80
NA,T80,Roland Thatcher,21,179,104,75,2012,total_driving,T80
NA,T82,Zach Johnson,25,182,168,14,2012,total_driving,T82
NA,T82,John Mallinger,25,182,166,16,2012,total_driving,T82
NA,T82,Daniel Summerhays,26,182,101,81,2012,total_driving,T82
NA,T85,Tim Clark,20,183,180,3,2012,total_driving,T85
NA,T85,Jerry Kelly,26,183,182,1,2012,total_driving,T85
NA,T85,Carl Pettersson,26,183,35,148,2012,total_driving,T85
NA,88,Ian Poulter,15,184,145,39,2012,total_driving,88
NA,89,Bud Cauley,28,186,74,112,2012,total_driving,89
NA,90,Steve Wheatcroft,22,189,121,68,2012,total_driving,90
NA,T91,Scott Brown,24,190,77,113,2012,total_driving,T91
NA,T91,Ken Duke,30,190,160,30,2012,total_driving,T91
NA,T91,Jason Kokrak,27,190,14,176,2012,total_driving,T91
NA,T91,Kevin Na,25,190,165,25,2012,total_driving,T91
NA,T91,David Toms,19,190,184,6,2012,total_driving,T91
NA,T91,Jhonattan Vegas,25,190,10,180,2012,total_driving,T91
NA,T91,Gary Woodland,22,190,18,172,2012,total_driving,T91
NA,T98,Stuart Appleby,24,191,159,32,2012,total_driving,T98
NA,T98,Jason Day,17,191,7,184,2012,total_driving,T98
NA,100,Ben Curtis,19,193,186,7,2012,total_driving,100
NA,101,Chris Kirk,27,194,73,121,2012,total_driving,101
NA,102,Mark Wilson,25,195,183,12,2012,total_driving,102
NA,T103,Chris DiMarco,29,196,188,8,2012,total_driving,T103
NA,T103,David Hearn,28,196,124,72,2012,total_driving,T103
NA,T105,Brian Davis,29,197,179,18,2012,total_driving,T105
NA,T105,D.A. Points,29,197,152,45,2012,total_driving,T105
NA,T105,Chris Stroud,28,197,126,71,2012,total_driving,T105
NA,108,Tommy Gainey,32,198,33,165,2012,total_driving,108
NA,109,Steve Stricker,19,199,138,61,2012,total_driving,109
NA,T110,Harrison Frazar,20,200,30,170,2012,total_driving,T110
NA,T110,"Ted Potter, Jr.",25,200,148,52,2012,total_driving,T110
NA,T112,Hunter Haas,24,201,117,84,2012,total_driving,T112
NA,T112,Trevor Immelman,24,201,80,121,2012,total_driving,T112
NA,114,Webb Simpson,22,203,111,92,2012,total_driving,114
NA,T115,Chad Campbell,27,204,90,114,2012,total_driving,T115
NA,T115,Colt Knost,29,204,189,15,2012,total_driving,T115
NA,T115,George McNeill,25,204,105,99,2012,total_driving,T115
NA,T115,Alexandre Rocha,21,204,147,57,2012,total_driving,T115
NA,T119,Ernie Els,22,206,51,155,2012,total_driving,T119
NA,T119,Troy Kelly,23,206,23,183,2012,total_driving,T119
NA,T121,Luke Donald,17,207,170,37,2012,total_driving,T121
NA,T121,Edward Loar,23,207,44,163,2012,total_driving,T121
NA,T123,Ricky Barnes,28,208,68,140,2012,total_driving,T123
NA,T123,Troy Matteson,32,208,26,182,2012,total_driving,T123
NA,125,Scott Dunlap,20,211,166,45,2012,total_driving,125
NA,126,Kevin Chappell,29,212,58,154,2012,total_driving,126
NA,127,Bill Lunde,25,215,84,131,2012,total_driving,127
NA,T128,K.J. Choi,21,216,162,54,2012,total_driving,T128
NA,T128,Kyle Thompson,22,216,151,65,2012,total_driving,T128
NA,T130,Jason Bohn,28,217,174,43,2012,total_driving,T130
NA,T130,Robert Karlsson,17,217,50,167,2012,total_driving,T130
NA,T130,Kevin Kisner,24,217,116,101,2012,total_driving,T130
NA,133,Tim Herron,27,218,99,119,2012,total_driving,133
NA,T134,Brandt Snedeker,22,219,110,109,2012,total_driving,T134
NA,T134,Jimmy Walker,28,219,38,181,2012,total_driving,T134
NA,T136,Matt Jones,19,221,55,166,2012,total_driving,T136
NA,T136,Charlie Wi,25,221,134,87,2012,total_driving,T136
NA,T138,Charles Howell III,29,222,51,171,2012,total_driving,T138
NA,T138,Danny Lee,26,222,72,150,2012,total_driving,T138
NA,T138,Rory Sabbatini,29,222,119,103,2012,total_driving,T138
NA,T138,Johnson Wagner,27,222,152,70,2012,total_driving,T138
NA,142,Dicky Pride,19,224,130,94,2012,total_driving,142
NA,143,Martin Flores,30,226,49,177,2012,total_driving,143
NA,144,Phil Mickelson,22,227,53,174,2012,total_driving,144
NA,145,Cameron Beckman,26,228,142,86,2012,total_driving,145
NA,T146,Mark Anderson,25,229,43,186,2012,total_driving,T146
NA,T146,Mathew Goggin,23,229,82,147,2012,total_driving,T146
NA,148,Gavin Coles,23,231,190,41,2012,total_driving,148
NA,T149,Daniel Chopra,21,235,44,191,2012,total_driving,T149
NA,T149,Vaughn Taylor,26,235,129,106,2012,total_driving,T149
NA,T151,Sangmoon Bae,25,237,95,142,2012,total_driving,T151
NA,T151,Andres Romero,22,237,68,169,2012,total_driving,T151
NA,T153,Stephen Ames,20,238,155,83,2012,total_driving,T153
NA,T153,David Mathis,29,238,176,62,2012,total_driving,T153
NA,155,Matt Every,25,240,136,104,2012,total_driving,155
NA,T156,Jonathan Byrd,21,241,96,145,2012,total_driving,T156
NA,T156,Miguel Angel Carballo,25,241,96,145,2012,total_driving,T156
NA,T158,Aaron Baddeley,22,243,68,175,2012,total_driving,T158
NA,T158,Greg Chalmers,25,243,163,80,2012,total_driving,T158
NA,T158,Rocco Mediate,23,243,169,74,2012,total_driving,T158
NA,161,Arjun Atwal,27,244,144,100,2012,total_driving,161
NA,162,William McGirt,30,245,138,107,2012,total_driving,162
NA,163,Bob Estes,23,247,142,105,2012,total_driving,163
NA,164,Y.E. Yang,20,248,146,102,2012,total_driving,164
NA,T165,Robert Allenby,27,251,124,127,2012,total_driving,T165
NA,T165,Nick O'Hern,26,251,191,60,2012,total_driving,T165
NA,T167,Brian Gay,28,254,177,77,2012,total_driving,T167
NA,T167,J.J. Killeen,33,254,94,160,2012,total_driving,T167
NA,169,Jonas Blixt,21,260,127,133,2012,total_driving,169
NA,170,Freddie Jacobson,17,262,119,143,2012,total_driving,170
NA,171,Stephen Gangluff,23,265,75,190,2012,total_driving,171
NA,T172,James Driscoll,27,267,78,189,2012,total_driving,T172
NA,T172,Marc Leishman,23,267,99,168,2012,total_driving,T172
NA,174,Bryce Molder,25,269,178,91,2012,total_driving,174
NA,175,Ryo Ishikawa,18,271,92,179,2012,total_driving,175
NA,176,Sung Kang,30,282,133,149,2012,total_driving,176
NA,T177,Stewart Cink,22,283,105,178,2012,total_driving,T177
NA,T177,Justin Leonard,26,283,172,111,2012,total_driving,T177
NA,T179,Tom Pernice Jr.,23,284,187,97,2012,total_driving,T179
NA,T179,Michael Thompson,25,284,158,126,2012,total_driving,T179
NA,181,Nathan Green,22,286,154,132,2012,total_driving,181
NA,T182,Derek Lamely,25,289,102,187,2012,total_driving,T182
NA,T182,Patrick Sheehan,21,289,173,116,2012,total_driving,T182
NA,184,Tommy Biershenk,27,290,138,152,2012,total_driving,184
NA,185,Marco Dawson,22,292,130,162,2012,total_driving,185
NA,T186,Billy Hurley III,27,293,185,108,2012,total_driving,T186
NA,T186,Brendon Todd,29,293,157,136,2012,total_driving,T186
NA,188,Matt Bettencourt,31,299,114,185,2012,total_driving,188
NA,189,Spencer Levin,26,306,155,151,2012,total_driving,189
NA,190,Michael Bradley,23,336,148,188,2012,total_driving,190
NA,191,Ryuji Imada,28,340,181,159,2012,total_driving,191
NA,1,Graham DeLaet,26,53,19,34,2013,total_driving,1
NA,2,Keegan Bradley,25,72,11,61,2013,total_driving,2
NA,3,Henrik Stenson,18,73,66,7,2013,total_driving,3
NA,4,Justin Rose,17,79,27,52,2013,total_driving,4
NA,5,Jim Herman,19,82,17,65,2013,total_driving,5
NA,6,Billy Horschel,26,92,42,50,2013,total_driving,6
NA,7,Boo Weekley,27,94,66,28,2013,total_driving,7
NA,T8,Hunter Mahan,25,98,73,25,2013,total_driving,T8
NA,T8,Jordan Spieth,23,98,80,18,2013,total_driving,T8
NA,10,D.J. Trahan,16,99,46,53,2013,total_driving,10
NA,11,Brandt Jobe,19,100,57,43,2013,total_driving,11
NA,12,Matt Jones,24,101,56,45,2013,total_driving,12
NA,13,Nicholas Thompson,29,105,60,45,2013,total_driving,13
NA,14,Adam Scott,16,107,23,84,2013,total_driving,14
NA,15,Vaughn Taylor,16,112,75,37,2013,total_driving,15
NA,16,Kevin Streelman,25,117,94,23,2013,total_driving,16
NA,17,Tiger Woods,16,118,49,69,2013,total_driving,17
NA,18,Kevin Stadler,25,124,75,49,2013,total_driving,18
NA,19,Steve Stricker,13,127,124,3,2013,total_driving,19
NA,20,Lucas Glover,23,128,43,85,2013,total_driving,20
NA,21,Russell Henley,24,130,83,47,2013,total_driving,21
NA,22,Bubba Watson,21,131,5,126,2013,total_driving,22
NA,23,Brendon de Jonge,30,133,104,29,2013,total_driving,23
NA,24,Chez Reavie,22,134,128,6,2013,total_driving,24
NA,25,Lee Westwood,19,135,69,66,2013,total_driving,25
NA,26,Nick Watney,26,136,63,73,2013,total_driving,26
NA,T27,Kevin Chappell,24,139,52,87,2013,total_driving,T27
NA,T27,Charl Schwartzel,19,139,29,110,2013,total_driving,T27
NA,T29,Kyle Stanley,24,140,22,118,2013,total_driving,T29
NA,T29,Robert Streb,25,140,24,116,2013,total_driving,T29
NA,T31,George McNeill,21,142,106,36,2013,total_driving,T31
NA,T31,Josh Teater,24,142,43,99,2013,total_driving,T31
NA,33,Charlie Beljan,24,143,32,111,2013,total_driving,33
NA,34,Martin Laird,21,144,46,98,2013,total_driving,34
NA,35,Henrik Norlander,22,145,36,109,2013,total_driving,35
NA,T36,Steve LeBrun,21,146,38,108,2013,total_driving,T36
NA,T36,Ryan Moore,22,146,130,16,2013,total_driving,T36
NA,38,John Huh,28,147,133,14,2013,total_driving,38
NA,T39,Jason Dufner,22,148,107,41,2013,total_driving,T39
NA,T39,Tom Gillis,22,148,104,44,2013,total_driving,T39
NA,T39,Rory McIlroy,16,148,8,140,2013,total_driving,T39
NA,42,David Lingmerth,23,149,109,40,2013,total_driving,42
NA,43,Gary Woodland,26,150,4,146,2013,total_driving,43
NA,44,Roberto Castro,29,152,130,22,2013,total_driving,44
NA,T45,Scott Brown,21,154,78,76,2013,total_driving,T45
NA,T45,Jason Day,21,154,16,138,2013,total_driving,T45
NA,T45,Brendan Steele,26,154,68,86,2013,total_driving,T45
NA,T48,Justin Hicks,25,155,146,9,2013,total_driving,T48
NA,T48,Ryan Palmer,22,155,10,145,2013,total_driving,T48
NA,T50,Sergio Garcia,17,156,64,92,2013,total_driving,T50
NA,T50,Charley Hoffman,23,156,40,116,2013,total_driving,T50
NA,T50,Eric Meierdierks,19,156,9,147,2013,total_driving,T50
NA,T50,Scott Stallings,27,156,30,126,2013,total_driving,T50
NA,54,Cameron Tringale,24,157,98,59,2013,total_driving,54
NA,T55,J.J. Henry,26,158,119,39,2013,total_driving,T55
NA,T55,Bo Van Pelt,22,158,107,51,2013,total_driving,T55
NA,57,Mark Wilson,19,160,158,2,2013,total_driving,57
NA,T58,Fabián Gómez,23,161,78,83,2013,total_driving,T58
NA,T58,Zach Johnson,24,161,153,8,2013,total_driving,T58
NA,T58,"Ted Potter, Jr.",22,161,144,17,2013,total_driving,T58
NA,T61,Pat Perez,22,162,71,91,2013,total_driving,T61
NA,T61,John Rollins,24,162,31,131,2013,total_driving,T61
NA,63,Brad Fritsch,24,163,26,137,2013,total_driving,63
NA,T64,Harris English,26,164,35,129,2013,total_driving,T64
NA,T64,Rory Sabbatini,27,164,50,114,2013,total_driving,T64
NA,T66,Greg Owen,24,165,53,112,2013,total_driving,T66
NA,T66,Cameron Percy,21,165,45,120,2013,total_driving,T66
NA,T66,Y.E. Yang,19,165,101,64,2013,total_driving,T66
NA,T69,Brian Davis,28,166,153,13,2013,total_driving,T69
NA,T69,Derek Ernst,21,166,61,105,2013,total_driving,T69
NA,T69,Doug LaBelle II,23,166,145,21,2013,total_driving,T69
NA,T69,Webb Simpson,25,166,111,55,2013,total_driving,T69
NA,T69,Brian Stuard,25,166,134,32,2013,total_driving,T69
NA,74,Bill Haas,25,167,90,77,2013,total_driving,74
NA,T75,Vijay Singh,19,168,91,77,2013,total_driving,T75
NA,T75,Andrew Svoboda,18,168,71,97,2013,total_driving,T75
NA,77,Robert Garrigus,22,169,7,162,2013,total_driving,77
NA,T78,Nicolas Colsaerts,17,170,3,167,2013,total_driving,T78
NA,T78,Ben Kohles,25,170,151,19,2013,total_driving,T78
NA,T78,D.H. Lee,22,170,140,30,2013,total_driving,T78
NA,T81,Bob Estes,18,171,115,56,2013,total_driving,T81
NA,T81,Jeff Maggert,21,171,160,11,2013,total_driving,T81
NA,83,Sean O'Hair,22,172,14,158,2013,total_driving,83
NA,T84,Jim Furyk,22,173,169,4,2013,total_driving,T84
NA,T84,Dustin Johnson,22,173,2,171,2013,total_driving,T84
NA,T84,Richard Lee,24,173,149,24,2013,total_driving,T84
NA,87,Morgan Hoffmann,20,175,32,143,2013,total_driving,87
NA,T88,Martin Kaymer,17,176,87,89,2013,total_driving,T88
NA,T88,Graeme McDowell,16,176,161,15,2013,total_driving,T88
NA,T90,Will Claxton,24,178,116,62,2013,total_driving,T90
NA,T90,James Hahn,26,178,48,130,2013,total_driving,T90
NA,T90,Jerry Kelly,22,178,177,1,2013,total_driving,T90
NA,T90,Jason Kokrak,25,178,6,172,2013,total_driving,T90
NA,T94,Tim Clark,20,180,175,5,2013,total_driving,T94
NA,T94,Ken Duke,28,180,170,10,2013,total_driving,T94
NA,T94,Martin Flores,25,180,12,168,2013,total_driving,T94
NA,97,Luke List,24,181,1,180,2013,total_driving,97
NA,98,Rickie Fowler,22,183,103,80,2013,total_driving,98
NA,99,John Senden,25,184,82,102,2013,total_driving,99
NA,T100,Chad Campbell,25,185,85,100,2013,total_driving,T100
NA,T100,Tag Ridings,24,185,15,170,2013,total_driving,T100
NA,102,Ricky Barnes,26,186,80,106,2013,total_driving,102
NA,T103,Stuart Appleby,25,187,119,68,2013,total_driving,T103
NA,T103,Steven Bowditch,22,187,13,174,2013,total_driving,T103
NA,T103,K.J. Choi,24,187,156,31,2013,total_driving,T103
NA,T106,Peter Hanson,15,188,34,154,2013,total_driving,T106
NA,T106,David Toms,16,188,162,26,2013,total_driving,T106
NA,T108,Jin Park,20,189,177,12,2013,total_driving,T108
NA,T108,Carl Pettersson,24,189,70,119,2013,total_driving,T108
NA,T108,Shawn Stefani,21,189,25,164,2013,total_driving,T108
NA,T111,Scott Piercy,24,190,21,169,2013,total_driving,T111
NA,T111,Darron Stiles,20,190,170,20,2013,total_driving,T111
NA,T111,Camilo Villegas,23,190,59,131,2013,total_driving,T111
NA,T111,Charlie Wi,23,190,132,58,2013,total_driving,T111
NA,115,Daniel Summerhays,26,191,110,81,2013,total_driving,115
NA,116,D.A. Points,28,192,138,54,2013,total_driving,116
NA,117,Brian Harman,29,195,94,101,2013,total_driving,117
NA,T118,Ángel Cabrera,21,196,40,156,2013,total_driving,T118
NA,T118,Seung-Yul Noh,25,196,18,178,2013,total_driving,T118
NA,T118,Jimmy Walker,24,196,20,176,2013,total_driving,T118
NA,121,Jeff Overton,24,197,55,142,2013,total_driving,121
NA,T122,Chris Kirk,24,198,83,115,2013,total_driving,T122
NA,T122,Andres Romero,21,198,50,148,2013,total_driving,T122
NA,124,Troy Matteson,24,199,38,161,2013,total_driving,124
NA,125,Jason Bohn,23,201,166,35,2013,total_driving,125
NA,T126,Rod Pampling,16,204,129,75,2013,total_driving,T126
NA,T126,Brandt Snedeker,23,204,137,67,2013,total_driving,T126
NA,T128,Erik Compton,24,205,54,151,2013,total_driving,T128
NA,T128,Bobby Gates,20,205,28,177,2013,total_driving,T128
NA,T128,Robert Karlsson,18,205,98,107,2013,total_driving,T128
NA,131,Colt Knost,25,206,179,27,2013,total_driving,131
NA,132,Ian Poulter,16,207,136,71,2013,total_driving,132
NA,T133,Bryce Molder,24,209,176,33,2013,total_driving,T133
NA,T133,Geoff Ogilvy,19,209,114,95,2013,total_driving,T133
NA,135,Charles Howell III,26,210,37,173,2013,total_driving,135
NA,T136,Brian Gay,24,212,170,42,2013,total_driving,T136
NA,T136,Dicky Pride,23,212,174,38,2013,total_driving,T136
NA,T138,David Mathis,24,213,142,71,2013,total_driving,T138
NA,T138,William McGirt,24,213,134,79,2013,total_driving,T138
NA,T140,Matt Every,28,214,91,123,2013,total_driving,T140
NA,T140,Justin Leonard,24,214,166,48,2013,total_driving,T140
NA,142,Patrick Reed,26,215,58,157,2013,total_driving,142
NA,143,Bud Cauley,24,216,94,122,2013,total_driving,143
NA,T144,Luke Donald,17,217,157,60,2013,total_driving,T144
NA,T144,Tommy Gainey,28,217,64,153,2013,total_driving,T144
NA,146,Trevor Immelman,24,218,124,94,2013,total_driving,146
NA,T147,Ernie Els,19,220,77,143,2013,total_driving,T147
NA,T147,Luke Guthrie,27,220,127,93,2013,total_driving,T147
NA,T147,Aaron Watkins,19,220,163,57,2013,total_driving,T147
NA,T150,Scott Gardiner,23,221,87,134,2013,total_driving,T150
NA,T150,Ryo Ishikawa,23,221,62,159,2013,total_driving,T150
NA,152,Scott Langley,27,222,152,70,2013,total_driving,152
NA,153,Stewart Cink,22,223,73,150,2013,total_driving,153
NA,154,Padraig Harrington,17,224,89,135,2013,total_driving,154
NA,155,John Merrick,23,226,122,104,2013,total_driving,155
NA,T156,Greg Chalmers,25,227,165,62,2013,total_driving,T156
NA,T156,Marc Leishman,23,227,102,125,2013,total_driving,T156
NA,158,David Hearn,26,228,147,81,2013,total_driving,158
NA,159,Ben Crane,21,234,139,95,2013,total_driving,159
NA,160,Michael Thompson,22,236,148,88,2013,total_driving,160
NA,161,Chris Stroud,26,237,164,73,2013,total_driving,161
NA,162,Justin Bolli,23,238,149,89,2013,total_driving,162
NA,163,Matt Kuchar,23,240,116,124,2013,total_driving,163
NA,164,Phil Mickelson,21,242,93,149,2013,total_driving,164
NA,165,Sangmoon Bae,26,247,112,135,2013,total_driving,165
NA,166,Freddie Jacobson,19,252,97,155,2013,total_driving,166
NA,167,Robert Allenby,24,257,116,141,2013,total_driving,167
NA,168,Alistair Presnell,23,260,121,139,2013,total_driving,168
NA,169,Aaron Baddeley,24,265,86,179,2013,total_driving,169
NA,170,James Driscoll,23,266,100,166,2013,total_driving,170
NA,171,Michael Bradley,21,272,112,160,2013,total_driving,171
NA,172,Stephen Ames,19,274,141,133,2013,total_driving,172
NA,173,Jonas Blixt,24,275,123,152,2013,total_driving,173
NA,174,Ben Curtis,20,276,173,103,2013,total_driving,174
NA,T175,David Lynn,22,280,159,121,2013,total_driving,T175
NA,T175,Lee Williams,22,280,168,112,2013,total_driving,T175
NA,177,Johnson Wagner,24,283,155,128,2013,total_driving,177
NA,178,Tim Herron,15,299,124,175,2013,total_driving,178
NA,179,Casey Wittenberg,27,308,143,165,2013,total_driving,179
NA,180,Mike Weir,22,343,180,163,2013,total_driving,180
NA,1,Lucas Glover,26,74,20,54,2014,total_driving,1
NA,2,Henrik Stenson,15,78,64,14,2014,total_driving,2
NA,3,Hunter Mahan,25,81,45,36,2014,total_driving,3
NA,4,Hudson Swafford,26,82,33,49,2014,total_driving,4
NA,5,Derek Ernst,28,83,38,45,2014,total_driving,5
NA,T6,Kevin Chappell,28,84,43,41,2014,total_driving,T6
NA,T6,Shawn Stefani,17,84,31,53,2014,total_driving,T6
NA,8,Keegan Bradley,26,86,17,69,2014,total_driving,8
NA,9,Graham DeLaet,24,89,14,75,2014,total_driving,9
NA,10,Adam Scott,17,93,13,80,2014,total_driving,10
NA,11,Billy Horschel,27,99,76,23,2014,total_driving,11
NA,T12,Jhonattan Vegas,23,101,8,93,2014,total_driving,T12
NA,T12,Nick Watney,25,101,45,56,2014,total_driving,T12
NA,14,Bubba Watson,21,103,1,102,2014,total_driving,14
NA,15,Boo Weekley,24,110,100,10,2014,total_driving,15
NA,16,Rory McIlroy,17,111,3,108,2014,total_driving,16
NA,17,Kevin Streelman,24,113,97,16,2014,total_driving,17
NA,18,Louis Oosthuizen,16,119,21,98,2014,total_driving,18
NA,19,Willy Wilcox,16,121,36,85,2014,total_driving,19
NA,T20,Ben Martin,26,122,75,47,2014,total_driving,T20
NA,T20,Kyle Stanley,28,122,33,89,2014,total_driving,T20
NA,T22,Brendon de Jonge,31,123,106,17,2014,total_driving,T22
NA,T22,Russell Henley,29,123,61,62,2014,total_driving,T22
NA,24,Kevin Stadler,26,125,76,49,2014,total_driving,24
NA,T25,Jim Herman,21,126,52,74,2014,total_driving,T25
NA,T25,Martin Laird,20,126,37,89,2014,total_driving,T25
NA,T27,J.J. Henry,28,128,82,46,2014,total_driving,T27
NA,T27,Justin Hicks,30,128,125,3,2014,total_driving,T27
NA,T27,Will MacKenzie,27,128,84,44,2014,total_driving,T27
NA,T27,Gary Woodland,25,128,9,119,2014,total_driving,T27
NA,T31,Sergio Garcia,16,130,57,73,2014,total_driving,T31
NA,T31,Hideki Matsuyama,24,130,51,79,2014,total_driving,T31
NA,33,Harris English,28,132,26,106,2014,total_driving,33
NA,T34,Charlie Beljan,26,136,11,125,2014,total_driving,T34
NA,T34,Nicholas Thompson,30,136,114,22,2014,total_driving,T34
NA,T36,Bill Haas,28,137,73,64,2014,total_driving,T36
NA,T36,John Merrick,25,137,122,15,2014,total_driving,T36
NA,T38,Scott Brown,30,138,112,26,2014,total_driving,T38
NA,T38,Martin Kaymer,19,138,50,88,2014,total_driving,T38
NA,T38,Russell Knox,26,138,120,18,2014,total_driving,T38
NA,T38,Ryan Moore,24,138,129,9,2014,total_driving,T38
NA,T42,Rickie Fowler,26,141,33,108,2014,total_driving,T42
NA,T42,Robert Streb,21,141,25,116,2014,total_driving,T42
NA,T44,Chad Campbell,18,142,107,35,2014,total_driving,T44
NA,T44,Andrew Svoboda,24,142,111,31,2014,total_driving,T44
NA,46,Bo Van Pelt,25,143,78,65,2014,total_driving,46
NA,47,Josh Teater,28,144,53,91,2014,total_driving,47
NA,48,Brendan Steele,26,145,28,117,2014,total_driving,48
NA,T49,Chris Kirk,28,146,80,66,2014,total_driving,T49
NA,T49,John Senden,27,146,95,51,2014,total_driving,T49
NA,51,Zach Johnson,26,147,141,6,2014,total_driving,51
NA,52,Dustin Johnson,17,148,2,146,2014,total_driving,52
NA,53,Jason Day,15,149,18,131,2014,total_driving,53
NA,T54,Ángel Cabrera,23,151,12,139,2014,total_driving,T54
NA,T54,Charl Schwartzel,18,151,30,121,2014,total_driving,T54
NA,56,Robert Garrigus,25,153,7,146,2014,total_driving,56
NA,T57,Brooks Koepka,16,156,6,150,2014,total_driving,T57
NA,T57,Matt Kuchar,24,156,136,20,2014,total_driving,T57
NA,T57,Ryan Palmer,23,156,23,133,2014,total_driving,T57
NA,60,John Peterson,25,157,102,55,2014,total_driving,60
NA,61,Charley Hoffman,25,158,26,132,2014,total_driving,61
NA,T62,Jim Furyk,21,159,155,4,2014,total_driving,T62
NA,T62,John Huh,28,159,134,25,2014,total_driving,T62
NA,T62,Michael Putnam,30,159,65,94,2014,total_driving,T62
NA,T65,Brad Fritsch,18,160,56,104,2014,total_driving,T65
NA,T65,Justin Rose,19,160,49,111,2014,total_driving,T65
NA,67,Wes Roach,22,161,65,96,2014,total_driving,67
NA,68,Lee Westwood,18,162,71,91,2014,total_driving,68
NA,69,Michael Thompson,22,164,93,71,2014,total_driving,69
NA,70,Davis Love III,22,165,41,124,2014,total_driving,70
NA,71,Paul Casey,16,166,65,101,2014,total_driving,71
NA,T72,J.B. Holmes,24,168,4,164,2014,total_driving,T72
NA,T72,Webb Simpson,25,168,98,70,2014,total_driving,T72
NA,T72,Brian Stuard,29,168,137,31,2014,total_driving,T72
NA,75,Danny Lee,28,169,132,37,2014,total_driving,75
NA,T76,Jason Kokrak,19,171,14,157,2014,total_driving,T76
NA,T76,Heath Slocum,23,171,166,5,2014,total_driving,T76
NA,T76,Daniel Summerhays,27,171,141,30,2014,total_driving,T76
NA,T79,Marc Leishman,24,173,32,141,2014,total_driving,T79
NA,T79,"Ted Potter, Jr.",24,173,162,11,2014,total_driving,T79
NA,T81,David Toms,20,174,173,1,2014,total_driving,T81
NA,T81,Camilo Villegas,29,174,68,106,2014,total_driving,T81
NA,T83,David Hearn,28,175,156,19,2014,total_driving,T83
NA,T83,Billy Hurley III,26,175,168,7,2014,total_driving,T83
NA,T85,Tim Clark,26,176,174,2,2014,total_driving,T85
NA,T85,Carl Pettersson,28,176,47,129,2014,total_driving,T85
NA,T85,Chris Stroud,25,176,119,57,2014,total_driving,T85
NA,T88,Matt Jones,25,177,41,136,2014,total_driving,T88
NA,T88,Graeme McDowell,17,177,165,12,2014,total_driving,T88
NA,T88,Mark Wilson,25,177,153,24,2014,total_driving,T88
NA,T88,Y.E. Yang,28,177,143,34,2014,total_driving,T88
NA,92,Scott Stallings,28,178,23,155,2014,total_driving,92
NA,93,Ken Duke,25,179,171,8,2014,total_driving,93
NA,94,Jonathan Byrd,24,180,102,78,2014,total_driving,94
NA,T95,Jason Dufner,17,181,122,59,2014,total_driving,T95
NA,T95,Charles Howell III,29,181,9,172,2014,total_driving,T95
NA,T95,Andrew Loupe,22,181,4,177,2014,total_driving,T95
NA,T95,Brandt Snedeker,25,181,121,60,2014,total_driving,T95
NA,T99,Stewart Cink,25,182,61,121,2014,total_driving,T99
NA,T99,Jamie Lovemark,20,182,16,166,2014,total_driving,T99
NA,T99,Jeff Maggert,19,182,169,13,2014,total_driving,T99
NA,T99,Kevin Tway,23,182,55,127,2014,total_driving,T99
NA,T103,Sangmoon Bae,24,184,98,86,2014,total_driving,T103
NA,T103,Brian Davis,28,184,163,21,2014,total_driving,T103
NA,105,Ben Crane,25,186,157,29,2014,total_driving,105
NA,T106,George McNeill,24,188,117,71,2014,total_driving,T106
NA,T106,Sean O'Hair,25,188,21,167,2014,total_driving,T106
NA,T108,Steven Bowditch,30,189,29,160,2014,total_driving,T108
NA,T108,Ian Poulter,17,189,102,87,2014,total_driving,T108
NA,T108,Vijay Singh,25,189,89,100,2014,total_driving,T108
NA,T111,Jason Bohn,25,190,151,39,2014,total_driving,T111
NA,T111,James Hahn,27,190,91,99,2014,total_driving,T111
NA,T111,Kevin Kisner,26,190,107,83,2014,total_driving,T111
NA,T111,Spencer Levin,20,190,150,40,2014,total_driving,T111
NA,T111,Brendon Todd,29,190,148,42,2014,total_driving,T111
NA,116,Brian Harman,32,191,94,97,2014,total_driving,116
NA,117,William McGirt,29,193,160,33,2014,total_driving,117
NA,118,Jerry Kelly,23,194,167,27,2014,total_driving,118
NA,119,Jimmy Walker,27,195,19,176,2014,total_driving,119
NA,T120,Martin Flores,26,196,44,152,2014,total_driving,T120
NA,T120,Kevin Na,27,196,148,48,2014,total_driving,T120
NA,T122,Roberto Castro,27,197,134,63,2014,total_driving,T122
NA,T122,Ben Curtis,24,197,154,43,2014,total_driving,T122
NA,T122,Cameron Tringale,31,197,139,58,2014,total_driving,T122
NA,T125,D.H. Lee,20,198,170,28,2014,total_driving,T125
NA,T125,D.A. Points,27,198,131,67,2014,total_driving,T125
NA,127,John Rollins,28,199,86,113,2014,total_driving,127
NA,128,David Lingmerth,26,200,88,112,2014,total_driving,128
NA,T129,Tommy Gainey,26,201,59,142,2014,total_driving,T129
NA,T129,Seung-Yul Noh,27,201,40,161,2014,total_driving,T129
NA,T131,Richard Lee,27,202,125,77,2014,total_driving,T131
NA,T131,Geoff Ogilvy,26,202,68,134,2014,total_driving,T131
NA,T133,Briny Baird,17,204,144,60,2014,total_driving,T133
NA,T133,K.J. Choi,23,204,152,52,2014,total_driving,T133
NA,T135,Bud Cauley,19,207,63,144,2014,total_driving,T135
NA,T135,Troy Merritt,20,207,124,83,2014,total_driving,T135
NA,137,Robert Allenby,29,208,127,81,2014,total_driving,137
NA,T138,Gonzalo Fernandez-Castaño,25,210,102,108,2014,total_driving,T138
NA,T138,Trevor Immelman,28,210,74,136,2014,total_driving,T138
NA,T138,Troy Matteson,23,210,39,171,2014,total_driving,T138
NA,T138,Phil Mickelson,21,210,70,140,2014,total_driving,T138
NA,142,Morgan Hoffmann,32,213,48,165,2014,total_driving,142
NA,143,Justin Leonard,22,215,177,38,2014,total_driving,143
NA,144,Andres Romero,26,216,53,163,2014,total_driving,144
NA,145,Rory Sabbatini,26,217,58,159,2014,total_driving,145
NA,146,Jordan Spieth,27,218,89,129,2014,total_driving,146
NA,T147,Brice Garnett,28,220,92,128,2014,total_driving,T147
NA,T147,Pat Perez,25,220,115,105,2014,total_driving,T147
NA,149,Patrick Reed,28,229,71,158,2014,total_driving,149
NA,150,Luke Donald,17,231,164,67,2014,total_driving,150
NA,151,Chesson Hadley,29,232,84,148,2014,total_driving,151
NA,T152,Aaron Baddeley,24,235,60,175,2014,total_driving,T152
NA,T152,Luke Guthrie,26,235,109,126,2014,total_driving,T152
NA,154,Scott Langley,29,239,145,94,2014,total_driving,154
NA,155,Bronson La'Cassie,18,241,127,114,2014,total_driving,155
NA,156,Woody Austin,22,242,160,82,2014,total_driving,156
NA,157,Ricky Barnes,27,244,82,162,2014,total_driving,157
NA,158,Ernie Els,24,248,79,169,2014,total_driving,158
NA,159,Ryo Ishikawa,24,249,80,169,2014,total_driving,159
NA,160,Brian Gay,26,251,175,76,2014,total_driving,160
NA,161,Retief Goosen,26,252,96,156,2014,total_driving,161
NA,162,Freddie Jacobson,27,253,130,123,2014,total_driving,162
NA,163,Jim Renner,25,254,101,153,2014,total_driving,163
NA,T164,Jeff Overton,24,255,110,145,2014,total_driving,T164
NA,T164,Tyrone Van Aswegen,25,255,87,168,2014,total_driving,T164
NA,166,Tim Wilkinson,25,257,140,117,2014,total_driving,166
NA,T167,Stuart Appleby,29,262,159,103,2014,total_driving,T167
NA,T167,Johnson Wagner,24,262,113,149,2014,total_driving,T167
NA,169,Matt Every,26,267,116,151,2014,total_driving,169
NA,170,Jonas Blixt,21,271,117,154,2014,total_driving,170
NA,171,Erik Compton,28,276,138,138,2014,total_driving,171
NA,172,Bryce Molder,25,277,158,119,2014,total_driving,172
NA,173,Greg Chalmers,27,281,147,134,2014,total_driving,173
NA,174,Chad Collins,28,287,172,115,2014,total_driving,174
NA,175,Charlie Wi,25,289,146,143,2014,total_driving,175
NA,176,James Driscoll,25,306,132,174,2014,total_driving,176
NA,177,Mike Weir,25,349,176,173,2014,total_driving,177
NA,1,Henrik Stenson,16,55,43,12,2015,total_driving,1
NA,2,Willy Wilcox,17,60,42,18,2015,total_driving,2
NA,3,Keegan Bradley,24,62,10,52,2015,total_driving,3
NA,4,Justin Rose,20,78,14,64,2015,total_driving,4
NA,5,Graham DeLaet,22,79,32,47,2015,total_driving,5
NA,6,Charlie Beljan,27,89,6,83,2015,total_driving,6
NA,7,Russell Henley,24,90,36,54,2015,total_driving,7
NA,8,Paul Casey,24,93,35,58,2015,total_driving,8
NA,9,Jim Herman,27,95,62,33,2015,total_driving,9
NA,10,Hudson Swafford,30,103,29,74,2015,total_driving,10
NA,11,Lucas Glover,26,104,38,66,2015,total_driving,11
NA,T12,Derek Ernst,26,106,50,56,2015,total_driving,T12
NA,T12,Hideki Matsuyama,25,106,57,49,2015,total_driving,T12
NA,14,Davis Love III,18,107,56,51,2015,total_driving,14
NA,15,Adam Scott,15,111,4,107,2015,total_driving,15
NA,T16,Brendan Steele,24,113,16,97,2015,total_driving,T16
NA,T16,Kevin Streelman,27,113,93,20,2015,total_driving,T16
NA,T18,Daniel Berger,31,122,18,104,2015,total_driving,T18
NA,T18,Billy Horschel,28,122,53,69,2015,total_driving,T18
NA,T20,Jason Gore,26,123,87,36,2015,total_driving,T20
NA,T20,Webb Simpson,22,123,97,26,2015,total_driving,T20
NA,T22,Rickie Fowler,21,126,39,87,2015,total_driving,T22
NA,T22,John Senden,24,126,89,37,2015,total_driving,T22
NA,24,Charl Schwartzel,19,127,24,103,2015,total_driving,24
NA,25,Chez Reavie,19,128,125,3,2015,total_driving,25
NA,26,Sam Saunders,28,130,68,62,2015,total_driving,26
NA,T27,Kevin Chappell,26,132,67,65,2015,total_driving,T27
NA,T27,Shawn Stefani,26,132,44,88,2015,total_driving,T27
NA,29,Alex Prugh,27,138,49,89,2015,total_driving,29
NA,30,David Lingmerth,28,139,93,46,2015,total_driving,30
NA,31,John Peterson,25,140,110,30,2015,total_driving,31
NA,32,Lee Westwood,15,144,25,119,2015,total_driving,32
NA,33,Nicholas Thompson,31,146,127,19,2015,total_driving,33
NA,T34,Jason Dufner,21,148,121,27,2015,total_driving,T34
NA,T34,Sergio Garcia,15,148,25,123,2015,total_driving,T34
NA,T34,Kevin Kisner,30,148,114,34,2015,total_driving,T34
NA,T34,Louis Oosthuizen,20,148,31,117,2015,total_driving,T34
NA,38,Carlos Ortiz,30,150,33,117,2015,total_driving,38
NA,T39,Sean O'Hair,26,151,47,104,2015,total_driving,T39
NA,T39,Boo Weekley,24,151,76,75,2015,total_driving,T39
NA,41,Justin Thomas,30,152,15,137,2015,total_driving,41
NA,42,Brooks Koepka,23,153,8,145,2015,total_driving,42
NA,43,Francesco Molinari,16,154,153,1,2015,total_driving,43
NA,T44,Bill Haas,25,155,82,73,2015,total_driving,T44
NA,T44,Spencer Levin,31,155,139,16,2015,total_driving,T44
NA,T44,John Merrick,27,155,133,22,2015,total_driving,T44
NA,T44,Patrick Rodgers,17,155,9,146,2015,total_driving,T44
NA,T44,Bubba Watson,19,155,2,153,2015,total_driving,T44
NA,T49,Adam Hadwin,30,156,108,48,2015,total_driving,T49
NA,T49,Zach Johnson,25,156,148,8,2015,total_driving,T49
NA,51,Martin Laird,24,157,22,135,2015,total_driving,51
NA,52,Jordan Spieth,25,158,78,80,2015,total_driving,52
NA,T53,Ryan Moore,24,159,148,11,2015,total_driving,T53
NA,T53,Robert Streb,30,159,36,123,2015,total_driving,T53
NA,T53,Nick Watney,28,159,61,98,2015,total_driving,T53
NA,56,Ben Martin,27,160,110,50,2015,total_driving,56
NA,57,Jonathan Byrd,22,162,117,45,2015,total_driving,57
NA,T58,Russell Knox,28,164,136,28,2015,total_driving,T58
NA,T58,Ryan Palmer,22,164,13,151,2015,total_driving,T58
NA,T60,Jason Day,20,165,3,162,2015,total_driving,T60
NA,T60,Matt Jones,25,165,46,119,2015,total_driving,T60
NA,T62,James Hahn,28,166,50,116,2015,total_driving,T62
NA,T62,Dustin Johnson,21,166,1,165,2015,total_driving,T62
NA,T62,Jason Kokrak,28,166,11,155,2015,total_driving,T62
NA,65,Jamie Donaldson,16,167,54,113,2015,total_driving,65
NA,T66,Jim Furyk,19,168,151,17,2015,total_driving,T66
NA,T66,Brian Harman,29,168,113,55,2015,total_driving,T66
NA,T66,Johnson Wagner,23,168,82,86,2015,total_driving,T66
NA,T69,Harris English,29,169,33,136,2015,total_driving,T69
NA,T69,Scott Piercy,28,169,41,128,2015,total_driving,T69
NA,T71,Robert Garrigus,25,170,20,150,2015,total_driving,T71
NA,T71,Charley Hoffman,28,170,29,141,2015,total_driving,T71
NA,T71,Gary Woodland,24,170,12,158,2015,total_driving,T71
NA,74,Chad Campbell,30,172,131,41,2015,total_driving,74
NA,T75,Steven Alker,22,173,167,6,2015,total_driving,T75
NA,T75,Blayne Barber,26,173,103,70,2015,total_driving,T75
NA,T75,Cameron Tringale,28,173,152,21,2015,total_driving,T75
NA,T78,Brendon de Jonge,31,174,130,44,2015,total_driving,T78
NA,T78,John Huh,31,174,160,14,2015,total_driving,T78
NA,80,Jason Bohn,27,176,171,5,2015,total_driving,80
NA,81,Pat Perez,26,178,135,43,2015,total_driving,81
NA,T82,Tony Finau,31,179,7,172,2015,total_driving,T82
NA,T82,Jerry Kelly,24,179,170,9,2015,total_driving,T82
NA,T84,J.B. Holmes,25,180,5,175,2015,total_driving,T84
NA,T84,Colt Knost,29,180,173,7,2015,total_driving,T84
NA,T84,Matt Kuchar,25,180,104,76,2015,total_driving,T84
NA,T87,Hunter Mahan,24,181,50,131,2015,total_driving,T87
NA,T87,Sung Joon Park,27,181,139,42,2015,total_driving,T87
NA,T89,J.J. Henry,30,183,72,111,2015,total_driving,T89
NA,T89,William McGirt,30,183,158,25,2015,total_driving,T89
NA,T89,Phil Mickelson,19,183,22,161,2015,total_driving,T89
NA,T89,Greg Owen,19,183,62,121,2015,total_driving,T89
NA,T93,Oscar Fraustro,21,186,93,93,2015,total_driving,T93
NA,T93,Justin Leonard,22,186,182,4,2015,total_driving,T93
NA,T93,Bill Lunde,18,186,115,71,2015,total_driving,T93
NA,T93,George McNeill,27,186,126,60,2015,total_driving,T93
NA,T93,Geoff Ogilvy,15,186,64,122,2015,total_driving,T93
NA,T93,Brendon Todd,27,186,176,10,2015,total_driving,T93
NA,T93,David Toms,21,186,184,2,2015,total_driving,T93
NA,T93,Steve Wheatcroft,28,186,107,79,2015,total_driving,T93
NA,T101,Martin Flores,30,187,39,148,2015,total_driving,T101
NA,T101,Jhonattan Vegas,27,187,27,160,2015,total_driving,T101
NA,T103,Scott Pinckney,27,189,88,101,2015,total_driving,T103
NA,T103,Brian Stuard,31,189,174,15,2015,total_driving,T103
NA,T105,Scott Brown,30,190,108,82,2015,total_driving,T105
NA,T105,Roger Sloan,20,190,65,125,2015,total_driving,T105
NA,T105,Heath Slocum,22,190,177,13,2015,total_driving,T105
NA,T108,Ángel Cabrera,19,191,28,163,2015,total_driving,T108
NA,T108,Ken Duke,30,191,168,23,2015,total_driving,T108
NA,110,Ian Poulter,19,193,121,72,2015,total_driving,110
NA,111,Steven Bowditch,32,194,18,176,2015,total_driving,111
NA,T112,Charles Howell III,30,196,17,179,2015,total_driving,T112
NA,T112,Michael Putnam,28,196,101,95,2015,total_driving,T112
NA,114,Andres Gonzales,28,197,57,140,2015,total_driving,114
NA,115,Gonzalo Fernandez-Castaño,28,198,98,100,2015,total_driving,115
NA,T116,Cameron Percy,23,199,90,109,2015,total_driving,T116
NA,T116,Vijay Singh,23,199,85,114,2015,total_driving,T116
NA,T116,Bo Van Pelt,28,199,93,106,2015,total_driving,T116
NA,T119,Roberto Castro,16,200,160,40,2015,total_driving,T119
NA,T119,Rory Sabbatini,25,200,90,110,2015,total_driving,T119
NA,121,Jimmy Walker,24,201,21,180,2015,total_driving,121
NA,T122,Zac Blair,34,203,180,23,2015,total_driving,T122
NA,T122,Mark Hubbard,25,203,165,38,2015,total_driving,T122
NA,T122,Chris Stroud,28,203,146,57,2015,total_driving,T122
NA,T125,Bryce Molder,26,204,169,35,2015,total_driving,T125
NA,T125,Brandt Snedeker,27,204,105,99,2015,total_driving,T125
NA,127,Kyle Reifers,31,206,112,94,2015,total_driving,127
NA,T128,Sangmoon Bae,30,207,92,115,2015,total_driving,T128
NA,T128,Brian Davis,31,207,178,29,2015,total_driving,T128
NA,T130,Tom Hoge,26,208,74,134,2015,total_driving,T130
NA,T130,Danny Lee,36,208,145,63,2015,total_driving,T130
NA,T132,Alex Cejka,30,209,141,68,2015,total_driving,T132
NA,T132,Stewart Cink,23,209,65,144,2015,total_driving,T132
NA,T134,Jon Curran,28,211,179,32,2015,total_driving,T134
NA,T134,Carl Pettersson,32,211,81,130,2015,total_driving,T134
NA,136,Troy Merritt,29,212,131,81,2015,total_driving,136
NA,137,Max Homa,27,213,59,154,2015,total_driving,137
NA,T138,Ben Crane,22,214,183,31,2015,total_driving,T138
NA,T138,David Hearn,30,214,156,58,2015,total_driving,T138
NA,T140,Brice Garnett,29,215,119,96,2015,total_driving,T140
NA,T140,Morgan Hoffmann,26,215,45,170,2015,total_driving,T140
NA,T140,Mark Wilson,28,215,162,53,2015,total_driving,T140
NA,143,Byron Smith,21,216,77,139,2015,total_driving,143
NA,144,Chris Kirk,21,218,128,90,2015,total_driving,144
NA,T145,Billy Hurley III,28,220,181,39,2015,total_driving,T145
NA,T145,Scott Stallings,19,220,78,142,2015,total_driving,T145
NA,T147,Retief Goosen,25,222,71,151,2015,total_driving,T147
NA,T147,Marc Leishman,23,222,55,167,2015,total_driving,T147
NA,T149,Robert Allenby,25,225,147,78,2015,total_driving,T149
NA,T149,Andres Romero,24,225,47,178,2015,total_driving,T149
NA,151,Jonas Blixt,26,228,116,112,2015,total_driving,151
NA,T152,Ernie Els,18,229,80,149,2015,total_driving,T152
NA,T152,Chesson Hadley,30,229,82,147,2015,total_driving,T152
NA,T152,Daniel Summerhays,29,229,137,92,2015,total_driving,T152
NA,155,Nick Taylor,28,231,72,159,2015,total_driving,155
NA,T156,Chad Collins,24,232,166,66,2015,total_driving,T156
NA,T156,Erik Compton,28,232,105,127,2015,total_driving,T156
NA,T158,K.J. Choi,19,235,174,61,2015,total_driving,T158
NA,T158,Michael Thompson,27,235,98,137,2015,total_driving,T158
NA,T160,Greg Chalmers,17,239,154,85,2015,total_driving,T160
NA,T160,Seung-Yul Noh,21,239,70,169,2015,total_driving,T160
NA,T162,Patrick Reed,27,240,69,171,2015,total_driving,T162
NA,T162,Tim Wilkinson,28,240,163,77,2015,total_driving,T162
NA,164,Kevin Na,27,243,159,84,2015,total_driving,164
NA,165,Aaron Baddeley,25,244,60,184,2015,total_driving,165
NA,166,Andrew Svoboda,30,245,119,126,2015,total_driving,166
NA,167,Fabián Gómez,26,246,144,102,2015,total_driving,167
NA,168,Camilo Villegas,27,247,74,173,2015,total_driving,168
NA,169,Scott Langley,28,248,157,91,2015,total_driving,169
NA,170,Ryo Ishikawa,28,256,100,156,2015,total_driving,170
NA,171,Whee Kim,23,258,150,108,2015,total_driving,171
NA,172,Jeff Overton,30,266,134,132,2015,total_driving,172
NA,173,Padraig Harrington,21,267,86,181,2015,total_driving,173
NA,174,Luke Guthrie,27,271,138,133,2015,total_driving,174
NA,175,Derek Fathauer,27,283,101,182,2015,total_driving,175
NA,T176,Jonathan Randolph,25,284,118,166,2015,total_driving,T176
NA,T176,Jim Renner,27,284,141,143,2015,total_driving,T176
NA,178,Eric Axley,21,288,124,164,2015,total_driving,178
NA,179,Luke Donald,20,301,172,129,2015,total_driving,179
NA,T180,Matt Every,26,306,123,183,2015,total_driving,T180
NA,T180,Tyrone Van Aswegen,20,306,129,177,2015,total_driving,T180
NA,182,D.A. Points,26,312,155,157,2015,total_driving,182
NA,183,Ricky Barnes,27,315,141,174,2015,total_driving,183
NA,184,Andrew Putnam,23,332,164,168,2015,total_driving,184
NA,1,Keegan Bradley,26,64,27,37,2016,total_driving,1
NA,2,Lucas Glover,23,75,35,40,2016,total_driving,2
NA,3,Hudson Swafford,30,81,7,74,2016,total_driving,3
NA,4,Emiliano Grillo,25,84,67,17,2016,total_driving,4
NA,5,Andrew Landry,18,85,59,26,2016,total_driving,5
NA,6,Rory McIlroy,18,86,9,77,2016,total_driving,6
NA,7,Paul Casey,22,90,54,36,2016,total_driving,7
NA,8,Thomas Aiken,23,91,89,2,2016,total_driving,8
NA,9,Sergio Garcia,15,98,28,70,2016,total_driving,9
NA,10,Scott Pinckney,29,99,43,56,2016,total_driving,10
NA,11,Boo Weekley,26,100,84,16,2016,total_driving,11
NA,12,Shane Lowry,17,101,32,69,2016,total_driving,12
NA,13,Russell Henley,25,103,48,55,2016,total_driving,13
NA,14,Jim Herman,29,112,87,25,2016,total_driving,14
NA,15,Brendan Steele,25,114,20,94,2016,total_driving,15
NA,16,Scott Brown,27,123,76,47,2016,total_driving,16
NA,17,Jason Kokrak,28,125,6,119,2016,total_driving,17
NA,T18,Si Woo Kim,34,126,69,57,2016,total_driving,T18
NA,T18,Harold Varner III,28,126,22,104,2016,total_driving,T18
NA,20,Jason Dufner,28,128,70,58,2016,total_driving,20
NA,T21,Graham DeLaet,21,132,37,95,2016,total_driving,T21
NA,T21,Hideki Matsuyama,23,132,65,67,2016,total_driving,T21
NA,T21,Sean O'Hair,27,132,20,112,2016,total_driving,T21
NA,T21,Brett Stegmaier,29,132,52,80,2016,total_driving,T21
NA,T25,Kevin Chappell,27,133,46,87,2016,total_driving,T25
NA,T25,Chez Reavie,27,133,123,10,2016,total_driving,T25
NA,T27,Rickie Fowler,23,136,23,113,2016,total_driving,T27
NA,T27,Brooks Koepka,21,136,19,117,2016,total_driving,T27
NA,29,Wes Roach,21,137,59,78,2016,total_driving,29
NA,T30,Kevin Kisner,27,138,105,33,2016,total_driving,T30
NA,T30,Scott Piercy,24,138,37,101,2016,total_driving,T30
NA,32,Louis Oosthuizen,17,139,68,71,2016,total_driving,32
NA,T33,Dustin Johnson,22,140,2,138,2016,total_driving,T33
NA,T33,Ryan Palmer,23,140,12,128,2016,total_driving,T33
NA,35,Adam Hadwin,27,141,92,49,2016,total_driving,35
NA,36,Justin Rose,18,143,16,127,2016,total_driving,36
NA,37,Kevin Streelman,26,144,104,40,2016,total_driving,37
NA,T38,Russell Knox,25,145,137,8,2016,total_driving,T38
NA,T38,Marc Leishman,25,145,55,90,2016,total_driving,T38
NA,T40,Brian Harman,31,146,95,51,2016,total_driving,T40
NA,T40,Jamie Lovemark,27,146,11,135,2016,total_driving,T40
NA,T40,Greg Owen,29,146,39,107,2016,total_driving,T40
NA,43,William McGirt,28,149,118,31,2016,total_driving,43
NA,44,Kyle Stanley,28,150,112,38,2016,total_driving,44
NA,45,Jason Gore,27,151,103,48,2016,total_driving,45
NA,46,Kyle Reifers,34,153,123,30,2016,total_driving,46
NA,T47,John Huh,28,154,145,9,2016,total_driving,T47
NA,T47,Gary Woodland,26,154,10,144,2016,total_driving,T47
NA,T49,Chad Campbell,28,155,116,39,2016,total_driving,T49
NA,T49,Roberto Castro,27,155,149,6,2016,total_driving,T49
NA,T49,Geoff Ogilvy,22,155,80,75,2016,total_driving,T49
NA,52,Billy Horschel,20,156,72,84,2016,total_driving,52
NA,T53,Blayne Barber,27,157,97,60,2016,total_driving,T53
NA,T53,Patrick Rodgers,28,157,26,131,2016,total_driving,T53
NA,T55,Derek Ernst,20,159,63,96,2016,total_driving,T55
NA,T55,Bill Haas,24,159,97,62,2016,total_driving,T55
NA,T55,David Lingmerth,24,159,144,15,2016,total_driving,T55
NA,58,Matt Kuchar,26,161,137,24,2016,total_driving,58
NA,T59,Stewart Cink,19,162,42,120,2016,total_driving,T59
NA,T59,Rod Pampling,18,162,117,45,2016,total_driving,T59
NA,T59,Jhonattan Vegas,27,162,14,148,2016,total_driving,T59
NA,T62,Henrik Norlander,21,164,112,52,2016,total_driving,T62
NA,T62,Bubba Watson,19,164,4,160,2016,total_driving,T62
NA,64,Adam Scott,20,166,13,153,2016,total_driving,64
NA,65,Jim Furyk,14,167,160,7,2016,total_driving,65
NA,T66,Whee Kim,27,168,118,50,2016,total_driving,T66
NA,T66,Ryan Moore,23,168,150,18,2016,total_driving,T66
NA,T68,Spencer Levin,32,169,157,12,2016,total_driving,T68
NA,T68,Graeme McDowell,21,169,156,13,2016,total_driving,T68
NA,70,James Hahn,26,172,88,84,2016,total_driving,70
NA,T71,Scott Langley,22,174,139,35,2016,total_driving,T71
NA,T71,Danny Lee,28,174,130,44,2016,total_driving,T71
NA,T71,Ben Martin,28,174,108,66,2016,total_driving,T71
NA,T71,Jordan Spieth,21,174,51,123,2016,total_driving,T71
NA,T71,Michael Thompson,23,174,85,89,2016,total_driving,T71
NA,76,Francesco Molinari,18,175,129,46,2016,total_driving,76
NA,77,Willy Wilcox,23,176,73,103,2016,total_driving,77
NA,T78,Alex Cejka,22,177,155,22,2016,total_driving,T78
NA,T78,Jerry Kelly,23,177,174,3,2016,total_driving,T78
NA,T78,Johnson Wagner,26,177,101,76,2016,total_driving,T78
NA,T81,Tony Finau,28,178,3,175,2016,total_driving,T81
NA,T81,Fabián Gómez,26,178,105,73,2016,total_driving,T81
NA,T83,David Hearn,29,179,158,21,2016,total_driving,T83
NA,T83,Sung Kang,29,179,77,102,2016,total_driving,T83
NA,T83,Sam Saunders,24,179,81,98,2016,total_driving,T83
NA,T86,Daniel Berger,26,180,34,146,2016,total_driving,T86
NA,T86,J.B. Holmes,22,180,1,179,2016,total_driving,T86
NA,T86,Brian Stuard,20,180,176,4,2016,total_driving,T86
NA,89,Rory Sabbatini,20,182,118,64,2016,total_driving,89
NA,90,Nick Taylor,26,184,47,137,2016,total_driving,90
NA,T91,Zac Blair,31,185,180,5,2016,total_driving,T91
NA,T91,Padraig Harrington,16,185,97,88,2016,total_driving,T91
NA,T91,Colt Knost,26,185,184,1,2016,total_driving,T91
NA,T91,Kelly Kraft,20,185,93,92,2016,total_driving,T91
NA,T95,Robert Garrigus,21,186,18,168,2016,total_driving,T95
NA,T95,Charl Schwartzel,19,186,44,142,2016,total_driving,T95
NA,T97,Ángel Cabrera,22,187,63,124,2016,total_driving,T97
NA,T97,Luke List,27,187,7,180,2016,total_driving,T97
NA,T99,Matt Jones,27,188,56,132,2016,total_driving,T99
NA,T99,Brandt Snedeker,27,188,75,113,2016,total_driving,T99
NA,101,Andrew Loupe,27,189,5,184,2016,total_driving,101
NA,102,Scott Stallings,27,190,50,140,2016,total_driving,102
NA,T103,Harris English,27,191,29,162,2016,total_driving,T103
NA,T103,Charles Howell III,25,191,17,174,2016,total_driving,T103
NA,T103,Martin Laird,24,191,33,158,2016,total_driving,T103
NA,T103,Justin Thomas,28,191,24,167,2016,total_driving,T103
NA,T107,Chesson Hadley,27,192,45,147,2016,total_driving,T107
NA,T107,Patrick Reed,28,192,41,151,2016,total_driving,T107
NA,T107,John Senden,28,192,95,97,2016,total_driving,T107
NA,T107,Robert Streb,27,192,59,133,2016,total_driving,T107
NA,111,Jason Bohn,21,193,179,14,2016,total_driving,111
NA,T112,Morgan Hoffmann,25,195,66,129,2016,total_driving,T112
NA,T112,Hunter Mahan,22,195,56,139,2016,total_driving,T112
NA,T112,David Toms,19,195,184,11,2016,total_driving,T112
NA,T115,Jason Day,20,196,15,181,2016,total_driving,T115
NA,T115,Dicky Pride,21,196,173,23,2016,total_driving,T115
NA,T117,Steve Marino,24,197,79,118,2016,total_driving,T117
NA,T117,Webb Simpson,20,197,132,65,2016,total_driving,T117
NA,T119,Mark Hubbard,30,198,164,34,2016,total_driving,T119
NA,T119,Shawn Stefani,29,198,78,120,2016,total_driving,T119
NA,T121,Zach Johnson,24,199,167,32,2016,total_driving,T121
NA,T121,Kevin Na,26,199,170,29,2016,total_driving,T121
NA,T121,Vaughn Taylor,24,199,127,72,2016,total_driving,T121
NA,T124,K.J. Choi,22,200,180,20,2016,total_driving,T124
NA,T124,Charley Hoffman,26,200,36,164,2016,total_driving,T124
NA,T126,Smylie Kaufman,28,201,30,171,2016,total_driving,T126
NA,T126,Mark Wilson,21,201,182,19,2016,total_driving,T126
NA,T128,Billy Hurley III,20,204,176,28,2016,total_driving,T128
NA,T128,Chris Kirk,28,204,136,68,2016,total_driving,T128
NA,T128,Carlos Ortiz,29,204,31,173,2016,total_driving,T128
NA,131,Abraham Ancer,19,205,178,27,2016,total_driving,131
NA,132,Branden Grace,18,206,48,158,2016,total_driving,132
NA,T133,Bronson Burgoon,27,207,71,136,2016,total_driving,T133
NA,T133,Ken Duke,20,207,164,43,2016,total_driving,T133
NA,T133,Troy Merritt,26,207,126,81,2016,total_driving,T133
NA,T133,Jimmy Walker,25,207,24,183,2016,total_driving,T133
NA,137,Stuart Appleby,23,215,152,63,2016,total_driving,137
NA,T138,Ben Crane,27,216,162,54,2016,total_driving,T138
NA,T138,Rhein Gibson,20,216,40,176,2016,total_driving,T138
NA,140,Chris Stroud,27,218,132,86,2016,total_driving,140
NA,141,Phil Mickelson,22,219,56,163,2016,total_driving,141
NA,142,Jonas Blixt,26,220,90,130,2016,total_driving,142
NA,T143,Will MacKenzie,26,223,140,83,2016,total_driving,T143
NA,T143,Bryce Molder,26,223,164,59,2016,total_driving,T143
NA,145,Andres Gonzales,28,224,59,165,2016,total_driving,145
NA,T146,Jon Curran,30,225,183,42,2016,total_driving,T146
NA,T146,George McNeill,23,225,147,78,2016,total_driving,T146
NA,148,J.J. Henry,24,227,123,104,2016,total_driving,148
NA,T149,Steve Stricker,15,228,175,53,2016,total_driving,T149
NA,T149,Steve Wheatcroft,26,228,135,93,2016,total_driving,T149
NA,151,Daniel Summerhays,28,229,114,115,2016,total_driving,151
NA,152,Hiroshi Iwata,29,230,108,122,2016,total_driving,152
NA,153,Brendon de Jonge,30,231,122,109,2016,total_driving,153
NA,T154,Anirban Lahiri,21,232,82,150,2016,total_driving,T154
NA,T154,Dawie van der Walt,25,232,91,141,2016,total_driving,T154
NA,T154,Tim Wilkinson,22,232,171,61,2016,total_driving,T154
NA,157,Seung-Yul Noh,28,234,52,182,2016,total_driving,157
NA,158,Vijay Singh,22,236,93,143,2016,total_driving,158
NA,159,Aaron Baddeley,28,237,82,155,2016,total_driving,159
NA,160,Cameron Smith,24,240,132,108,2016,total_driving,160
NA,T161,Martin Piller,22,241,130,111,2016,total_driving,T161
NA,T161,Cameron Tringale,25,241,142,99,2016,total_driving,T161
NA,T163,Patton Kizzire,27,243,86,157,2016,total_driving,T163
NA,T163,D.H. Lee,22,243,161,82,2016,total_driving,T163
NA,165,Ernie Els,21,244,74,170,2016,total_driving,165
NA,166,Jeff Overton,25,249,143,106,2016,total_driving,166
NA,167,Tom Hoge,26,252,100,152,2016,total_driving,167
NA,168,D.A. Points,18,253,153,100,2016,total_driving,168
NA,169,Luke Guthrie,19,256,102,154,2016,total_driving,169
NA,170,Retief Goosen,16,257,108,149,2016,total_driving,170
NA,171,Peter Malnati,32,260,169,91,2016,total_driving,171
NA,172,Michael Kim,29,264,148,116,2016,total_driving,172
NA,173,Tyler Aldridge,28,267,141,126,2016,total_driving,173
NA,174,Freddie Jacobson,26,272,162,110,2016,total_driving,174
NA,175,Ricky Barnes,29,284,118,166,2016,total_driving,175
NA,176,Tyrone Van Aswegen,31,285,114,171,2016,total_driving,176
NA,177,Derek Fathauer,30,289,111,178,2016,total_driving,177
NA,T178,Steven Bowditch,26,292,107,185,2016,total_driving,T178
NA,T178,Brendon Todd,29,292,167,125,2016,total_driving,T178
NA,180,Luke Donald,23,295,151,144,2016,total_driving,180
NA,181,Camilo Villegas,27,304,127,177,2016,total_driving,181
NA,182,Chad Collins,26,305,171,134,2016,total_driving,182
NA,T183,Erik Compton,24,314,145,169,2016,total_driving,T183
NA,T183,Rob Oppenheim,21,314,158,156,2016,total_driving,T183
NA,185,Robert Allenby,23,315,154,161,2016,total_driving,185
NA,NA,Keegan Bradley,29,70,44,26,2017,total_driving,1
NA,NA,Kyle Stanley,29,76,63,13,2017,total_driving,2
NA,NA,Graham DeLaet,25,82,32,50,2017,total_driving,3
NA,NA,Lucas Glover,26,88,51,37,2017,total_driving,4
NA,NA,Rickie Fowler,21,98,39,59,2017,total_driving,T5
NA,NA,Rick Lamb,19,98,54,44,2017,total_driving,T5
NA,NA,Jim Herman,25,106,95,11,2017,total_driving,T7
NA,NA,Francesco Molinari,21,106,99,7,2017,total_driving,T7
NA,NA,Martin Laird,25,109,66,43,2017,total_driving,9
NA,NA,Brendan Steele,25,112,41,71,2017,total_driving,10
NA,NA,Kevin Streelman,26,113,84,29,2017,total_driving,11
NA,NA,Sergio Garcia,17,114,33,81,2017,total_driving,T12
NA,NA,Hudson Swafford,28,114,22,92,2017,total_driving,T12
NA,NA,Paul Casey,24,115,60,55,2017,total_driving,T14
NA,NA,Boo Weekley,27,115,113,2,2017,total_driving,T14
NA,NA,Shane Lowry,16,116,74,42,2017,total_driving,16
NA,NA,Russell Henley,27,120,56,64,2017,total_driving,17
NA,NA,Patrick Cantlay,13,126,47,79,2017,total_driving,18
NA,NA,Emiliano Grillo,25,129,91,38,2017,total_driving,T19
NA,NA,Gary Woodland,26,129,13,116,2017,total_driving,T19
NA,NA,Bubba Watson,22,130,21,109,2017,total_driving,21
NA,NA,Sam Saunders,24,133,88,45,2017,total_driving,22
NA,NA,Jason Kokrak,28,134,20,114,2017,total_driving,T23
NA,NA,Hunter Mahan,26,134,78,56,2017,total_driving,T23
NA,NA,Jason Dufner,24,136,78,58,2017,total_driving,T25
NA,NA,Jon Rahm,23,136,19,117,2017,total_driving,T25
NA,NA,Richy Werenski,26,136,106,30,2017,total_driving,T25
NA,NA,Harold Varner III,31,137,29,108,2017,total_driving,28
NA,NA,Tony Finau,29,143,9,134,2017,total_driving,T29
NA,NA,Xander Schauffele,28,143,15,128,2017,total_driving,T29
NA,NA,Rory Sabbatini,23,144,103,41,2017,total_driving,31
NA,NA,Billy Horschel,28,145,43,102,2017,total_driving,T32
NA,NA,Kevin Kisner,28,145,122,23,2017,total_driving,T32
NA,NA,J.J. Spaun,29,145,105,40,2017,total_driving,T32
NA,NA,Julián Etulain,22,146,89,57,2017,total_driving,T35
NA,NA,Robert Garrigus,26,146,36,110,2017,total_driving,T35
NA,NA,Dustin Johnson,20,146,2,144,2017,total_driving,T35
NA,NA,Ryan Moore,24,146,129,17,2017,total_driving,T35
NA,NA,James Hahn,28,147,86,61,2017,total_driving,39
NA,NA,Russell Knox,24,151,129,22,2017,total_driving,T40
NA,NA,Tag Ridings,20,151,30,121,2017,total_driving,T40
NA,NA,J.J. Henry,29,152,83,69,2017,total_driving,42
NA,NA,Kevin Chappell,27,154,24,130,2017,total_driving,T43
NA,NA,Ben Martin,27,154,102,52,2017,total_driving,T43
NA,NA,Hideki Matsuyama,22,157,27,130,2017,total_driving,T45
NA,NA,Sean O'Hair,25,157,58,99,2017,total_driving,T45
NA,NA,Chez Reavie,28,157,152,5,2017,total_driving,T45
NA,NA,William McGirt,28,158,152,6,2017,total_driving,T48
NA,NA,Justin Rose,18,158,40,118,2017,total_driving,T48
NA,NA,Daniel Berger,26,159,63,96,2017,total_driving,T50
NA,NA,Luke List,31,159,4,155,2017,total_driving,T50
NA,NA,Rory McIlroy,14,159,1,158,2017,total_driving,T50
NA,NA,Grayson Murray,30,160,12,148,2017,total_driving,53
NA,NA,Anirban Lahiri,22,161,60,101,2017,total_driving,54
NA,NA,Matt Jones,20,164,28,136,2017,total_driving,T55
NA,NA,Ryan Palmer,20,164,26,138,2017,total_driving,T55
NA,NA,Zach Johnson,23,165,140,25,2017,total_driving,57
NA,NA,Jamie Lovemark,28,166,25,141,2017,total_driving,58
NA,NA,Chad Campbell,29,167,147,20,2017,total_driving,T59
NA,NA,Bud Cauley,28,167,67,100,2017,total_driving,T59
NA,NA,Adam Scott,16,167,18,149,2017,total_driving,T59
NA,NA,Scott Brown,29,168,119,49,2017,total_driving,T62
NA,NA,Brett Stegmaier,27,168,122,46,2017,total_driving,T62
NA,NA,Bryson DeChambeau,31,170,46,124,2017,total_driving,T64
NA,NA,Louis Oosthuizen,18,170,73,97,2017,total_driving,T64
NA,NA,Jhonattan Vegas,29,170,35,135,2017,total_driving,T64
NA,NA,Sung Kang,32,171,65,106,2017,total_driving,T67
NA,NA,Shawn Stefani,26,171,84,87,2017,total_driving,T67
NA,NA,Chris Stroud,22,172,140,32,2017,total_driving,69
NA,NA,Adam Hadwin,28,173,110,63,2017,total_driving,T70
NA,NA,Danny Lee,32,173,108,65,2017,total_driving,T70
NA,NA,Brooks Koepka,24,174,6,168,2017,total_driving,72
NA,NA,Vaughn Taylor,26,175,161,14,2017,total_driving,73
NA,NA,Morgan Hoffmann,29,176,86,90,2017,total_driving,74
NA,NA,Ryan Armour,20,177,176,1,2017,total_driving,T75
NA,NA,Charley Hoffman,31,177,50,127,2017,total_driving,T75
NA,NA,Justin Thomas,25,177,8,169,2017,total_driving,T75
NA,NA,Webb Simpson,28,179,145,34,2017,total_driving,78
NA,NA,Byeong Hun An,22,180,41,139,2017,total_driving,T79
NA,NA,Marc Leishman,25,180,51,129,2017,total_driving,T79
NA,NA,Nick Taylor,29,180,103,77,2017,total_driving,T79
NA,NA,Miguel Angel Carballo,22,181,127,54,2017,total_driving,82
NA,NA,John Huh,28,182,135,47,2017,total_driving,T83
NA,NA,Smylie Kaufman,26,182,23,159,2017,total_driving,T83
NA,NA,Brandon Hagy,26,183,3,180,2017,total_driving,85
NA,NA,Blayne Barber,25,184,106,78,2017,total_driving,T86
NA,NA,Matt Kuchar,26,184,148,36,2017,total_driving,T86
NA,NA,Graeme McDowell,17,184,174,10,2017,total_driving,T86
NA,NA,Trey Mullinax,28,184,11,173,2017,total_driving,T86
NA,NA,Steve Wheatcroft,17,184,169,15,2017,total_driving,T86
NA,NA,Alex Cejka,28,185,164,21,2017,total_driving,T91
NA,NA,Jason Day,20,185,15,170,2017,total_driving,T91
NA,NA,C.T. Pan,29,185,135,50,2017,total_driving,T91
NA,NA,Kyle Reifers,32,185,146,39,2017,total_driving,T91
NA,NA,Brian Campbell,20,186,67,119,2017,total_driving,T95
NA,NA,Chris Kirk,28,186,138,48,2017,total_driving,T95
NA,NA,David Lingmerth,23,186,114,72,2017,total_driving,T95
NA,NA,Scott Piercy,22,186,74,112,2017,total_driving,T95
NA,NA,Jordan Spieth,23,187,76,111,2017,total_driving,T99
NA,NA,Johnson Wagner,26,187,127,60,2017,total_driving,T99
NA,NA,Nick Watney,23,187,33,154,2017,total_driving,T99
NA,NA,Mackenzie Hughes,31,188,81,107,2017,total_driving,T102
NA,NA,Cameron Percy,23,188,95,93,2017,total_driving,T102
NA,NA,Kevin Tway,27,188,9,179,2017,total_driving,T102
NA,NA,K.J. Choi,25,189,163,26,2017,total_driving,T105
NA,NA,Brian Harman,30,189,116,73,2017,total_driving,T105
NA,NA,David Hearn,29,190,166,24,2017,total_driving,107
NA,NA,Ryan Brehm,25,191,6,185,2017,total_driving,T108
NA,NA,Pat Perez,26,191,111,80,2017,total_driving,T108
NA,NA,Patrick Rodgers,27,191,15,176,2017,total_driving,T108
NA,NA,Spencer Levin,31,192,174,18,2017,total_driving,T111
NA,NA,J.T. Poston,28,192,77,115,2017,total_driving,T111
NA,NA,Brian Stuard,31,192,189,3,2017,total_driving,T111
NA,NA,Scott Stallings,27,193,56,137,2017,total_driving,114
NA,NA,Ben Crane,26,194,178,16,2017,total_driving,T115
NA,NA,Jim Furyk,18,194,190,4,2017,total_driving,T115
NA,NA,Kelly Kraft,27,194,99,95,2017,total_driving,T115
NA,NA,Andrew Loupe,21,194,5,189,2017,total_driving,T115
NA,NA,Zac Blair,32,196,188,8,2017,total_driving,T119
NA,NA,Søren Kjeldsen,17,196,187,9,2017,total_driving,T119
NA,NA,Roberto Castro,25,198,170,28,2017,total_driving,T121
NA,NA,Ken Duke,26,198,186,12,2017,total_driving,T121
NA,NA,Andres Gonzales,24,198,45,153,2017,total_driving,T121
NA,NA,Troy Merritt,28,198,114,84,2017,total_driving,T121
NA,NA,Rafa Cabrera Bello,19,200,109,91,2017,total_driving,T125
NA,NA,Jonathan Randolph,22,200,133,67,2017,total_driving,T125
NA,NA,J.B. Holmes,23,201,14,187,2017,total_driving,127
NA,NA,Steven Alker,23,202,183,19,2017,total_driving,128
NA,NA,Daniel Summerhays,29,205,139,66,2017,total_driving,129
NA,NA,Tim Wilkinson,22,206,173,33,2017,total_driving,130
NA,NA,Geoff Ogilvy,25,210,142,68,2017,total_driving,131
NA,NA,D.A. Points,22,211,180,31,2017,total_driving,132
NA,NA,Brian Gay,25,212,177,35,2017,total_driving,133
NA,NA,Jonas Blixt,25,214,120,94,2017,total_driving,T134
NA,NA,Rod Pampling,22,214,131,83,2017,total_driving,T134
NA,NA,Patrick Reed,29,214,72,142,2017,total_driving,T134
NA,NA,Robert Streb,30,214,81,133,2017,total_driving,T134
NA,NA,Martin Flores,27,215,38,177,2017,total_driving,138
NA,NA,Harris English,27,217,31,186,2017,total_driving,139
NA,NA,Cody Gribble,28,218,58,160,2017,total_driving,140
NA,NA,Dominic Bozzelli,24,220,80,140,2017,total_driving,T141
NA,NA,Bill Haas,25,220,97,123,2017,total_driving,T141
NA,NA,Ollie Schniederjans,28,220,36,184,2017,total_driving,T141
NA,NA,Charl Schwartzel,18,220,49,171,2017,total_driving,T141
NA,NA,Michael Kim,28,221,116,105,2017,total_driving,145
NA,NA,Jimmy Walker,21,222,71,151,2017,total_driving,146
NA,NA,Fabián Gómez,21,223,148,75,2017,total_driving,T147
NA,NA,Charles Howell III,23,223,62,161,2017,total_driving,T147
NA,NA,Seung-Yul Noh,31,223,48,175,2017,total_driving,T147
NA,NA,Seamus Power,25,223,51,172,2017,total_driving,T147
NA,NA,Peter Malnati,29,224,162,62,2017,total_driving,151
NA,NA,Retief Goosen,19,227,101,126,2017,total_driving,152
NA,NA,Michael Thompson,21,228,152,76,2017,total_driving,153
NA,NA,Brett Drewitt,19,229,144,85,2017,total_driving,T154
NA,NA,Ian Poulter,20,229,159,70,2017,total_driving,T154
NA,NA,Sebastián Muñoz,17,230,67,163,2017,total_driving,156
NA,NA,Branden Grace,20,231,111,120,2017,total_driving,157
NA,NA,Ryan Blaum,29,237,155,82,2017,total_driving,T158
NA,NA,Jason Bohn,28,237,185,52,2017,total_driving,T158
NA,NA,Stewart Cink,26,237,70,167,2017,total_driving,T158
NA,NA,Tyrone Van Aswegen,32,237,133,104,2017,total_driving,T158
NA,NA,Cameron Smith,26,239,93,146,2017,total_driving,162
NA,NA,Brandt Snedeker,15,242,168,74,2017,total_driving,163
NA,NA,Matt Every,30,243,55,188,2017,total_driving,164
NA,NA,Kevin Na,26,245,157,88,2017,total_driving,165
NA,NA,Phil Mickelson,22,246,89,157,2017,total_driving,166
NA,NA,Mark Hubbard,27,249,160,89,2017,total_driving,167
NA,NA,Mark Anderson,20,254,156,98,2017,total_driving,168
NA,NA,Billy Hurley III,25,269,183,86,2017,total_driving,T169
NA,NA,Patton Kizzire,28,269,91,178,2017,total_driving,T169
NA,NA,Gonzalo Fernandez-Castaño,22,271,98,173,2017,total_driving,T171
NA,NA,Brad Fritsch,18,271,126,145,2017,total_driving,T171
NA,NA,Aaron Baddeley,20,274,93,181,2017,total_driving,173
NA,NA,Si Woo Kim,30,277,125,152,2017,total_driving,174
NA,NA,Chad Collins,26,278,165,113,2017,total_driving,175
NA,NA,Nicholas Lindheim,21,282,135,147,2017,total_driving,176
NA,NA,Greg Chalmers,28,283,181,102,2017,total_driving,T177
NA,NA,Whee Kim,27,283,118,165,2017,total_driving,T177
NA,NA,Camilo Villegas,25,286,122,164,2017,total_driving,179
NA,NA,Cameron Tringale,28,289,167,122,2017,total_driving,180
NA,NA,Wesley Bryan,28,297,172,125,2017,total_driving,T181
NA,NA,Tom Hoge,17,297,148,149,2017,total_driving,T181
NA,NA,Derek Fathauer,27,298,142,156,2017,total_driving,183
NA,NA,Ryo Ishikawa,20,303,120,183,2017,total_driving,184
NA,NA,Bryce Molder,26,314,182,132,2017,total_driving,185
NA,NA,Ricky Barnes,31,316,151,165,2017,total_driving,186
NA,NA,Ernie Els,20,319,157,162,2017,total_driving,187
NA,NA,Luke Donald,18,321,178,143,2017,total_driving,188
NA,NA,Steven Bowditch,27,322,132,190,2017,total_driving,189
NA,NA,Carl Pettersson,27,352,170,182,2017,total_driving,190
NA,1,Justin Rose,18,67,34,33,2018,total_driving,1
NA,2,Tommy Fleetwood,19,72,23,49,2018,total_driving,2
NA,3,Gary Woodland,27,73,7,66,2018,total_driving,3
NA,4,Keegan Bradley,27,80,65,15,2018,total_driving,4
NA,T5,Francesco Molinari,20,98,52,46,2018,total_driving,T5
NA,T5,Hudson Swafford,22,98,41,57,2018,total_driving,T5
NA,7,Bronson Burgoon,24,99,41,58,2018,total_driving,7
NA,8,Rickie Fowler,20,101,61,40,2018,total_driving,8
NA,9,Kyle Stanley,26,105,98,7,2018,total_driving,9
NA,T10,Paul Casey,20,109,31,78,2018,total_driving,T10
NA,T10,Sam Ryder,26,109,87,22,2018,total_driving,T10
NA,12,Louis Oosthuizen,17,112,61,51,2018,total_driving,12
NA,13,Aaron Wise,29,113,40,73,2018,total_driving,13
NA,T14,Emiliano Grillo,25,114,106,8,2018,total_driving,T14
NA,T14,J.J. Spaun,27,114,82,32,2018,total_driving,T14
NA,16,Corey Conners,28,115,36,79,2018,total_driving,16
NA,T17,Bryson DeChambeau,26,117,25,92,2018,total_driving,T17
NA,T17,Billy Horschel,27,117,100,17,2018,total_driving,T17
NA,T17,Adam Scott,21,117,29,88,2018,total_driving,T17
NA,T17,Xinjun Zhang,28,117,77,40,2018,total_driving,T17
NA,21,Kevin Chappell,23,118,17,101,2018,total_driving,21
NA,22,Kevin Streelman,27,119,107,12,2018,total_driving,22
NA,23,Brendan Steele,22,121,12,109,2018,total_driving,23
NA,24,Rafa Cabrera Bello,20,123,107,16,2018,total_driving,24
NA,25,Joel Dahmen,28,126,97,29,2018,total_driving,25
NA,26,Scott Piercy,26,128,92,36,2018,total_driving,26
NA,27,Lucas Glover,18,129,85,44,2018,total_driving,27
NA,28,Dustin Johnson,20,131,6,125,2018,total_driving,28
NA,29,Hideki Matsuyama,21,132,49,83,2018,total_driving,29
NA,30,Russell Henley,23,134,125,9,2018,total_driving,30
NA,31,Byeong Hun An,24,135,19,116,2018,total_driving,31
NA,T32,Patrick Cantlay,23,136,38,98,2018,total_driving,T32
NA,T32,Hunter Mahan,21,136,90,46,2018,total_driving,T32
NA,T34,Tyler Duncan,31,137,112,25,2018,total_driving,T34
NA,T34,Patrick Rodgers,30,137,34,103,2018,total_driving,T34
NA,36,C.T. Pan,30,139,126,13,2018,total_driving,36
NA,37,Henrik Stenson,16,140,139,1,2018,total_driving,37
NA,T38,Daniel Berger,23,141,85,56,2018,total_driving,T38
NA,T38,Charles Howell III,28,141,54,87,2018,total_driving,T38
NA,40,James Hahn,26,142,77,65,2018,total_driving,40
NA,T41,Branden Grace,18,145,74,71,2018,total_driving,T41
NA,T41,Keith Mitchell,29,145,10,135,2018,total_driving,T41
NA,T41,Jon Rahm,20,145,16,129,2018,total_driving,T41
NA,44,Ian Poulter,20,146,118,28,2018,total_driving,44
NA,T45,Martin Laird,22,147,71,76,2018,total_driving,T45
NA,T45,Michael Thompson,19,147,93,54,2018,total_driving,T45
NA,T47,Justin Thomas,23,149,11,138,2018,total_driving,T47
NA,T47,Harold Varner III,27,149,18,131,2018,total_driving,T47
NA,49,Brice Garnett,30,150,91,59,2018,total_driving,49
NA,50,Bubba Watson,24,151,9,142,2018,total_driving,50
NA,T51,Kiradech Aphibarnrat,14,152,110,42,2018,total_driving,T51
NA,T51,Xander Schauffele,27,152,28,124,2018,total_driving,T51
NA,T53,Austin Cook,29,154,130,24,2018,total_driving,T53
NA,T53,Brian Harman,25,154,133,21,2018,total_driving,T53
NA,T55,Jason Day,20,155,14,141,2018,total_driving,T55
NA,T55,Russell Knox,27,155,137,18,2018,total_driving,T55
NA,T55,J.T. Poston,22,155,55,100,2018,total_driving,T55
NA,58,Matt Jones,23,156,30,126,2018,total_driving,58
NA,T59,Satoshi Kodaira,18,157,118,39,2018,total_driving,T59
NA,T59,Shane Lowry,19,157,55,102,2018,total_driving,T59
NA,T59,Ryan Palmer,22,157,27,130,2018,total_driving,T59
NA,62,Jason Kokrak,29,158,15,143,2018,total_driving,62
NA,T63,Sam Saunders,26,159,41,118,2018,total_driving,T63
NA,T63,Tiger Woods,18,159,32,127,2018,total_driving,T63
NA,65,Jordan Spieth,23,160,61,99,2018,total_driving,65
NA,66,Jason Dufner,22,162,88,74,2018,total_driving,66
NA,T67,Blayne Barber,22,163,110,53,2018,total_driving,T67
NA,T67,Brooks Koepka,17,163,8,155,2018,total_driving,T67
NA,T67,Sean O'Hair,22,163,44,119,2018,total_driving,T67
NA,70,Rory McIlroy,18,164,1,163,2018,total_driving,70
NA,71,Abraham Ancer,30,165,96,69,2018,total_driving,71
NA,T72,J.J. Henry,28,166,135,31,2018,total_driving,T72
NA,T72,Alex Noren,18,166,69,97,2018,total_driving,T72
NA,T74,Beau Hossler,28,167,58,109,2018,total_driving,T74
NA,T74,Ryan Moore,22,167,163,4,2018,total_driving,T74
NA,T74,Cameron Percy,16,167,99,68,2018,total_driving,T74
NA,T77,Graeme McDowell,20,171,121,50,2018,total_driving,T77
NA,T77,Adam Schenk,28,171,26,145,2018,total_driving,T77
NA,T79,Tyrrell Hatton,16,172,76,96,2018,total_driving,T79
NA,T79,Denny McCarthy,22,172,100,72,2018,total_driving,T79
NA,81,J.B. Holmes,24,174,24,150,2018,total_driving,81
NA,T82,Kevin Kisner,25,176,146,30,2018,total_driving,T82
NA,T82,Chez Reavie,28,176,173,3,2018,total_driving,T82
NA,T82,Conrad Shindler,20,176,141,35,2018,total_driving,T82
NA,T82,Jhonattan Vegas,27,176,32,144,2018,total_driving,T82
NA,T86,Trey Mullinax,24,177,2,175,2018,total_driving,T86
NA,T86,Steve Wheatcroft,20,177,166,11,2018,total_driving,T86
NA,T88,Tony Finau,28,178,4,174,2018,total_driving,T88
NA,T88,Robert Garrigus,27,178,19,159,2018,total_driving,T88
NA,T90,Harris English,31,179,47,132,2018,total_driving,T90
NA,T90,Chesson Hadley,30,179,58,121,2018,total_driving,T90
NA,T90,Richy Werenski,32,179,135,44,2018,total_driving,T90
NA,T93,Troy Merritt,27,181,100,81,2018,total_driving,T93
NA,T93,Nick Watney,26,181,21,160,2018,total_driving,T93
NA,95,Tom Lovelady,28,183,3,180,2018,total_driving,95
NA,96,Grayson Murray,22,184,22,162,2018,total_driving,96
NA,97,Ethan Tracy,23,186,71,115,2018,total_driving,97
NA,T98,Ryan Armour,32,187,185,2,2018,total_driving,T98
NA,T98,Luke List,29,187,5,182,2018,total_driving,T98
NA,T98,Pat Perez,23,187,144,43,2018,total_driving,T98
NA,T101,Fabián Gómez,28,190,142,48,2018,total_driving,T101
NA,T101,Jamie Lovemark,26,190,37,153,2018,total_driving,T101
NA,T101,Ben Silverman,28,190,152,38,2018,total_driving,T101
NA,104,Brian Gay,30,192,186,6,2018,total_driving,104
NA,105,David Lingmerth,26,194,180,14,2018,total_driving,105
NA,T106,Adam Hadwin,25,196,159,37,2018,total_driving,T106
NA,T106,Vaughn Taylor,25,196,176,20,2018,total_driving,T106
NA,T108,Matt Atkins,21,197,50,147,2018,total_driving,T108
NA,T108,Marc Leishman,25,197,80,117,2018,total_driving,T108
NA,110,Brian Stuard,32,198,193,5,2018,total_driving,110
NA,111,Alex Cejka,24,199,172,27,2018,total_driving,111
NA,112,Jim Furyk,15,200,190,10,2018,total_driving,112
NA,T113,Kelly Kraft,31,201,167,34,2018,total_driving,T113
NA,T113,"Ted Potter, Jr.",28,201,178,23,2018,total_driving,T113
NA,T115,Stephan Jaeger,26,203,69,134,2018,total_driving,T115
NA,T115,Kevin Tway,31,203,13,190,2018,total_driving,T115
NA,T117,Bud Cauley,17,206,100,106,2018,total_driving,T117
NA,T117,Brandt Snedeker,25,206,122,84,2018,total_driving,T117
NA,T119,Ben Crane,21,207,188,19,2018,total_driving,T119
NA,T119,Charley Hoffman,25,207,67,140,2018,total_driving,T119
NA,T119,Webb Simpson,26,207,117,90,2018,total_driving,T119
NA,T122,David Hearn,21,209,183,26,2018,total_driving,T122
NA,T122,Chris Kirk,29,209,154,55,2018,total_driving,T122
NA,124,Lanto Griffin,26,215,46,169,2018,total_driving,124
NA,T125,Brandon Harkins,30,216,38,178,2018,total_driving,T125
NA,T125,Seamus Power,28,216,45,171,2018,total_driving,T125
NA,127,Zach Johnson,25,217,154,63,2018,total_driving,127
NA,T128,Cody Gribble,25,219,52,167,2018,total_driving,T128
NA,T128,Kevin Na,26,219,157,62,2018,total_driving,T128
NA,130,Scott Stallings,30,221,64,157,2018,total_driving,130
NA,131,Talor Gooch,27,222,74,148,2018,total_driving,131
NA,T132,Scott Brown,32,223,128,95,2018,total_driving,T132
NA,T132,Nate Lashley,17,223,115,108,2018,total_driving,T132
NA,T132,Shawn Stefani,25,223,65,158,2018,total_driving,T132
NA,T135,Andrew Landry,27,224,142,82,2018,total_driving,T135
NA,T135,Rory Sabbatini,27,224,130,94,2018,total_driving,T135
NA,T137,Ryan Blaum,28,225,165,60,2018,total_driving,T137
NA,T137,Chad Campbell,28,225,173,52,2018,total_driving,T137
NA,139,Ben Martin,20,227,157,70,2018,total_driving,139
NA,T140,Stewart Cink,25,229,83,146,2018,total_driving,T140
NA,T140,Tom Hoge,31,229,140,89,2018,total_driving,T140
NA,T140,Andrew Putnam,28,229,116,113,2018,total_driving,T140
NA,T143,Mackenzie Hughes,28,231,109,122,2018,total_driving,T143
NA,T143,Nick Taylor,30,231,126,105,2018,total_driving,T143
NA,T145,Nicholas Lindheim,26,232,120,112,2018,total_driving,T145
NA,T145,Cameron Smith,24,232,81,151,2018,total_driving,T145
NA,147,Anirban Lahiri,24,233,114,119,2018,total_driving,147
NA,T148,Martin Flores,29,234,58,176,2018,total_driving,T148
NA,T148,John Huh,29,234,170,64,2018,total_driving,T148
NA,T148,Danny Lee,30,234,148,86,2018,total_driving,T148
NA,T148,Rod Pampling,20,234,168,66,2018,total_driving,T148
NA,T152,Jonas Blixt,23,236,122,114,2018,total_driving,T152
NA,T152,Peter Uihlein,26,236,48,188,2018,total_driving,T152
NA,154,Johnson Wagner,21,237,176,61,2018,total_driving,154
NA,155,Charl Schwartzel,20,238,67,171,2018,total_driving,155
NA,156,Brett Stegmaier,21,239,100,139,2018,total_driving,156
NA,157,Ollie Schniederjans,27,241,50,191,2018,total_driving,157
NA,158,Patton Kizzire,29,242,77,165,2018,total_driving,158
NA,159,Bill Haas,25,243,94,149,2018,total_driving,159
NA,160,Matt Kuchar,24,244,169,75,2018,total_driving,160
NA,161,Chris Stroud,27,245,154,91,2018,total_driving,161
NA,162,Phil Mickelson,24,246,57,189,2018,total_driving,162
NA,T163,Roberto Díaz,25,252,175,77,2018,total_driving,T163
NA,T163,Jonathan Randolph,25,252,159,93,2018,total_driving,T163
NA,T165,Dominic Bozzelli,20,253,89,164,2018,total_driving,T165
NA,T165,Si Woo Kim,31,253,146,107,2018,total_driving,T165
NA,T167,Patrick Reed,26,256,83,173,2018,total_driving,T167
NA,T167,Jimmy Walker,23,256,71,185,2018,total_driving,T167
NA,169,Kyle Thompson,22,260,181,79,2018,total_driving,169
NA,170,Retief Goosen,20,264,94,170,2018,total_driving,170
NA,171,Martin Piller,28,269,132,137,2018,total_driving,171
NA,172,Jonathan Byrd,24,272,137,135,2018,total_driving,172
NA,173,Zac Blair,20,277,192,85,2018,total_driving,173
NA,174,Sung Kang,29,278,122,156,2018,total_driving,174
NA,175,Matt Every,30,279,113,166,2018,total_driving,175
NA,176,Whee Kim,30,283,179,104,2018,total_driving,176
NA,177,William McGirt,26,284,161,123,2018,total_driving,177
NA,178,Aaron Baddeley,27,291,105,186,2018,total_driving,178
NA,T179,Peter Malnati,28,298,144,154,2018,total_driving,T179
NA,T179,D.A. Points,25,298,189,109,2018,total_driving,T179
NA,181,Tyrone Van Aswegen,31,303,151,152,2018,total_driving,181
NA,182,Robert Streb,29,311,128,183,2018,total_driving,182
NA,T183,Zecheng Dou,23,312,133,179,2018,total_driving,T183
NA,T183,Billy Hurley III,27,312,184,128,2018,total_driving,T183
NA,185,Greg Chalmers,20,320,187,133,2018,total_driving,185
NA,186,Michael Kim,27,330,153,177,2018,total_driving,186
NA,187,Andrew Yun,22,332,148,184,2018,total_driving,187
NA,188,Ricky Barnes,22,341,148,193,2018,total_driving,188
NA,189,Rob Oppenheim,26,343,182,161,2018,total_driving,189
NA,190,Derek Fathauer,28,350,164,186,2018,total_driving,190
NA,191,Daniel Summerhays,19,351,170,181,2018,total_driving,191
NA,192,Cameron Tringale,26,353,161,192,2018,total_driving,192
NA,193,Wesley Bryan,23,359,191,168,2018,total_driving,193
NA,1,Brendan Steele,15,64,24,40,2019,total_driving,1
NA,4,Paul Casey,14,75,62,13,2019,total_driving,2
NA,2,Gary Woodland,16,77,8,69,2019,total_driving,3
NA,3,Bryson DeChambeau,11,79,42,37,2019,total_driving,4
NA,6,Louis Oosthuizen,11,84,49,35,2019,total_driving,5
NA,5,Justin Harding,9,99,93,6,2019,total_driving,6
NA,T9,Daniel Berger,12,103,69,34,2019,total_driving,7
NA,12,Keegan Bradley,16,104,58,46,2019,total_driving,T8
NA,11,Emiliano Grillo,15,104,65,39,2019,total_driving,T8
NA,T7,Abraham Ancer,18,111,89,22,2019,total_driving,10
NA,T9,Brooks Koepka,12,112,14,98,2019,total_driving,11
NA,T7,Jon Rahm,13,114,19,95,2019,total_driving,12
NA,15,Jason Kokrak,16,117,26,91,2019,total_driving,13
NA,T13,Charles Howell III,18,122,43,79,2019,total_driving,14
NA,16,Matt Kuchar,14,124,116,8,2019,total_driving,15
NA,22,Corey Conners,17,129,85,44,2019,total_driving,16
NA,T20,Joel Dahmen,20,132,112,20,2019,total_driving,T17
NA,T17,Troy Merritt,11,132,89,43,2019,total_driving,T17
NA,27,Hideki Matsuyama,14,134,23,111,2019,total_driving,T19
NA,19,Aaron Wise,14,134,30,104,2019,total_driving,T19
NA,T17,Tommy Fleetwood,11,136,47,89,2019,total_driving,21
NA,T25,Alex Prugh,17,138,41,97,2019,total_driving,22
NA,T23,Rickie Fowler,12,139,25,114,2019,total_driving,23
NA,28,Carlos Ortiz,18,140,55,85,2019,total_driving,24
NA,T20,Ian Poulter,12,141,109,32,2019,total_driving,25
NA,T13,Tiger Woods,7,142,56,86,2019,total_driving,26
NA,T30,Lucas Glover,16,146,78,68,2019,total_driving,27
NA,T23,Jason Day,13,147,26,121,2019,total_driving,28
NA,29,Kevin Streelman,18,148,124,24,2019,total_driving,T29
NA,T40,Bubba Watson,12,148,7,141,2019,total_driving,T29
NA,999,Thorbjørn Olesen,8,149,67,82,2019,total_driving,31
NA,T50,Tyrrell Hatton,11,150,56,94,2019,total_driving,32
NA,T30,Sungjae Im,23,154,93,61,2019,total_driving,33
NA,T43,Scott Piercy,17,155,138,17,2019,total_driving,34
NA,32,Lucas Bjerregaard,9,157,6,151,2019,total_driving,T35
NA,T25,Henrik Stenson,10,157,141,16,2019,total_driving,T35
NA,37,Justin Thomas,11,158,38,120,2019,total_driving,T37
NA,39,D.J. Trahan,10,158,51,107,2019,total_driving,T37
NA,36,Chase Wright,18,158,76,82,2019,total_driving,T37
NA,T40,Hank Lebioda,15,164,111,53,2019,total_driving,40
NA,T40,Kramer Hickok,17,165,151,14,2019,total_driving,T41
NA,33,Rory McIlroy,11,165,2,163,2019,total_driving,T41
NA,45,Chez Reavie,18,165,163,2,2019,total_driving,T41
NA,T34,Alex Noren,12,167,50,117,2019,total_driving,44
NA,63,Francesco Molinari,9,168,123,45,2019,total_driving,45
NA,T48,Hunter Mahan,15,169,102,67,2019,total_driving,T46
NA,T43,Harold Varner III,18,169,35,134,2019,total_driving,T46
NA,T50,Jim Herman,15,170,144,26,2019,total_driving,T48
NA,T54,Seth Reeves,17,170,11,159,2019,total_driving,T48
NA,T48,Matt Every,9,172,112,60,2019,total_driving,T50
NA,T34,Adam Hadwin,16,172,121,51,2019,total_driving,T50
NA,T58,Keith Mitchell,18,172,40,132,2019,total_driving,T50
NA,57,Byeong Hun An,13,174,14,160,2019,total_driving,T53
NA,52,Austin Cook,14,174,151,23,2019,total_driving,T53
NA,T61,Xander Schauffele,13,174,28,146,2019,total_driving,T53
NA,T54,Roger Sloan,18,174,81,93,2019,total_driving,T53
NA,53,James Hahn,10,175,128,47,2019,total_driving,57
NA,T58,Harris English,20,177,51,126,2019,total_driving,T58
NA,T54,Wes Roach,13,177,129,48,2019,total_driving,T58
NA,64,Webb Simpson,13,178,159,19,2019,total_driving,60
NA,46,Tony Finau,15,179,4,175,2019,total_driving,T61
NA,70,Sung Kang,19,179,63,116,2019,total_driving,T61
NA,T58,Matt Jones,17,181,81,100,2019,total_driving,63
NA,T61,Sam Ryder,15,182,86,96,2019,total_driving,64
NA,65,Tyler Duncan,21,183,171,12,2019,total_driving,T65
NA,T66,Sepp Straka,15,183,39,144,2019,total_driving,T65
NA,T66,Fabián Gómez,13,184,149,35,2019,total_driving,67
NA,T74,Bronson Burgoon,12,185,116,69,2019,total_driving,68
NA,47,Kiradech Aphibarnrat,13,186,99,87,2019,total_driving,T69
NA,T92,Patrick Cantlay,13,186,12,174,2019,total_driving,T69
NA,T68,Russell Henley,17,186,166,20,2019,total_driving,T69
NA,T68,Andrew Landry,16,186,176,10,2019,total_driving,T69
NA,38,Adam Scott,11,187,45,142,2019,total_driving,T73
NA,T71,Kyle Stanley,17,187,133,54,2019,total_driving,T73
NA,T74,Ryan Palmer,14,188,73,115,2019,total_driving,T75
NA,T71,Jhonattan Vegas,16,188,19,169,2019,total_driving,T75
NA,T81,Russell Knox,16,189,125,64,2019,total_driving,T77
NA,T89,Adam Long,17,189,108,81,2019,total_driving,T77
NA,T76,Brice Garnett,18,190,181,9,2019,total_driving,T79
NA,T76,Kevin Kisner,15,190,161,29,2019,total_driving,T79
NA,T76,Sebastián Muñoz,17,191,64,127,2019,total_driving,T81
NA,T85,Justin Rose,9,191,21,170,2019,total_driving,T81
NA,T79,Adam Schenk,21,191,61,130,2019,total_driving,T81
NA,T79,Joaquin Niemann,17,193,48,145,2019,total_driving,84
NA,T85,Bud Cauley,16,194,106,88,2019,total_driving,T85
NA,T81,Cameron Davis,17,194,16,178,2019,total_driving,T85
NA,T71,Sergio Garcia,10,195,37,158,2019,total_driving,T87
NA,88,Ryan Moore,15,195,190,5,2019,total_driving,T87
NA,T81,Michael Thompson,15,196,178,18,2019,total_driving,89
NA,T81,Davis Love III,9,197,147,50,2019,total_driving,90
NA,T95,Sam Burns,20,198,22,176,2019,total_driving,T91
NA,T89,Cameron Champ,17,198,1,197,2019,total_driving,T91
NA,98,Ben Silverman,15,199,184,15,2019,total_driving,T93
NA,T92,Josh Teater,15,199,134,65,2019,total_driving,T93
NA,T99,Matthew Fitzpatrick,9,200,158,42,2019,total_driving,T95
NA,T85,Kevin Na,14,200,125,75,2019,total_driving,T95
NA,T115,Dustin Johnson,11,202,12,190,2019,total_driving,T97
NA,T92,Nick Watney,17,202,59,143,2019,total_driving,T97
NA,101,Rory Sabbatini,17,203,129,74,2019,total_driving,99
NA,T95,Luke List,15,204,2,202,2019,total_driving,T100
NA,T99,Denny McCarthy,18,204,132,72,2019,total_driving,T100
NA,106,Beau Hossler,18,205,80,125,2019,total_driving,102
NA,T103,Ryan Armour,18,206,202,4,2019,total_driving,T103
NA,102,Wyndham Clark,18,206,5,201,2019,total_driving,T103
NA,T107,J.J. Spaun,18,206,129,77,2019,total_driving,T103
NA,91,Chesson Hadley,18,207,69,138,2019,total_driving,T106
NA,T107,David Hearn,13,207,200,7,2019,total_driving,T106
NA,T95,Rafa Cabrera Bello,14,208,137,71,2019,total_driving,T108
NA,T109,Nate Lashley,11,208,180,28,2019,total_driving,T108
NA,T109,Jim Furyk,13,209,208,1,2019,total_driving,110
NA,T109,Dylan Frittelli,15,212,84,128,2019,total_driving,T111
NA,105,Haotong Li,8,212,33,179,2019,total_driving,T111
NA,113,Brian Gay,19,213,210,3,2019,total_driving,T113
NA,112,Kyoung-Hoon Lee,20,213,172,41,2019,total_driving,T113
NA,T103,Kevin Tway,17,214,32,182,2019,total_driving,115
NA,T115,Martin Laird,16,216,93,123,2019,total_driving,116
NA,118,Grayson Murray,14,218,9,209,2019,total_driving,T117
NA,T119,Brian Stuard,20,218,207,11,2019,total_driving,T117
NA,121,Vaughn Taylor,19,219,194,25,2019,total_driving,119
NA,T124,Satoshi Kodaira,16,220,189,31,2019,total_driving,T120
NA,T131,Brady Schnell,13,220,193,27,2019,total_driving,T120
NA,T119,Sangmoon Bae,15,221,103,118,2019,total_driving,T122
NA,T124,Dominic Bozzelli,15,221,109,112,2019,total_driving,T122
NA,T124,Ollie Schniederjans,20,221,10,211,2019,total_driving,T122
NA,T134,Brandon Harkins,20,222,34,188,2019,total_driving,T125
NA,T122,Graeme McDowell,14,222,173,49,2019,total_driving,T125
NA,T122,Trey Mullinax,18,222,17,205,2019,total_driving,T125
NA,T136,Kyle Jones,18,224,194,30,2019,total_driving,128
NA,T115,Marc Leishman,13,226,72,154,2019,total_driving,T129
NA,T127,Shawn Stefani,17,226,107,119,2019,total_driving,T129
NA,130,Roberto Díaz,15,227,166,61,2019,total_driving,T131
NA,T127,Branden Grace,16,227,66,161,2019,total_driving,T131
NA,T138,Patton Kizzire,16,228,92,136,2019,total_driving,T133
NA,T142,Phil Mickelson,12,228,18,210,2019,total_driving,T133
NA,153,J.T. Poston,20,228,93,135,2019,total_driving,T133
NA,T131,Matt Wallace,9,228,36,192,2019,total_driving,T133
NA,140,J.B. Holmes,16,229,29,200,2019,total_driving,137
NA,T136,J.J. Henry,13,230,175,55,2019,total_driving,138
NA,T134,Danny Lee,17,231,43,188,2019,total_driving,139
NA,144,C.T. Pan,18,232,176,56,2019,total_driving,140
NA,T145,Cameron Smith,15,234,69,165,2019,total_driving,141
NA,T145,Scott Brown,18,235,162,73,2019,total_driving,T142
NA,T151,Zach Johnson,13,235,169,66,2019,total_driving,T142
NA,T149,Jonas Blixt,18,237,157,80,2019,total_driving,T144
NA,T147,Patrick Rodgers,14,237,54,183,2019,total_driving,T144
NA,T147,Johnson Wagner,13,237,199,38,2019,total_driving,T144
NA,141,Billy Horschel,17,238,135,103,2019,total_driving,T147
NA,999,Shane Lowry,9,238,51,187,2019,total_driving,T147
NA,T142,Martin Trainer,17,238,31,207,2019,total_driving,T147
NA,T131,Brian Harman,19,239,181,58,2019,total_driving,150
NA,T149,Max Homa,17,241,46,195,2019,total_driving,151
NA,158,Scott Langley,18,244,211,33,2019,total_driving,152
NA,154,Ryan Blaum,20,247,155,92,2019,total_driving,T153
NA,T156,Roberto Castro,14,247,191,56,2019,total_driving,T153
NA,160,Hudson Swafford,18,247,81,166,2019,total_driving,T153
NA,161,Si Woo Kim,18,249,99,150,2019,total_driving,156
NA,T127,Martin Kaymer,9,250,119,131,2019,total_driving,T157
NA,T156,Pat Perez,14,250,174,76,2019,total_driving,T157
NA,159,Joey Garber,14,252,142,110,2019,total_driving,T159
NA,162,Jim Knous,16,252,68,184,2019,total_driving,T159
NA,T163,Ben Crane,11,253,201,52,2019,total_driving,161
NA,T151,Patrick Reed,15,254,86,168,2019,total_driving,162
NA,T171,Kelly Kraft,20,255,146,109,2019,total_driving,T163
NA,T167,Jimmy Walker,15,255,59,196,2019,total_driving,T163
NA,T163,Tom Hoge,22,256,151,105,2019,total_driving,T165
NA,T167,Brandt Snedeker,16,256,166,90,2019,total_driving,T165
NA,T167,Rod Pampling,14,257,179,78,2019,total_driving,167
NA,T167,Talor Gooch,9,258,78,180,2019,total_driving,T168
NA,T174,Cameron Tringale,14,258,91,167,2019,total_driving,T168
NA,166,Sam Saunders,17,259,73,186,2019,total_driving,170
NA,155,Richy Werenski,18,260,138,122,2019,total_driving,171
NA,T163,Jason Dufner,17,261,163,98,2019,total_driving,T172
NA,177,Seamus Power,19,261,105,156,2019,total_driving,T172
NA,T174,Alex Cejka,15,262,203,59,2019,total_driving,174
NA,T171,Anders Albertson,17,263,125,138,2019,total_driving,T175
NA,T174,John Chin,13,263,86,177,2019,total_driving,T175
NA,T171,Charley Hoffman,16,265,103,162,2019,total_driving,177
NA,178,Derek Fathauer,9,267,204,63,2019,total_driving,178
NA,T184,Danny Willett,13,269,112,157,2019,total_driving,179
NA,179,Adam Svensson,17,273,165,108,2019,total_driving,180
NA,180,Stephan Jaeger,18,274,101,173,2019,total_driving,181
NA,183,Mackenzie Hughes,17,279,98,181,2019,total_driving,182
NA,T189,Jordan Spieth,14,281,77,204,2019,total_driving,T183
NA,182,Robert Streb,19,281,145,136,2019,total_driving,T183
NA,181,Peter Uihlein,19,281,75,206,2019,total_driving,T183
NA,187,Scott Stallings,17,284,93,191,2019,total_driving,186
NA,188,Stewart Cink,12,287,115,172,2019,total_driving,T187
NA,186,Anirban Lahiri,15,287,138,149,2019,total_driving,T187
NA,191,"Ted Potter, Jr.",16,287,205,82,2019,total_driving,T187
NA,T184,Chris Kirk,17,288,186,102,2019,total_driving,190
NA,194,Nick Taylor,18,290,135,155,2019,total_driving,191
NA,T192,John Senden,13,291,185,106,2019,total_driving,192
NA,T189,John Huh,13,292,192,100,2019,total_driving,T193
NA,T192,José de Jesús Rodríguez,16,292,159,133,2019,total_driving,T193
NA,195,Whee Kim,18,296,183,113,2019,total_driving,195
NA,197,Aaron Baddeley,13,302,149,153,2019,total_driving,196
NA,196,Bill Haas,15,303,156,147,2019,total_driving,197
NA,199,Julián Etulain,16,310,116,194,2019,total_driving,198
NA,201,Ernie Els,13,316,187,129,2019,total_driving,199
NA,200,Cody Gribble,17,320,122,198,2019,total_driving,200
NA,202,Chris Stroud,17,322,151,171,2019,total_driving,201
NA,203,Charl Schwartzel,13,328,120,208,2019,total_driving,202
NA,T204,D.A. Points,13,333,209,124,2019,total_driving,203
NA,T204,Freddie Jacobson,14,335,187,148,2019,total_driving,204
NA,207,Jonathan Byrd,12,336,196,140,2019,total_driving,205
NA,208,Chris Thompson,11,345,142,203,2019,total_driving,206
NA,209,Peter Malnati,16,347,148,199,2019,total_driving,207
NA,206,Andrew Putnam,15,349,197,152,2019,total_driving,208
NA,211,Curtis Luck,16,354,169,185,2019,total_driving,209
NA,213,Martin Piller,9,362,198,164,2019,total_driving,210
NA,214,Michael Kim,19,399,206,193,2019,total_driving,211
